기관대분류,최상위기관,기관명,전체기관명,총계,공개장소,비공개장소,공개장소 소계,범죄예방,시설안전 및 화재예방,교통단속,교통정보수집 분석 및 제공
국가행정기관,감사원,감사원,감사원,75,6,69,6,0,6,0,0
국가행정기관,감사원,감사교육원,감사원 감사교육원,28,28,0,28,0,28,0,0
국가행정기관,경제사회노동위원회,경제사회노동위원회,경제사회노동위원회,2,2,0,2,0,2,0,0
국가행정기관,경찰청,경찰청,경찰청,288,248,40,248,3,245,0,0
국가행정기관,경찰청,강원도지방경찰청,경찰청 강원도지방경찰청,1148,1103,45,1103,0,184,919,0
국가행정기관,경찰청,강릉경찰서,경찰청 강원도지방경찰청 강릉경찰서,98,69,29,69,0,69,0,0
국가행정기관,경찰청,고성경찰서,경찰청 강원도지방경찰청 고성경찰서,58,58,0,58,19,39,0,0
국가행정기관,경찰청,동해경찰서,경찰청 강원도지방경찰청 동해경찰서,119,81,38,81,0,81,0,0
국가행정기관,경찰청,삼척경찰서,경찰청 강원도지방경찰청 삼척경찰서,87,68,19,68,0,68,0,0
국가행정기관,경찰청,속초경찰서,경찰청 강원도지방경찰청 속초경찰서,103,65,38,65,0,65,0,0
국가행정기관,경찰청,양구경찰서,경찰청 강원도지방경찰청 양구경찰서,50,41,9,41,0,41,0,0
국가행정기관,경찰청,영월경찰서,경찰청 강원도지방경찰청 영월경찰서,70,48,22,48,0,48,0,0
국가행정기관,경찰청,원주경찰서,경찰청 강원도지방경찰청 원주경찰서,173,101,72,101,0,101,0,0
국가행정기관,경찰청,인제경찰서,경찰청 강원도지방경찰청 인제경찰서,51,47,4,47,0,47,0,0
국가행정기관,경찰청,정선경찰서,경찰청 강원도지방경찰청 정선경찰서,57,53,4,53,9,44,0,0
국가행정기관,경찰청,철원경찰서,경찰청 강원도지방경찰청 철원경찰서,59,49,10,49,0,49,0,0
국가행정기관,경찰청,춘천경찰서,경찰청 강원도지방경찰청 춘천경찰서,150,94,56,94,0,94,0,0
국가행정기관,경찰청,태백경찰서,경찰청 강원도지방경찰청 태백경찰서,66,42,24,42,0,42,0,0
국가행정기관,경찰청,평창경찰서,경찰청 강원도지방경찰청 평창경찰서,59,51,8,51,0,51,0,0
국가행정기관,경찰청,홍천경찰서,경찰청 강원도지방경찰청 홍천경찰서,118,76,42,76,0,76,0,0
국가행정기관,경찰청,화천경찰서,경찰청 강원도지방경찰청 화천경찰서,53,39,14,39,0,39,0,0
국가행정기관,경찰청,횡성경찰서,경찰청 강원도지방경찰청 횡성경찰서,78,65,13,65,0,65,0,0
국가행정기관,경찰청,경기도남부경찰청,경찰청 경기도남부경찰청,3107,2712,395,2712,0,12,2700,0
국가행정기관,경찰청,과천경찰서,경찰청 경기도남부경찰청 과천경찰서,68,18,50,18,0,18,0,0
국가행정기관,경찰청,광명경찰서,경찰청 경기도남부경찰청 광명경찰서,96,57,39,57,0,57,0,0
국가행정기관,경찰청,광주경찰서,경찰청 경기도남부경찰청 광주경찰서,121,76,45,76,0,76,0,0
국가행정기관,경찰청,군포경찰서,경찰청 경기도남부경찰청 군포경찰서,99,50,49,50,0,50,0,0
국가행정기관,경찰청,김포경찰서,경찰청 경기도남부경찰청 김포경찰서,177,123,54,123,0,123,0,0
국가행정기관,경찰청,부천소사경찰서,경찰청 경기도남부경찰청 부천소사경찰서,130,56,74,56,0,56,0,0
국가행정기관,경찰청,부천오정경찰서,경찰청 경기도남부경찰청 부천오정경찰서,147,109,38,109,0,109,0,0
국가행정기관,경찰청,부천원미경찰서,경찰청 경기도남부경찰청 부천원미경찰서,203,87,116,87,0,87,0,0
국가행정기관,경찰청,분당경찰서,경찰청 경기도남부경찰청 분당경찰서,191,53,138,53,8,45,0,0
국가행정기관,경찰청,성남수정경찰서,경찰청 경기도남부경찰청 성남수정경찰서,160,83,77,83,0,83,0,0
국가행정기관,경찰청,성남중원경찰서,경찰청 경기도남부경찰청 성남중원경찰서,108,38,70,38,2,36,0,0
국가행정기관,경찰청,수원남부경찰서,경찰청 경기도남부경찰청 수원남부경찰서,157,129,28,129,38,91,0,0
국가행정기관,경찰청,수원서부경찰서,경찰청 경기도남부경찰청 수원서부경찰서,147,95,52,95,0,95,0,0
국가행정기관,경찰청,수원중부경찰서,경찰청 경기도남부경찰청 수원중부경찰서,148,104,44,104,104,0,0,0
국가행정기관,경찰청,시흥경찰서,경찰청 경기도남부경찰청 시흥경찰서,193,106,87,106,0,106,0,0
국가행정기관,경찰청,안산단원경찰서,경찰청 경기도남부경찰청 안산단원경찰서,151,87,64,87,0,87,0,0
국가행정기관,경찰청,안산상록경찰서,경찰청 경기도남부경찰청 안산상록경찰서,193,83,110,83,0,83,0,0
국가행정기관,경찰청,안성경찰서,경찰청 경기도남부경찰청 안성경찰서,111,63,48,63,0,63,0,0
국가행정기관,경찰청,안양동안경찰서,경찰청 경기도남부경찰청 안양동안경찰서,141,76,65,76,0,76,0,0
국가행정기관,경찰청,안양만안경찰서,경찰청 경기도남부경찰청 안양만안경찰서,115,82,33,82,0,82,0,0
국가행정기관,경찰청,양평경찰서,경찰청 경기도남부경찰청 양평경찰서,98,74,24,74,0,74,0,0
국가행정기관,경찰청,여주경찰서,경찰청 경기도남부경찰청 여주경찰서,94,67,27,67,0,67,0,0
국가행정기관,경찰청,오산경찰서,경찰청 경기도남부경찰청 오산경찰서,125,50,75,50,0,50,0,0
국가행정기관,경찰청,용인동부경찰서,경찰청 경기도남부경찰청 용인동부경찰서,212,101,111,101,9,92,0,0
국가행정기관,경찰청,용인서부경찰서,경찰청 경기도남부경찰청 용인서부경찰서,121,47,74,47,0,47,0,0
국가행정기관,경찰청,의왕경찰서,경찰청 경기도남부경찰청 의왕경찰서,175,116,59,116,0,116,0,0
국가행정기관,경찰청,이천경찰서,경찰청 경기도남부경찰청 이천경찰서,184,169,15,169,0,169,0,0
국가행정기관,경찰청,평택경찰서,경찰청 경기도남부경찰청 평택경찰서,164,89,75,89,0,89,0,0
국가행정기관,경찰청,하남경찰서,경찰청 경기도남부경찰청 하남경찰서,147,110,37,110,0,110,0,0
국가행정기관,경찰청,화성동탄경찰서,경찰청 경기도남부경찰청 화성동탄경찰서,158,104,54,104,0,104,0,0
국가행정기관,경찰청,화성서부경찰서,경찰청 경기도남부경찰청 화성서부경찰서,150,122,28,122,26,96,0,0
국가행정기관,경찰청,경기도북부지방경찰청,경찰청 경기도북부지방경찰청,1181,1147,34,1147,0,111,220,816
국가행정기관,경찰청,가평경찰서,경찰청 경기도북부지방경찰청 가평경찰서,58,37,21,37,0,37,0,0
국가행정기관,경찰청,고양경찰서,경찰청 경기도북부지방경찰청 고양경찰서,132,75,57,75,0,75,0,0
국가행정기관,경찰청,구리경찰서,경찰청 경기도북부지방경찰청 구리경찰서,101,61,40,61,0,61,0,0
국가행정기관,경찰청,남양주남부경찰서,경찰청 경기도북부지방경찰청 남양주남부경찰서,225,119,106,119,0,119,0,0
국가행정기관,경찰청,남양주북부경찰서,경찰청 경기도북부지방경찰청 남양주북부경찰서,153,112,41,112,0,112,0,0
국가행정기관,경찰청,동두천경찰서,경찰청 경기도북부지방경찰청 동두천경찰서,81,56,25,56,0,56,0,0
국가행정기관,경찰청,양주경찰서,경찰청 경기도북부지방경찰청 양주경찰서,113,71,42,71,0,71,0,0
국가행정기관,경찰청,연천경찰서,경찰청 경기도북부지방경찰청 연천경찰서,55,45,10,45,0,45,0,0
국가행정기관,경찰청,의정부경찰서,경찰청 경기도북부지방경찰청 의정부경찰서,177,107,70,107,0,107,0,0
국가행정기관,경찰청,일산동부경찰서,경찰청 경기도북부지방경찰청 일산동부경찰서,146,60,86,60,0,60,0,0
국가행정기관,경찰청,일산서부경찰서,경찰청 경기도북부지방경찰청 일산서부경찰서,99,63,36,63,0,63,0,0
국가행정기관,경찰청,파주경찰서,경찰청 경기도북부지방경찰청 파주경찰서,140,68,72,68,0,68,0,0
국가행정기관,경찰청,포천경찰서,경찰청 경기도북부지방경찰청 포천경찰서,103,74,29,74,0,74,0,0
국가행정기관,경찰청,경상남도지방경찰청,경찰청 경상남도지방경찰청,1436,1181,255,1181,0,46,1135,0
국가행정기관,경찰청,거제경찰서,경찰청 경상남도지방경찰청 거제경찰서,97,69,28,69,0,69,0,0
국가행정기관,경찰청,거창경찰서,경찰청 경상남도지방경찰청 거창경찰서,108,76,32,76,0,76,0,0
국가행정기관,경찰청,고성경찰서,경찰청 경상남도지방경찰청 고성경찰서,101,68,33,68,0,68,0,0
국가행정기관,경찰청,김해서부경찰서,경찰청 경상남도지방경찰청 김해서부경찰서,130,98,32,98,0,98,0,0
국가행정기관,경찰청,김해중부경찰서,경찰청 경상남도지방경찰청 김해중부경찰서,119,74,45,74,0,74,0,0
국가행정기관,경찰청,남해경찰서,경찰청 경상남도지방경찰청 남해경찰서,59,41,18,41,0,41,0,0
국가행정기관,경찰청,마산동부경찰서,경찰청 경상남도지방경찰청 마산동부경찰서,157,53,104,53,0,53,0,0
국가행정기관,경찰청,마산중부경찰서,경찰청 경상남도지방경찰청 마산중부경찰서,75,51,24,51,0,51,0,0
국가행정기관,경찰청,밀양경찰서,경찰청 경상남도지방경찰청 밀양경찰서,122,45,77,45,0,45,0,0
국가행정기관,경찰청,사천경찰서,경찰청 경상남도지방경찰청 사천경찰서,113,79,34,79,0,79,0,0
국가행정기관,경찰청,산청경찰서,경찰청 경상남도지방경찰청 산청경찰서,77,59,18,59,0,59,0,0
국가행정기관,경찰청,양산경찰서,경찰청 경상남도지방경찰청 양산경찰서,176,58,118,58,0,58,0,0
국가행정기관,경찰청,의령경찰서,경찰청 경상남도지방경찰청 의령경찰서,81,72,9,72,0,72,0,0
국가행정기관,경찰청,진주경찰서,경찰청 경상남도지방경찰청 진주경찰서,182,98,84,98,0,98,0,0
국가행정기관,경찰청,진해경찰서,경찰청 경상남도지방경찰청 진해경찰서,113,86,27,86,0,86,0,0
국가행정기관,경찰청,창녕경찰서,경찰청 경상남도지방경찰청 창녕경찰서,97,61,36,61,0,61,0,0
국가행정기관,경찰청,창원서부경찰서,경찰청 경상남도지방경찰청 창원서부경찰서,122,63,59,63,0,63,0,0
국가행정기관,경찰청,창원중부경찰서,경찰청 경상남도지방경찰청 창원중부경찰서,144,59,85,59,0,59,0,0
국가행정기관,경찰청,통영경찰서,경찰청 경상남도지방경찰청 통영경찰서,113,71,42,71,0,71,0,0
국가행정기관,경찰청,하동경찰서,경찰청 경상남도지방경찰청 하동경찰서,77,53,24,53,0,53,0,0
국가행정기관,경찰청,함안경찰서,경찰청 경상남도지방경찰청 함안경찰서,82,55,27,55,0,55,0,0
국가행정기관,경찰청,함양경찰서,경찰청 경상남도지방경찰청 함양경찰서,79,79,0,79,20,59,0,0
국가행정기관,경찰청,합천경찰서,경찰청 경상남도지방경찰청 합천경찰서,120,94,26,94,0,94,0,0
국가행정기관,경찰청,경상북도지방경찰청,경찰청 경상북도지방경찰청,595,501,94,501,0,309,192,0
국가행정기관,경찰청,경산경찰서,경찰청 경상북도지방경찰청 경산경찰서,241,180,61,180,0,65,115,0
국가행정기관,경찰청,경주경찰서,경찰청 경상북도지방경찰청 경주경찰서,304,267,37,267,0,117,150,0
국가행정기관,경찰청,고령경찰서,경찰청 경상북도지방경찰청 고령경찰서,94,87,7,87,0,59,28,0
국가행정기관,경찰청,구미경찰서,경찰청 경상북도지방경찰청 구미경찰서,371,293,78,293,0,151,142,0
국가행정기관,경찰청,군위경찰서,경찰청 경상북도지방경찰청 군위경찰서,75,55,20,55,0,31,24,0
국가행정기관,경찰청,김천경찰서,경찰청 경상북도지방경찰청 김천경찰서,277,219,58,219,0,127,92,0
국가행정기관,경찰청,문경경찰서,경찰청 경상북도지방경찰청 문경경찰서,168,138,30,138,0,84,54,0
국가행정기관,경찰청,봉화경찰서,경찰청 경상북도지방경찰청 봉화경찰서,90,83,7,83,0,61,22,0
국가행정기관,경찰청,상주경찰서,경찰청 경상북도지방경찰청 상주경찰서,208,185,23,185,0,115,70,0
국가행정기관,경찰청,성주경찰서,경찰청 경상북도지방경찰청 성주경찰서,119,93,26,93,0,61,32,0
국가행정기관,경찰청,안동경찰서,경찰청 경상북도지방경찰청 안동경찰서,209,173,36,173,0,106,67,0
국가행정기관,경찰청,영덕경찰서,경찰청 경상북도지방경찰청 영덕경찰서,63,42,21,42,0,33,9,0
국가행정기관,경찰청,영양경찰서,경찰청 경상북도지방경찰청 영양경찰서,69,60,9,60,0,35,25,0
국가행정기관,경찰청,영주경찰서,경찰청 경상북도지방경찰청 영주경찰서,189,154,35,154,0,112,42,0
국가행정기관,경찰청,영천경찰서,경찰청 경상북도지방경찰청 영천경찰서,164,149,15,149,0,91,58,0
국가행정기관,경찰청,예천경찰서,경찰청 경상북도지방경찰청 예천경찰서,137,121,16,121,0,76,45,0
국가행정기관,경찰청,울릉경찰서,경찰청 경상북도지방경찰청 울릉경찰서,31,22,9,22,0,22,0,0
국가행정기관,경찰청,울진경찰서,경찰청 경상북도지방경찰청 울진경찰서,96,85,11,85,0,49,36,0
국가행정기관,경찰청,의성경찰서,경찰청 경상북도지방경찰청 의성경찰서,206,180,26,180,0,119,61,0
국가행정기관,경찰청,청도경찰서,경찰청 경상북도지방경찰청 청도경찰서,108,83,25,83,0,58,25,0
국가행정기관,경찰청,청송경찰서,경찰청 경상북도지방경찰청 청송경찰서,102,85,17,85,0,61,24,0
국가행정기관,경찰청,칠곡경찰서,경찰청 경상북도지방경찰청 칠곡경찰서,177,131,46,131,0,61,70,0
국가행정기관,경찰청,포항남부경찰서,경찰청 경상북도지방경찰청 포항남부경찰서,284,235,49,235,0,139,96,0
국가행정기관,경찰청,포항북부경찰서,경찰청 경상북도지방경찰청 포항북부경찰서,288,227,61,227,0,137,90,0
국가행정기관,경찰청,경찰대학,경찰청 경찰대학,295,96,199,96,0,96,0,0
국가행정기관,경찰청,경찰병원,경찰청 경찰병원,206,206,0,206,0,206,0,0
국가행정기관,경찰청,경찰수사연수원,경찰청 경찰수사연수원,74,74,0,74,0,74,0,0
국가행정기관,경찰청,경찰인재개발원,경찰청 경찰인재개발원,129,55,74,55,0,55,0,0
국가행정기관,경찰청,광주광역시지방경찰청,경찰청 광주광역시지방경찰청,701,542,159,542,0,32,510,0
국가행정기관,경찰청,광주광산경찰서,경찰청 광주광역시지방경찰청 광주광산경찰서,69,69,0,69,0,69,0,0
국가행정기관,경찰청,광주남부경찰서,경찰청 광주광역시지방경찰청 광주남부경찰서,100,44,56,44,0,44,0,0
국가행정기관,경찰청,광주동부경찰서,경찰청 광주광역시지방경찰청 광주동부경찰서,65,31,34,31,0,31,0,0
국가행정기관,경찰청,광주북부경찰서,경찰청 광주광역시지방경찰청 광주북부경찰서,140,76,64,76,0,76,0,0
국가행정기관,경찰청,광주서부경찰서,경찰청 광주광역시지방경찰청 광주서부경찰서,154,64,90,64,0,64,0,0
국가행정기관,경찰청,대구광역시지방경찰청,경찰청 대구광역시지방경찰청,920,712,208,712,0,10,702,0
국가행정기관,경찰청,대구강북경찰서,경찰청 대구광역시지방경찰청 대구강북경찰서,161,47,114,47,47,0,0,0
국가행정기관,경찰청,대구남부경찰서,경찰청 대구광역시지방경찰청 대구남부경찰서,124,57,67,57,0,57,0,0
국가행정기관,경찰청,대구달서경찰서,경찰청 대구광역시지방경찰청 대구달서경찰서,134,65,69,65,0,65,0,0
국가행정기관,경찰청,대구달성경찰서,경찰청 대구광역시지방경찰청 대구달성경찰서,96,68,28,68,0,68,0,0
국가행정기관,경찰청,대구동부경찰서,경찰청 대구광역시지방경찰청 대구동부경찰서,213,146,67,146,0,146,0,0
국가행정기관,경찰청,대구북부경찰서,경찰청 대구광역시지방경찰청 대구북부경찰서,120,65,55,65,0,65,0,0
국가행정기관,경찰청,대구서부경찰서,경찰청 대구광역시지방경찰청 대구서부경찰서,162,54,108,54,0,54,0,0
국가행정기관,경찰청,대구성서경찰서,경찰청 대구광역시지방경찰청 대구성서경찰서,159,52,107,52,0,52,0,0
국가행정기관,경찰청,대구수성경찰서,경찰청 대구광역시지방경찰청 대구수성경찰서,167,97,70,97,0,97,0,0
국가행정기관,경찰청,대구중부경찰서,경찰청 대구광역시지방경찰청 대구중부경찰서,118,57,61,57,0,57,0,0
국가행정기관,경찰청,대전광역시지방경찰청,경찰청 대전광역시지방경찰청,796,624,172,624,0,13,611,0
국가행정기관,경찰청,대전대덕경찰서,경찰청 대전광역시지방경찰청 대전대덕경찰서,92,34,58,34,0,34,0,0
국가행정기관,경찰청,대전동부경찰서,경찰청 대전광역시지방경찰청 대전동부경찰서,187,115,72,115,0,115,0,0
국가행정기관,경찰청,대전둔산경찰서,경찰청 대전광역시지방경찰청 대전둔산경찰서,132,62,70,62,0,62,0,0
국가행정기관,경찰청,대전서부경찰서,경찰청 대전광역시지방경찰청 대전서부경찰서,96,49,47,49,0,49,0,0
국가행정기관,경찰청,대전유성경찰서,경찰청 대전광역시지방경찰청 대전유성경찰서,172,122,50,122,0,122,0,0
국가행정기관,경찰청,대전중부경찰서,경찰청 대전광역시지방경찰청 대전중부경찰서,115,70,45,70,0,70,0,0
국가행정기관,경찰청,도로교통공단,경찰청 도로교통공단,1429,1328,101,1328,186,1142,0,0
국가행정기관,경찰청,부산광역시경찰청,경찰청 부산광역시경찰청,1504,1170,334,1170,0,37,1133,0
국가행정기관,경찰청,부산강서경찰서,경찰청 부산광역시경찰청 부산강서경찰서,112,59,53,59,0,59,0,0
국가행정기관,경찰청,부산금정경찰서,경찰청 부산광역시경찰청 부산금정경찰서,97,60,37,60,0,60,0,0
국가행정기관,경찰청,부산기장경찰서,경찰청 부산광역시경찰청 부산기장경찰서,109,25,84,25,0,25,0,0
국가행정기관,경찰청,부산남부경찰서,경찰청 부산광역시경찰청 부산남부경찰서,214,96,118,96,0,96,0,0
국가행정기관,경찰청,부산동래경찰서,경찰청 부산광역시경찰청 부산동래경찰서,173,86,87,86,0,86,0,0
국가행정기관,경찰청,부산동부경찰서,경찰청 부산광역시경찰청 부산동부경찰서,97,57,40,57,0,57,0,0
국가행정기관,경찰청,부산북부경찰서,경찰청 부산광역시경찰청 부산북부경찰서,134,56,78,56,0,56,0,0
국가행정기관,경찰청,부산사상경찰서,경찰청 부산광역시경찰청 부산사상경찰서,148,68,80,68,0,68,0,0
국가행정기관,경찰청,부산사하경찰서,경찰청 부산광역시경찰청 부산사하경찰서,147,78,69,78,0,78,0,0
국가행정기관,경찰청,부산서부경찰서,경찰청 부산광역시경찰청 부산서부경찰서,104,43,61,43,0,43,0,0
국가행정기관,경찰청,부산연제경찰서,경찰청 부산광역시경찰청 부산연제경찰서,167,61,106,61,0,61,0,0
국가행정기관,경찰청,부산영도경찰서,경찰청 부산광역시경찰청 부산영도경찰서,85,52,33,52,0,52,0,0
국가행정기관,경찰청,부산중부경찰서,경찰청 부산광역시경찰청 부산중부경찰서,67,40,27,40,0,40,0,0
국가행정기관,경찰청,부산진경찰서,경찰청 부산광역시경찰청 부산진경찰서,220,117,103,117,0,117,0,0
국가행정기관,경찰청,부산해운대경찰서,경찰청 부산광역시경찰청 부산해운대경찰서,152,73,79,73,0,73,0,0
국가행정기관,경찰청,서울특별시지방경찰청,경찰청 서울특별시지방경찰청,2528,1905,623,1905,0,127,1778,0
국가행정기관,경찰청,1기동대,경찰청 서울특별시지방경찰청 1기동대,19,0,19,0,0,0,0,0
국가행정기관,경찰청,202경비대,경찰청 서울특별시지방경찰청 202경비대,43,0,43,0,0,0,0,0
국가행정기관,경찰청,22경찰경호대,경찰청 서울특별시지방경찰청 22경찰경호대,12,0,12,0,0,0,0,0
국가행정기관,경찰청,2기동대,경찰청 서울특별시지방경찰청 2기동대,58,0,58,0,0,0,0,0
국가행정기관,경찰청,3기동대,경찰청 서울특별시지방경찰청 3기동대,68,3,65,3,0,3,0,0
국가행정기관,경찰청,4기동대,경찰청 서울특별시지방경찰청 4기동대,41,0,41,0,0,0,0,0
국가행정기관,경찰청,5기동대,경찰청 서울특별시지방경찰청 5기동대,56,0,56,0,0,0,0,0
국가행정기관,경찰청,6기동대,경찰청 서울특별시지방경찰청 6기동대,17,0,17,0,0,0,0,0
국가행정기관,경찰청,7기동대,경찰청 서울특별시지방경찰청 7기동대,12,0,12,0,0,0,0,0
국가행정기관,경찰청,8기동대,경찰청 서울특별시지방경찰청 8기동대,28,0,28,0,0,0,0,0
국가행정기관,경찰청,경찰특공대,경찰청 서울특별시지방경찰청 경찰특공대,30,21,9,21,0,21,0,0
국가행정기관,경찰청,국회경비대,경찰청 서울특별시지방경찰청 국회경비대,11,0,11,0,0,0,0,0
국가행정기관,경찰청,기동단,경찰청 서울특별시지방경찰청 기동단,19,0,19,0,0,0,0,0
국가행정기관,경찰청,김포공항경찰대,경찰청 서울특별시지방경찰청 김포공항경찰대,5,0,5,0,0,0,0,0
국가행정기관,경찰청,서울강남경찰서,경찰청 서울특별시지방경찰청 서울강남경찰서,277,79,198,79,0,79,0,0
국가행정기관,경찰청,서울강동경찰서,경찰청 서울특별시지방경찰청 서울강동경찰서,245,53,192,53,0,53,0,0
국가행정기관,경찰청,서울강북경찰서,경찰청 서울특별시지방경찰청 서울강북경찰서,142,86,56,86,0,86,0,0
국가행정기관,경찰청,서울강서경찰서,경찰청 서울특별시지방경찰청 서울강서경찰서,273,177,96,177,0,177,0,0
국가행정기관,경찰청,서울관악경찰서,경찰청 서울특별시지방경찰청 서울관악경찰서,181,102,79,102,0,102,0,0
국가행정기관,경찰청,서울광진경찰서,경찰청 서울특별시지방경찰청 서울광진경찰서,238,127,111,127,0,127,0,0
국가행정기관,경찰청,서울구로경찰서,경찰청 서울특별시지방경찰청 서울구로경찰서,144,88,56,88,0,88,0,0
국가행정기관,경찰청,서울금천경찰서,경찰청 서울특별시지방경찰청 서울금천경찰서,202,57,145,57,0,57,0,0
국가행정기관,경찰청,서울남대문경찰서,경찰청 서울특별시지방경찰청 서울남대문경찰서,117,26,91,26,0,26,0,0
국가행정기관,경찰청,서울노원경찰서,경찰청 서울특별시지방경찰청 서울노원경찰서,140,72,68,72,0,72,0,0
국가행정기관,경찰청,서울도봉경찰서,경찰청 서울특별시지방경찰청 서울도봉경찰서,149,41,108,41,0,41,0,0
국가행정기관,경찰청,서울동대문경찰서,경찰청 서울특별시지방경찰청 서울동대문경찰서,201,116,85,116,0,116,0,0
국가행정기관,경찰청,서울동작경찰서,경찰청 서울특별시지방경찰청 서울동작경찰서,133,76,57,76,0,76,0,0
국가행정기관,경찰청,서울마포경찰서,경찰청 서울특별시지방경찰청 서울마포경찰서,180,98,82,98,12,86,0,0
국가행정기관,경찰청,서울방배경찰서,경찰청 서울특별시지방경찰청 서울방배경찰서,77,46,31,46,0,46,0,0
국가행정기관,경찰청,서울서대문경찰서,경찰청 서울특별시지방경찰청 서울서대문경찰서,139,47,92,47,0,47,0,0
국가행정기관,경찰청,서울서부경찰서,경찰청 서울특별시지방경찰청 서울서부경찰서,190,53,137,53,0,53,0,0
국가행정기관,경찰청,서울서초경찰서,경찰청 서울특별시지방경찰청 서울서초경찰서,181,88,93,88,0,88,0,0
국가행정기관,경찰청,서울성동경찰서,경찰청 서울특별시지방경찰청 서울성동경찰서,153,68,85,68,0,68,0,0
국가행정기관,경찰청,서울성북경찰서,경찰청 서울특별시지방경찰청 서울성북경찰서,164,97,67,97,0,97,0,0
국가행정기관,경찰청,서울송파경찰서,경찰청 서울특별시지방경찰청 서울송파경찰서,232,159,73,159,0,159,0,0
국가행정기관,경찰청,서울수서경찰서,경찰청 서울특별시지방경찰청 서울수서경찰서,191,62,129,62,0,62,0,0
국가행정기관,경찰청,서울양천경찰서,경찰청 서울특별시지방경찰청 서울양천경찰서,146,57,89,57,0,57,0,0
국가행정기관,경찰청,서울영등포경찰서,경찰청 서울특별시지방경찰청 서울영등포경찰서,150,81,69,81,0,81,0,0
국가행정기관,경찰청,서울용산경찰서,경찰청 서울특별시지방경찰청 서울용산경찰서,144,57,87,57,0,57,0,0
국가행정기관,경찰청,서울은평경찰서,경찰청 서울특별시지방경찰청 서울은평경찰서,152,95,57,95,0,95,0,0
국가행정기관,경찰청,서울종로경찰서,경찰청 서울특별시지방경찰청 서울종로경찰서,167,76,91,76,0,76,0,0
국가행정기관,경찰청,서울종암경찰서,경찰청 서울특별시지방경찰청 서울종암경찰서,107,70,37,70,0,70,0,0
국가행정기관,경찰청,서울중랑경찰서,경찰청 서울특별시지방경찰청 서울중랑경찰서,211,126,85,126,0,126,0,0
국가행정기관,경찰청,서울중부경찰서,경찰청 서울특별시지방경찰청 서울중부경찰서,83,42,41,42,0,42,0,0
국가행정기관,경찰청,서울혜화경찰서,경찰청 서울특별시지방경찰청 서울혜화경찰서,101,77,24,77,0,77,0,0
국가행정기관,경찰청,세종특별자치시경찰청,경찰청 세종특별자치시경찰청,69,2,67,2,0,2,0,0
국가행정기관,경찰청,세종남부경찰서,경찰청 세종특별자치시경찰청 세종남부경찰서,149,28,121,28,0,28,0,0
국가행정기관,경찰청,세종북부경찰서,경찰청 세종특별자치시경찰청 세종북부경찰서,66,31,35,31,0,31,0,0
국가행정기관,경찰청,울산광역시경찰청,경찰청 울산광역시경찰청,961,851,110,851,0,36,815,0
국가행정기관,경찰청,울산남부경찰서,경찰청 울산광역시경찰청 울산남부경찰서,174,101,73,101,0,101,0,0
국가행정기관,경찰청,울산동부경찰서,경찰청 울산광역시경찰청 울산동부경찰서,127,52,75,52,0,52,0,0
국가행정기관,경찰청,울산북부경찰서,경찰청 울산광역시경찰청 울산북부경찰서,126,47,79,47,0,47,0,0
국가행정기관,경찰청,울산울주경찰서,경찰청 울산광역시경찰청 울산울주경찰서,134,133,1,133,0,133,0,0
국가행정기관,경찰청,울산중부경찰서,경찰청 울산광역시경찰청 울산중부경찰서,136,67,69,67,0,67,0,0
국가행정기관,경찰청,인천광역시지방경찰청,경찰청 인천광역시지방경찰청,1340,983,357,983,0,48,935,0
국가행정기관,경찰청,인천강화경찰서,경찰청 인천광역시지방경찰청 인천강화경찰서,108,45,63,45,0,45,0,0
국가행정기관,경찰청,인천계양경찰서,경찰청 인천광역시지방경찰청 인천계양경찰서,117,63,54,63,0,63,0,0
국가행정기관,경찰청,인천국제공항경찰단,경찰청 인천광역시지방경찰청 인천국제공항경찰단,49,4,45,4,0,4,0,0
국가행정기관,경찰청,인천남동경찰서,경찰청 인천광역시지방경찰청 인천남동경찰서,116,57,59,57,0,57,0,0
국가행정기관,경찰청,인천논현경찰서,경찰청 인천광역시지방경찰청 인천논현경찰서,154,36,118,36,0,36,0,0
국가행정기관,경찰청,인천미추홀경찰서,경찰청 인천광역시지방경찰청 인천미추홀경찰서,204,72,132,72,0,72,0,0
국가행정기관,경찰청,인천부평경찰서,경찰청 인천광역시지방경찰청 인천부평경찰서,112,66,46,66,0,66,0,0
국가행정기관,경찰청,인천삼산경찰서,경찰청 인천광역시지방경찰청 인천삼산경찰서,173,62,111,62,0,62,0,0
국가행정기관,경찰청,인천서부경찰서,경찰청 인천광역시지방경찰청 인천서부경찰서,234,80,154,80,0,80,0,0
국가행정기관,경찰청,인천연수경찰서,경찰청 인천광역시지방경찰청 인천연수경찰서,130,42,88,42,0,42,0,0
국가행정기관,경찰청,인천중부경찰서,경찰청 인천광역시지방경찰청 인천중부경찰서,166,111,55,111,0,111,0,0
국가행정기관,경찰청,전라남도경찰청,경찰청 전라남도경찰청,1701,1654,47,1654,0,220,1434,0
국가행정기관,경찰청,강진경찰서,경찰청 전라남도경찰청 강진경찰서,60,47,13,47,0,47,0,0
국가행정기관,경찰청,고흥경찰서,경찰청 전라남도경찰청 고흥경찰서,125,93,32,93,0,93,0,0
국가행정기관,경찰청,곡성경찰서,경찰청 전라남도경찰청 곡성경찰서,60,53,7,53,0,53,0,0
국가행정기관,경찰청,광양경찰서,경찰청 전라남도경찰청 광양경찰서,98,68,30,68,0,68,0,0
국가행정기관,경찰청,구례경찰서,경찰청 전라남도경찰청 구례경찰서,74,58,16,58,0,58,0,0
국가행정기관,경찰청,나주경찰서,경찰청 전라남도경찰청 나주경찰서,101,72,29,72,0,72,0,0
국가행정기관,경찰청,담양경찰서,경찰청 전라남도경찰청 담양경찰서,79,67,12,67,0,67,0,0
국가행정기관,경찰청,목포경찰서,경찰청 전라남도경찰청 목포경찰서,389,292,97,292,0,292,0,0
국가행정기관,경찰청,무안경찰서,경찰청 전라남도경찰청 무안경찰서,94,71,23,71,0,71,0,0
국가행정기관,경찰청,보성경찰서,경찰청 전라남도경찰청 보성경찰서,99,80,19,80,0,80,0,0
국가행정기관,경찰청,순천경찰서,경찰청 전라남도경찰청 순천경찰서,226,148,78,148,0,148,0,0
국가행정기관,경찰청,여수경찰서,경찰청 전라남도경찰청 여수경찰서,253,191,62,191,0,191,0,0
국가행정기관,경찰청,영광경찰서,경찰청 전라남도경찰청 영광경찰서,78,58,20,58,0,58,0,0
국가행정기관,경찰청,영암경찰서,경찰청 전라남도경찰청 영암경찰서,76,63,13,63,0,63,0,0
국가행정기관,경찰청,완도경찰서,경찰청 전라남도경찰청 완도경찰서,97,83,14,83,0,83,0,0
국가행정기관,경찰청,장성경찰서,경찰청 전라남도경찰청 장성경찰서,65,52,13,52,0,52,0,0
국가행정기관,경찰청,장흥경찰서,경찰청 전라남도경찰청 장흥경찰서,71,57,14,57,0,57,0,0
국가행정기관,경찰청,진도경찰서,경찰청 전라남도경찰청 진도경찰서,78,60,18,60,0,60,0,0
국가행정기관,경찰청,함평경찰서,경찰청 전라남도경찰청 함평경찰서,66,51,15,51,0,51,0,0
국가행정기관,경찰청,해남경찰서,경찰청 전라남도경찰청 해남경찰서,92,68,24,68,0,68,0,0
국가행정기관,경찰청,화순경찰서,경찰청 전라남도경찰청 화순경찰서,90,72,18,72,0,72,0,0
국가행정기관,경찰청,전라북도지방경찰청,경찰청 전라북도지방경찰청,1767,1499,268,1499,0,27,1472,0
국가행정기관,경찰청,고창경찰서,경찰청 전라북도지방경찰청 고창경찰서,95,77,18,77,0,77,0,0
국가행정기관,경찰청,군산경찰서,경찰청 전라북도지방경찰청 군산경찰서,148,109,39,109,0,109,0,0
국가행정기관,경찰청,김제경찰서,경찰청 전라북도지방경찰청 김제경찰서,104,84,20,84,0,84,0,0
국가행정기관,경찰청,남원경찰서,경찰청 전라북도지방경찰청 남원경찰서,156,117,39,117,0,117,0,0
국가행정기관,경찰청,무주경찰서,경찰청 전라북도지방경찰청 무주경찰서,73,51,22,51,0,51,0,0
국가행정기관,경찰청,부안경찰서,경찰청 전라북도지방경찰청 부안경찰서,97,82,15,82,0,82,0,0
국가행정기관,경찰청,순창경찰서,경찰청 전라북도지방경찰청 순창경찰서,100,92,8,92,0,92,0,0
국가행정기관,경찰청,완주경찰서,경찰청 전라북도지방경찰청 완주경찰서,95,3,92,3,0,3,0,0
국가행정기관,경찰청,익산경찰서,경찰청 전라북도지방경찰청 익산경찰서,204,146,58,146,0,146,0,0
국가행정기관,경찰청,임실경찰서,경찰청 전라북도지방경찰청 임실경찰서,68,60,8,60,0,60,0,0
국가행정기관,경찰청,장수경찰서,경찰청 전라북도지방경찰청 장수경찰서,78,67,11,67,0,67,0,0
국가행정기관,경찰청,전주덕진경찰서,경찰청 전라북도지방경찰청 전주덕진경찰서,165,113,52,113,0,113,0,0
국가행정기관,경찰청,전주완산경찰서,경찰청 전라북도지방경찰청 전주완산경찰서,190,139,51,139,0,139,0,0
국가행정기관,경찰청,정읍경찰서,경찰청 전라북도지방경찰청 정읍경찰서,150,121,29,121,0,121,0,0
국가행정기관,경찰청,진안경찰서,경찰청 전라북도지방경찰청 진안경찰서,69,60,9,60,0,60,0,0
국가행정기관,경찰청,제주특별자치도지방경찰청,경찰청 제주특별자치도지방경찰청,534,424,110,424,98,46,280,0
국가행정기관,경찰청,경찰특공대,경찰청 제주특별자치도지방경찰청 경찰특공대,18,0,18,0,0,0,0,0
국가행정기관,경찰청,서귀포경찰서,경찰청 제주특별자치도지방경찰청 서귀포경찰서,185,133,52,133,33,100,0,0
국가행정기관,경찰청,제주동부경찰서,경찰청 제주특별자치도지방경찰청 제주동부경찰서,189,110,79,110,3,107,0,0
국가행정기관,경찰청,제주서부경찰서,경찰청 제주특별자치도지방경찰청 제주서부경찰서,152,74,78,74,0,74,0,0
국가행정기관,경찰청,제주해안경비단,경찰청 제주특별자치도지방경찰청 제주해안경비단,193,0,193,0,0,0,0,0
국가행정기관,경찰청,중앙경찰학교,경찰청 중앙경찰학교,138,0,138,0,0,0,0,0
국가행정기관,경찰청,충청남도지방경찰청,경찰청 충청남도지방경찰청,2064,2012,52,2012,0,184,1828,0
국가행정기관,경찰청,공주경찰서,경찰청 충청남도지방경찰청 공주경찰서,92,76,16,76,0,76,0,0
국가행정기관,경찰청,금산경찰서,경찰청 충청남도지방경찰청 금산경찰서,104,79,25,79,0,79,0,0
국가행정기관,경찰청,논산경찰서,경찰청 충청남도지방경찰청 논산경찰서,95,76,19,76,0,76,0,0
국가행정기관,경찰청,당진경찰서,경찰청 충청남도지방경찰청 당진경찰서,104,64,40,64,0,64,0,0
국가행정기관,경찰청,보령경찰서,경찰청 충청남도지방경찰청 보령경찰서,135,109,26,109,0,109,0,0
국가행정기관,경찰청,부여경찰서,경찰청 충청남도지방경찰청 부여경찰서,75,65,10,65,0,65,0,0
국가행정기관,경찰청,서산경찰서,경찰청 충청남도지방경찰청 서산경찰서,152,110,42,110,0,110,0,0
국가행정기관,경찰청,서천경찰서,경찰청 충청남도지방경찰청 서천경찰서,109,89,20,89,0,89,0,0
국가행정기관,경찰청,아산경찰서,경찰청 충청남도지방경찰청 아산경찰서,180,94,86,94,14,80,0,0
국가행정기관,경찰청,예산경찰서,경찰청 충청남도지방경찰청 예산경찰서,92,72,20,72,0,72,0,0
국가행정기관,경찰청,천안동남경찰서,경찰청 충청남도지방경찰청 천안동남경찰서,168,131,37,131,0,131,0,0
국가행정기관,경찰청,천안서북경찰서,경찰청 충청남도지방경찰청 천안서북경찰서,175,125,50,125,0,125,0,0
국가행정기관,경찰청,청양경찰서,경찰청 충청남도지방경찰청 청양경찰서,69,53,16,53,0,53,0,0
국가행정기관,경찰청,태안경찰서,경찰청 충청남도지방경찰청 태안경찰서,116,95,21,95,0,95,0,0
국가행정기관,경찰청,홍성경찰서,경찰청 충청남도지방경찰청 홍성경찰서,68,39,29,39,0,39,0,0
국가행정기관,경찰청,충청북도경찰청,경찰청 충청북도경찰청,1196,1127,69,1127,0,219,908,0
국가행정기관,경찰청,괴산경찰서,경찰청 충청북도경찰청 괴산경찰서,102,77,25,77,7,70,0,0
국가행정기관,경찰청,단양경찰서,경찰청 충청북도경찰청 단양경찰서,56,42,14,42,0,42,0,0
국가행정기관,경찰청,보은경찰서,경찰청 충청북도경찰청 보은경찰서,70,54,16,54,6,48,0,0
국가행정기관,경찰청,영동경찰서,경찰청 충청북도경찰청 영동경찰서,74,48,26,48,0,48,0,0
국가행정기관,경찰청,옥천경찰서,경찰청 충청북도경찰청 옥천경찰서,70,55,15,55,0,55,0,0
국가행정기관,경찰청,음성경찰서,경찰청 충청북도경찰청 음성경찰서,81,59,22,59,0,59,0,0
국가행정기관,경찰청,제천경찰서,경찰청 충청북도경찰청 제천경찰서,150,121,29,121,10,111,0,0
국가행정기관,경찰청,진천경찰서,경찰청 충청북도경찰청 진천경찰서,115,47,68,47,5,42,0,0
국가행정기관,경찰청,청주상당경찰서,경찰청 충청북도경찰청 청주상당경찰서,152,92,60,92,0,92,0,0
국가행정기관,경찰청,청주청원경찰서,경찰청 충청북도경찰청 청주청원경찰서,136,75,61,75,0,75,0,0
국가행정기관,경찰청,청주흥덕경찰서,경찰청 충청북도경찰청 청주흥덕경찰서,122,57,65,57,0,57,0,0
국가행정기관,경찰청,충주경찰서,경찰청 충청북도경찰청 충주경찰서,154,122,32,122,18,104,0,0
국가행정기관,고용노동부,고용노동부,고용노동부,48,21,27,21,0,21,0,0
국가행정기관,고용노동부,강원지청,고용노동부 강원지청,23,23,0,23,10,13,0,0
국가행정기관,고용노동부,강릉지청,고용노동부 강원지청 강릉지청,50,50,0,50,0,50,0,0
국가행정기관,고용노동부,영월출장소,고용노동부 강원지청 영월출장소,15,15,0,15,0,15,0,0
국가행정기관,고용노동부,원주지청,고용노동부 강원지청 원주지청,38,38,0,38,19,19,0,0
국가행정기관,고용노동부,태백지청,고용노동부 강원지청 태백지청,28,28,0,28,9,15,2,2
국가행정기관,고용노동부,건설근로자공제회,고용노동부 건설근로자공제회,0,0,0,0,0,0,0,0
국가행정기관,고용노동부,경기지청,고용노동부 경기지청,133,133,0,133,0,133,0,0
국가행정기관,고용노동부,성남지청,고용노동부 경기지청 성남지청,134,134,0,134,61,73,0,0
국가행정기관,고용노동부,안산지청,고용노동부 경기지청 안산지청,61,59,2,59,0,59,0,0
국가행정기관,고용노동부,안양지청,고용노동부 경기지청 안양지청,90,79,11,79,0,79,0,0
국가행정기관,고용노동부,평택지청,고용노동부 경기지청 평택지청,54,54,0,54,54,0,0,0
국가행정기관,고용노동부,고객상담센터,고용노동부 고객상담센터,11,11,0,11,0,11,0,0
국가행정기관,고용노동부,광주지방고용노동청,고용노동부 광주지방고용노동청,125,125,0,125,0,125,0,0
국가행정기관,고용노동부,군산지청,고용노동부 광주지방고용노동청 군산지청,45,45,0,45,0,45,0,0
국가행정기관,고용노동부,목포지청,고용노동부 광주지방고용노동청 목포지청,71,71,0,71,0,71,0,0
국가행정기관,고용노동부,여수지청,고용노동부 광주지방고용노동청 여수지청,39,39,0,39,0,39,0,0
국가행정기관,고용노동부,익산지청,고용노동부 광주지방고용노동청 익산지청,55,55,0,55,0,55,0,0
국가행정기관,고용노동부,전주지청,고용노동부 광주지방고용노동청 전주지청,173,171,2,171,0,171,0,0
국가행정기관,고용노동부,근로복지공단,고용노동부 근로복지공단,2676,2665,11,2665,470,2195,0,0
국가행정기관,고용노동부,노사발전재단,고용노동부 노사발전재단,39,39,0,39,39,0,0,0
국가행정기관,고용노동부,대구지방고용노동청,고용노동부 대구지방고용노동청,180,180,0,180,0,180,0,0
국가행정기관,고용노동부,구미지청,고용노동부 대구지방고용노동청 구미지청,109,109,0,109,0,109,0,0
국가행정기관,고용노동부,대구서부지청,고용노동부 대구지방고용노동청 대구서부지청,91,91,0,91,45,46,0,0
국가행정기관,고용노동부,안동지청,고용노동부 대구지방고용노동청 안동지청,37,37,0,37,0,37,0,0
국가행정기관,고용노동부,영주지청,고용노동부 대구지방고용노동청 영주지청,24,24,0,24,0,24,0,0
국가행정기관,고용노동부,포항지청,고용노동부 대구지방고용노동청 포항지청,47,47,0,47,0,47,0,0
국가행정기관,고용노동부,대전지방고용노동청,고용노동부 대전지방고용노동청,127,127,0,127,84,43,0,0
국가행정기관,고용노동부,보령지청,고용노동부 대전지방고용노동청 보령지청,36,36,0,36,0,36,0,0
국가행정기관,고용노동부,서산출장소,고용노동부 대전지방고용노동청 서산출장소,22,22,0,22,0,22,0,0
국가행정기관,고용노동부,천안지청,고용노동부 대전지방고용노동청 천안지청,92,92,0,92,15,77,0,0
국가행정기관,고용노동부,청주지청,고용노동부 대전지방고용노동청 청주지청,75,75,0,75,61,14,0,0
국가행정기관,고용노동부,충주지청,고용노동부 대전지방고용노동청 충주지청,58,58,0,58,15,43,0,0
국가행정기관,고용노동부,부산지방고용노동청,고용노동부 부산지방고용노동청,118,118,0,118,118,0,0,0
국가행정기관,고용노동부,부산동부지청,고용노동부 부산지방고용노동청 부산동부지청,72,72,0,72,4,68,0,0
국가행정기관,고용노동부,부산북부지청,고용노동부 부산지방고용노동청 부산북부지청,24,24,0,24,0,24,0,0
국가행정기관,고용노동부,양산지청,고용노동부 부산지방고용노동청 양산지청,62,62,0,62,0,62,0,0
국가행정기관,고용노동부,울산지청,고용노동부 부산지방고용노동청 울산지청,40,40,0,40,20,20,0,0
국가행정기관,고용노동부,진주지청,고용노동부 부산지방고용노동청 진주지청,51,51,0,51,0,51,0,0
국가행정기관,고용노동부,창원지청,고용노동부 부산지방고용노동청 창원지청,109,109,0,109,0,109,0,0
국가행정기관,고용노동부,통영지청,고용노동부 부산지방고용노동청 통영지청,56,56,0,56,0,56,0,0
국가행정기관,고용노동부,산업재해보상보험재심사위원회,고용노동부 산업재해보상보험재심사위원회,0,0,0,0,0,0,0,0
국가행정기관,고용노동부,서울지방고용노동청,고용노동부 서울지방고용노동청,64,64,0,64,0,64,0,0
국가행정기관,고용노동부,서울강남지청,고용노동부 서울지방고용노동청 서울강남지청,31,31,0,31,0,31,0,0
국가행정기관,고용노동부,서울관악지청,고용노동부 서울지방고용노동청 서울관악지청,74,74,0,74,69,5,0,0
국가행정기관,고용노동부,서울남부지청,고용노동부 서울지방고용노동청 서울남부지청,96,96,0,96,1,95,0,0
국가행정기관,고용노동부,서울동부지청,고용노동부 서울지방고용노동청 서울동부지청,64,64,0,64,38,26,0,0
국가행정기관,고용노동부,서울북부지청,고용노동부 서울지방고용노동청 서울북부지청,92,92,0,92,0,92,0,0
국가행정기관,고용노동부,서울서부지청,고용노동부 서울지방고용노동청 서울서부지청,53,53,0,53,53,0,0,0
국가행정기관,고용노동부,중부지방고용노동청,고용노동부 중부지방고용노동청,76,76,0,76,0,76,0,0
국가행정기관,고용노동부,고양지청,고용노동부 중부지방고용노동청 고양지청,75,75,0,75,65,10,0,0
국가행정기관,고용노동부,부천지청,고용노동부 중부지방고용노동청 부천지청,88,88,0,88,88,0,0,0
국가행정기관,고용노동부,의정부지청,고용노동부 중부지방고용노동청 의정부지청,113,113,0,113,19,90,4,0
국가행정기관,고용노동부,인천북부지청,고용노동부 중부지방고용노동청 인천북부지청,55,48,7,48,0,48,0,0
국가행정기관,고용노동부,중앙노동위원회,고용노동부 중앙노동위원회,0,0,0,0,0,0,0,0
국가행정기관,고용노동부,강원지방노동위원회,고용노동부 중앙노동위원회 강원지방노동위원회,0,0,0,0,0,0,0,0
국가행정기관,고용노동부,경기지방노동위원회,고용노동부 중앙노동위원회 경기지방노동위원회,12,12,0,12,0,12,0,0
국가행정기관,고용노동부,경남지방노동위원회,고용노동부 중앙노동위원회 경남지방노동위원회,4,4,0,4,0,4,0,0
국가행정기관,고용노동부,경북지방노동위원회,고용노동부 중앙노동위원회 경북지방노동위원회,6,6,0,6,0,6,0,0
국가행정기관,고용노동부,부산지방노동위원회,고용노동부 중앙노동위원회 부산지방노동위원회,0,0,0,0,0,0,0,0
국가행정기관,고용노동부,서울지방노동위원회,고용노동부 중앙노동위원회 서울지방노동위원회,27,27,0,27,12,15,0,0
국가행정기관,고용노동부,울산지방노동위원회,고용노동부 중앙노동위원회 울산지방노동위원회,3,3,0,3,0,3,0,0
국가행정기관,고용노동부,인천지방노동위원회,고용노동부 중앙노동위원회 인천지방노동위원회,0,0,0,0,0,0,0,0
국가행정기관,고용노동부,전남지방노동위원회,고용노동부 중앙노동위원회 전남지방노동위원회,4,4,0,4,2,2,0,0
국가행정기관,고용노동부,전북지방노동위원회,고용노동부 중앙노동위원회 전북지방노동위원회,4,4,0,4,0,4,0,0
국가행정기관,고용노동부,충남지방노동위원회,고용노동부 중앙노동위원회 충남지방노동위원회,4,4,0,4,0,4,0,0
국가행정기관,고용노동부,충북지방노동위원회,고용노동부 중앙노동위원회 충북지방노동위원회,8,6,2,6,0,6,0,0
국가행정기관,고용노동부,최저임금위원회,고용노동부 최저임금위원회,0,0,0,0,0,0,0,0
국가행정기관,고용노동부,학교법인한국폴리텍,고용노동부 학교법인한국폴리텍,2476,2474,2,2474,0,2474,0,0
국가행정기관,고용노동부,한국고용노동교육원,고용노동부 한국고용노동교육원,45,42,3,42,0,42,0,0
국가행정기관,고용노동부,한국고용정보원,고용노동부 한국고용정보원,109,60,49,60,37,13,6,4
국가행정기관,고용노동부,한국기술교육대학교,고용노동부 한국기술교육대학교,613,613,0,613,173,440,0,0
국가행정기관,고용노동부,한국사회적기업진흥원 ,고용노동부 한국사회적기업진흥원 ,0,0,0,0,0,0,0,0
국가행정기관,고용노동부,한국산업안전보건공단,고용노동부 한국산업안전보건공단,207,206,1,206,47,159,0,0
국가행정기관,고용노동부,한국산업인력공단,고용노동부 한국산업인력공단,622,324,298,324,19,305,0,0
국가행정기관,고용노동부,한국잡월드,고용노동부 한국잡월드,234,234,0,234,0,234,0,0
국가행정기관,고용노동부,한국장애인고용공단,고용노동부 한국장애인고용공단,460,453,7,453,19,434,0,0
국가행정기관,고위공직자범죄수사처,고위공직자범죄수사처,고위공직자범죄수사처,43,0,43,0,0,0,0,0
국가행정기관,공정거래위원회,공정거래위원회,공정거래위원회,33,0,33,0,0,0,0,0
국가행정기관,공정거래위원회,한국공정거래조정원,공정거래위원회 한국공정거래조정원,4,4,0,4,0,4,0,0
국가행정기관,공정거래위원회,한국소비자원,공정거래위원회 한국소비자원,141,50,91,50,14,36,0,0
국가행정기관,과학기술정보통신부,과학기술정보통신부,과학기술정보통신부,59,0,59,0,0,0,0,0
국가행정기관,과학기술정보통신부,(재)우체국물류지원단,과학기술정보통신부 (재)우체국물류지원단,10,0,10,0,0,0,0,0
국가행정기관,과학기술정보통신부,(재)우체국시설관리단,과학기술정보통신부 (재)우체국시설관리단,4,4,0,4,2,2,0,0
국가행정기관,과학기술정보통신부,과학기술연합대학원대학교,과학기술정보통신부 과학기술연합대학원대학교,104,104,0,104,0,104,0,0
국가행정기관,과학기술정보통신부,광주과학기술원,과학기술정보통신부 광주과학기술원,716,176,540,176,176,0,0,0
국가행정기관,과학기술정보통신부,국가과학기술인력개발원,과학기술정보통신부 국가과학기술인력개발원,52,52,0,52,0,52,0,0
국가행정기관,과학기술정보통신부,국가보안기술연구소,과학기술정보통신부 국가보안기술연구소,267,3,264,3,1,2,0,0
국가행정기관,과학기술정보통신부,국가수리과학연구소,과학기술정보통신부 국가수리과학연구소,12,0,12,0,0,0,0,0
국가행정기관,과학기술정보통신부,국립광주과학관,과학기술정보통신부 국립광주과학관,210,210,0,210,0,210,0,0
국가행정기관,과학기술정보통신부,국립대구과학관,과학기술정보통신부 국립대구과학관,156,143,13,143,0,143,0,0
국가행정기관,과학기술정보통신부,국립부산과학관,과학기술정보통신부 국립부산과학관,182,168,14,168,56,94,0,18
국가행정기관,과학기술정보통신부,국립전파연구원,과학기술정보통신부 국립전파연구원,171,157,14,157,0,157,0,0
국가행정기관,과학기술정보통신부,국립중앙과학관,과학기술정보통신부 국립중앙과학관,239,239,0,239,0,239,0,0
국가행정기관,과학기술정보통신부,기초과학연구원,과학기술정보통신부 기초과학연구원,611,197,414,197,0,197,0,0
국가행정기관,과학기술정보통신부,대구경북과학기술원,과학기술정보통신부 대구경북과학기술원,1457,1375,82,1375,22,1353,0,0
국가행정기관,과학기술정보통신부,동남권원자력의학원,과학기술정보통신부 동남권원자력의학원,281,145,136,145,0,145,0,0
국가행정기관,과학기술정보통신부,연구개발특구진흥재단,과학기술정보통신부 연구개발특구진흥재단,39,3,36,3,3,0,0,0
국가행정기관,과학기술정보통신부,우정사업본부,과학기술정보통신부 우정사업본부,49550,39722,9828,39722,25140,14527,17,38
국가행정기관,과학기술정보통신부,한국우편사업진흥원,과학기술정보통신부 우정사업본부 한국우편사업진흥원,29,26,3,26,0,26,0,0
국가행정기관,과학기술정보통신부,우체국금융개발원,과학기술정보통신부 우체국금융개발원,423,391,32,391,372,19,0,0
국가행정기관,과학기술정보통신부,울산과학기술원,과학기술정보통신부 울산과학기술원,941,745,196,745,540,205,0,0
국가행정기관,과학기술정보통신부,정보통신산업진흥원,과학기술정보통신부 정보통신산업진흥원,63,62,1,62,0,62,0,0
국가행정기관,과학기술정보통신부,중앙전파관리소,과학기술정보통신부 중앙전파관리소,16,16,0,16,0,16,0,0
국가행정기관,과학기술정보통신부,강릉전파관리소,과학기술정보통신부 중앙전파관리소 강릉전파관리소,28,0,28,0,0,0,0,0
국가행정기관,과학기술정보통신부,광주전파관리소,과학기술정보통신부 중앙전파관리소 광주전파관리소,23,22,1,22,0,22,0,0
국가행정기관,과학기술정보통신부,대구전파관리소,과학기술정보통신부 중앙전파관리소 대구전파관리소,15,15,0,15,0,15,0,0
국가행정기관,과학기술정보통신부,대전전파관리소,과학기술정보통신부 중앙전파관리소 대전전파관리소,9,3,6,3,0,3,0,0
국가행정기관,과학기술정보통신부,당진사무소,과학기술정보통신부 중앙전파관리소 대전전파관리소 당진사무소,14,1,13,1,0,1,0,0
국가행정기관,과학기술정보통신부,부산전파관리소,과학기술정보통신부 중앙전파관리소 부산전파관리소,7,7,0,7,0,7,0,0
국가행정기관,과학기술정보통신부,서울전파관리소,과학기술정보통신부 중앙전파관리소 서울전파관리소,10,10,0,10,0,10,0,0
국가행정기관,과학기술정보통신부,서울북부사무소,과학기술정보통신부 중앙전파관리소 서울전파관리소 서울북부사무소,24,0,24,0,0,0,0,0
국가행정기관,과학기술정보통신부,울산전파관리소,과학기술정보통신부 중앙전파관리소 울산전파관리소,20,0,20,0,0,0,0,0
국가행정기관,과학기술정보통신부,위성전파감시센터,과학기술정보통신부 중앙전파관리소 위성전파감시센터,37,25,12,25,0,25,0,0
국가행정기관,과학기술정보통신부,전주전파관리소,과학기술정보통신부 중앙전파관리소 전주전파관리소,15,15,0,15,0,15,0,0
국가행정기관,과학기술정보통신부,제주전파관리소,과학기술정보통신부 중앙전파관리소 제주전파관리소,19,0,19,0,0,0,0,0
국가행정기관,과학기술정보통신부,청주전파관리소,과학기술정보통신부 중앙전파관리소 청주전파관리소,9,0,9,0,0,0,0,0
국가행정기관,과학기술정보통신부,한국건설기술연구원,과학기술정보통신부 한국건설기술연구원,120,0,120,0,0,0,0,0
국가행정기관,과학기술정보통신부,한국과학기술기획평가원(KISTEP),과학기술정보통신부 한국과학기술기획평가원(KISTEP),73,26,47,26,0,26,0,0
국가행정기관,과학기술정보통신부,한국과학기술연구원,과학기술정보통신부 한국과학기술연구원,354,354,0,354,0,354,0,0
국가행정기관,과학기술정보통신부,한국과학기술연구원부설녹색기술센터,과학기술정보통신부 한국과학기술연구원 한국과학기술연구원부설녹색기술센터,6,0,6,0,0,0,0,0
국가행정기관,과학기술정보통신부,한국과학기술원,과학기술정보통신부 한국과학기술원,1956,1581,375,1581,605,847,0,129
국가행정기관,과학기술정보통신부,한국과학기술원 부설 고등과학원,과학기술정보통신부 한국과학기술원 부설 고등과학원,0,0,0,0,0,0,0,0
국가행정기관,과학기술정보통신부,한국과학기술원부설나노종합기술원,과학기술정보통신부 한국과학기술원부설나노종합기술원,153,38,115,38,0,38,0,0
국가행정기관,과학기술정보통신부,한국과학기술원부설한국과학영재학교,과학기술정보통신부 한국과학기술원부설한국과학영재학교,189,189,0,189,38,151,0,0
국가행정기관,과학기술정보통신부,한국과학기술정보연구원,과학기술정보통신부 한국과학기술정보연구원,181,60,121,60,0,60,0,0
국가행정기관,과학기술정보통신부,한국과학창의재단,과학기술정보통신부 한국과학창의재단,11,11,0,11,0,11,0,0
국가행정기관,과학기술정보통신부,한국기계연구원,과학기술정보통신부 한국기계연구원,411,411,0,411,0,411,0,0
국가행정기관,과학기술정보통신부,한국기초과학지원연구원,과학기술정보통신부 한국기초과학지원연구원,347,347,0,347,0,347,0,0
국가행정기관,과학기술정보통신부,한국나노기술원,과학기술정보통신부 한국나노기술원,108,108,0,108,48,60,0,0
국가행정기관,과학기술정보통신부,한국데이터산업진흥원,과학기술정보통신부 한국데이터산업진흥원,24,13,11,13,5,8,0,0
국가행정기관,과학기술정보통신부,한국방송통신전파진흥원,과학기술정보통신부 한국방송통신전파진흥원,480,381,99,381,312,69,0,0
국가행정기관,과학기술정보통신부,한국생명공학연구원,과학기술정보통신부 한국생명공학연구원,494,494,0,494,0,494,0,0
국가행정기관,과학기술정보통신부,한국생산기술연구원,과학기술정보통신부 한국생산기술연구원,983,983,0,983,403,580,0,0
국가행정기관,과학기술정보통신부,한국식품연구원,과학기술정보통신부 한국식품연구원,224,224,0,224,0,224,0,0
국가행정기관,과학기술정보통신부,한국식품연구원부설세계김치연구소,과학기술정보통신부 한국식품연구원부설세계김치연구소,70,6,64,6,6,0,0,0
국가행정기관,과학기술정보통신부,한국에너지기술연구원,과학기술정보통신부 한국에너지기술연구원,404,404,0,404,13,391,0,0
국가행정기관,과학기술정보통신부,한국연구재단,과학기술정보통신부 한국연구재단,49,49,0,49,0,49,0,0
국가행정기관,과학기술정보통신부,정보통신기획평가원,과학기술정보통신부 한국연구재단 정보통신기획평가원,49,46,3,46,0,46,0,0
국가행정기관,과학기술정보통신부,한국원자력연구원,과학기술정보통신부 한국원자력연구원,307,0,307,0,0,0,0,0
국가행정기관,과학기술정보통신부,한국원자력의학원,과학기술정보통신부 한국원자력의학원,602,292,310,292,0,292,0,0
국가행정기관,과학기술정보통신부,한국인터넷진흥원,과학기술정보통신부 한국인터넷진흥원,237,90,147,90,18,72,0,0
국가행정기관,과학기술정보통신부,한국재료연구원,과학기술정보통신부 한국재료연구원,135,0,135,0,0,0,0,0
국가행정기관,과학기술정보통신부,한국전기연구원,과학기술정보통신부 한국전기연구원,265,113,152,113,0,113,0,0
국가행정기관,과학기술정보통신부,한국전자통신연구원,과학기술정보통신부 한국전자통신연구원,637,0,637,0,0,0,0,0
국가행정기관,과학기술정보통신부,한국지능정보사회진흥원,과학기술정보통신부 한국지능정보사회진흥원,115,17,98,17,0,17,0,0
국가행정기관,과학기술정보통신부,한국지질자원연구원,과학기술정보통신부 한국지질자원연구원,220,55,165,55,0,55,0,0
국가행정기관,과학기술정보통신부,한국천문연구원,과학기술정보통신부 한국천문연구원,65,12,53,12,5,5,1,1
국가행정기관,과학기술정보통신부,한국철도기술연구원,과학기술정보통신부 한국철도기술연구원,288,288,0,288,114,174,0,0
국가행정기관,과학기술정보통신부,한국표준과학연구원,과학기술정보통신부 한국표준과학연구원,278,179,99,179,0,179,0,0
국가행정기관,과학기술정보통신부,한국한의학연구원,과학기술정보통신부 한국한의학연구원,213,154,59,154,95,59,0,0
국가행정기관,과학기술정보통신부,한국항공우주연구원,과학기술정보통신부 한국항공우주연구원,984,11,973,11,0,11,0,0
국가행정기관,과학기술정보통신부,한국핵융합에너지연구원,과학기술정보통신부 한국핵융합에너지연구원,204,49,155,49,4,35,0,10
국가행정기관,과학기술정보통신부,한국화학연구원,과학기술정보통신부 한국화학연구원,284,254,30,254,210,44,0,0
국가행정기관,관세청,관세청,관세청,14,0,14,0,0,0,0,0
국가행정기관,관세청,경남남부세관,관세청 경남남부세관,8,7,1,7,6,1,0,0
국가행정기관,관세청,경남서부세관,관세청 경남서부세관,2,0,2,0,0,0,0,0
국가행정기관,관세청,관세인재개발원,관세청 관세인재개발원,171,171,0,171,0,171,0,0
국가행정기관,관세청,광양세관,관세청 광양세관,72,69,3,69,53,16,0,0
국가행정기관,관세청,광주세관,관세청 광주세관,36,33,3,33,0,33,0,0
국가행정기관,관세청,군산세관,관세청 군산세관,57,18,39,18,0,18,0,0
국가행정기관,관세청,김포공항세관,관세청 김포공항세관,64,60,4,60,60,0,0,0
국가행정기관,관세청,김해공항세관,관세청 김해공항세관,96,93,3,93,93,0,0,0
국가행정기관,관세청,대구세관,관세청 대구세관,12,9,3,9,9,0,0,0
국가행정기관,관세청,대전세관,관세청 대전세관,2,2,0,2,2,0,0,0
국가행정기관,관세청,동해세관,관세청 동해세관,27,0,27,0,0,0,0,0
국가행정기관,관세청,마산세관,관세청 마산세관,36,36,0,36,31,5,0,0
국가행정기관,관세청,목포세관,관세청 목포세관,18,15,3,15,12,3,0,0
국가행정기관,관세청,부산세관,관세청 부산세관,339,221,118,221,164,57,0,0
국가행정기관,관세청,부평세관,관세청 부평세관,4,4,0,4,0,4,0,0
국가행정기관,관세청,서울세관,관세청 서울세관,114,89,25,89,0,89,0,0
국가행정기관,관세청,속초세관,관세청 속초세관,97,88,9,88,49,39,0,0
국가행정기관,관세청,수원세관,관세청 수원세관,9,9,0,9,0,9,0,0
국가행정기관,관세청,안산세관,관세청 안산세관,3,3,0,3,0,3,0,0
국가행정기관,관세청,양산세관,관세청 양산세관,2,0,2,0,0,0,0,0
국가행정기관,관세청,여수세관,관세청 여수세관,59,0,59,0,0,0,0,0
국가행정기관,관세청,용당세관,관세청 용당세관,36,36,0,36,2,34,0,0
국가행정기관,관세청,울산세관,관세청 울산세관,94,0,94,0,0,0,0,0
국가행정기관,관세청,인천공항국제우편세관,관세청 인천공항국제우편세관,10,0,10,0,0,0,0,0
국가행정기관,관세청,인천세관,관세청 인천세관,987,940,47,940,692,248,0,0
국가행정기관,관세청,재단법인국제원산지정보원,관세청 재단법인국제원산지정보원,2,0,2,0,0,0,0,0
국가행정기관,관세청,전주세관,관세청 전주세관,1,0,1,0,0,0,0,0
국가행정기관,관세청,제주세관,관세청 제주세관,54,12,42,12,12,0,0,0
국가행정기관,관세청,중앙관세분석소,관세청 중앙관세분석소,5,5,0,5,0,5,0,0
국가행정기관,관세청,창원세관,관세청 창원세관,12,12,0,12,9,3,0,0
국가행정기관,관세청,천안세관,관세청 천안세관,2,2,0,2,0,2,0,0
국가행정기관,관세청,파주세관,관세청 파주세관,8,8,0,8,0,8,0,0
국가행정기관,관세청,의정부지원센터,관세청 파주세관 의정부지원센터,16,16,0,16,0,16,0,0
국가행정기관,관세청,평택세관,관세청 평택세관,149,100,49,100,29,71,0,0
국가행정기관,관세청,포항세관,관세청 포항세관,40,39,1,39,39,0,0,0
국가행정기관,교육부,교육부,교육부,0,0,0,0,0,0,0,0
국가행정기관,교육부,교원소청심사위원회,교육부 교원소청심사위원회,0,0,0,0,0,0,0,0
국가행정기관,교육부,국가평생교육진흥원,교육부 국가평생교육진흥원,0,0,0,0,0,0,0,0
국가행정기관,교육부,국립국제교육원,교육부 국립국제교육원,86,40,46,40,40,0,0,0
국가행정기관,교육부,국립특수교육원,교육부 국립특수교육원,47,45,2,45,45,0,0,0
국가행정기관,교육부,국사편찬위원회,교육부 국사편찬위원회,65,65,0,65,0,65,0,0
국가행정기관,교육부,동북아역사재단,교육부 동북아역사재단,19,9,10,9,3,6,0,0
국가행정기관,교육부,사립학교교직원연금공단,교육부 사립학교교직원연금공단,213,203,10,203,0,203,0,0
국가행정기관,교육부,유네스코한국위원회,교육부 유네스코한국위원회,59,59,0,59,0,59,0,0
국가행정기관,교육부,중앙교육연수원,교육부 중앙교육연수원,83,65,18,65,65,0,0,0
국가행정기관,교육부,학술원사무국,교육부 학술원사무국,4,4,0,4,0,4,0,0
국가행정기관,교육부,한국고전번역원,교육부 한국고전번역원,44,44,0,44,0,44,0,0
국가행정기관,교육부,한국교육학술정보원,교육부 한국교육학술정보원,156,56,100,56,47,9,0,0
국가행정기관,교육부,한국대학교육협의회,교육부 한국대학교육협의회,21,15,6,15,0,15,0,0
국가행정기관,교육부,한국사학진흥재단,교육부 한국사학진흥재단,30,24,6,24,0,24,0,0
국가행정기관,교육부,한국장학재단,교육부 한국장학재단,386,227,159,227,5,222,0,0
국가행정기관,교육부,한국전문대학교육협의회,교육부 한국전문대학교육협의회,0,0,0,0,0,0,0,0
국가행정기관,교육부,한국학중앙연구원,교육부 한국학중앙연구원,202,202,0,202,0,202,0,0
국가행정기관,국가교육위원회,국가교육위원회,국가교육위원회,0,0,0,0,0,0,0,0
국가행정기관,국가보훈처,88관광개발(주),국가보훈처 88관광개발(주),158,158,0,158,93,65,0,0
국가행정기관,국가보훈처,강원동부보훈지청,국가보훈처 강원동부보훈지청,16,16,0,16,0,16,0,0
국가행정기관,국가보훈처,강원서부보훈지청,국가보훈처 강원서부보훈지청,5,5,0,5,0,5,0,0
국가행정기관,국가보훈처,경기남부보훈지청,국가보훈처 경기남부보훈지청,27,27,0,27,0,27,0,0
국가행정기관,국가보훈처,경기동부보훈지청,국가보훈처 경기동부보훈지청,12,12,0,12,9,3,0,0
국가행정기관,국가보훈처,경기북부보훈지청,국가보훈처 경기북부보훈지청,8,8,0,8,0,8,0,0
국가행정기관,국가보훈처,경남동부보훈지청,국가보훈처 경남동부보훈지청,12,12,0,12,0,12,0,0
국가행정기관,국가보훈처,경남서부보훈지청,국가보훈처 경남서부보훈지청,11,11,0,11,0,11,0,0
국가행정기관,국가보훈처,경북남부보훈지청,국가보훈처 경북남부보훈지청,9,9,0,9,0,9,0,0
국가행정기관,국가보훈처,경북북부보훈지청,국가보훈처 경북북부보훈지청,5,4,1,4,0,4,0,0
국가행정기관,국가보훈처,광주지방보훈청,국가보훈처 광주지방보훈청,10,10,0,10,0,10,0,0
국가행정기관,국가보훈처,국립3.15민주묘지관리소,국가보훈처 국립3.15민주묘지관리소,20,20,0,20,0,20,0,0
국가행정기관,국가보훈처,국립4.19민주묘지관리소,국가보훈처 국립4.19민주묘지관리소,24,24,0,24,0,24,0,0
국가행정기관,국가보훈처,국립5.18민주묘지관리소,국가보훈처 국립5.18민주묘지관리소,51,51,0,51,0,51,0,0
국가행정기관,국가보훈처,국립대전현충원,국가보훈처 국립대전현충원,226,222,4,222,0,222,0,0
국가행정기관,국가보훈처,국립대한민국임시정부기념관,국가보훈처 국립대한민국임시정부기념관,85,7,78,7,0,7,0,0
국가행정기관,국가보훈처,국립산청호국원,국가보훈처 국립산청호국원,32,32,0,32,0,32,0,0
국가행정기관,국가보훈처,국립영천호국원,국가보훈처 국립영천호국원,137,137,0,137,9,128,0,0
국가행정기관,국가보훈처,국립이천호국원,국가보훈처 국립이천호국원,57,57,0,57,0,57,0,0
국가행정기관,국가보훈처,국립임실호국원,국가보훈처 국립임실호국원,79,79,0,79,0,79,0,0
국가행정기관,국가보훈처,국립제주호국원,국가보훈처 국립제주호국원,83,83,0,83,36,47,0,0
국가행정기관,국가보훈처,대구지방보훈청,국가보훈처 대구지방보훈청,11,11,0,11,0,11,0,0
국가행정기관,국가보훈처,대전지방보훈청,국가보훈처 대전지방보훈청,6,6,0,6,0,6,0,0
국가행정기관,국가보훈처,독립기념관,국가보훈처 독립기념관,394,358,36,358,0,358,0,0
국가행정기관,국가보훈처,보훈심사위원회,국가보훈처 보훈심사위원회,10,7,3,7,0,7,0,0
국가행정기관,국가보훈처,부산지방보훈청,국가보훈처 부산지방보훈청,41,41,0,41,0,41,0,0
국가행정기관,국가보훈처,서울남부보훈지청,국가보훈처 서울남부보훈지청,11,11,0,11,0,11,0,0
국가행정기관,국가보훈처,서울북부보훈지청,국가보훈처 서울북부보훈지청,29,29,0,29,0,29,0,0
국가행정기관,국가보훈처,서울지방보훈청,국가보훈처 서울지방보훈청,25,25,0,25,0,25,0,0
국가행정기관,국가보훈처,울산보훈지청,국가보훈처 울산보훈지청,8,8,0,8,2,6,0,0
국가행정기관,국가보훈처,인천보훈지청,국가보훈처 인천보훈지청,18,18,0,18,0,18,0,0
국가행정기관,국가보훈처,전남동부보훈지청,국가보훈처 전남동부보훈지청,8,8,0,8,0,8,0,0
국가행정기관,국가보훈처,전남서부보훈지청,국가보훈처 전남서부보훈지청,8,8,0,8,2,6,0,0
국가행정기관,국가보훈처,전북동부보훈지청,국가보훈처 전북동부보훈지청,8,8,0,8,0,8,0,0
국가행정기관,국가보훈처,전북서부보훈지청,국가보훈처 전북서부보훈지청,9,9,0,9,0,9,0,0
국가행정기관,국가보훈처,충남동부보훈지청,국가보훈처 충남동부보훈지청,10,10,0,10,0,10,0,0
국가행정기관,국가보훈처,충남서부보훈지청,국가보훈처 충남서부보훈지청,10,10,0,10,0,10,0,0
국가행정기관,국가보훈처,충북남부보훈지청,국가보훈처 충북남부보훈지청,5,5,0,5,2,3,0,0
국가행정기관,국가보훈처,충북북부보훈지청,국가보훈처 충북북부보훈지청,8,8,0,8,4,4,0,0
국가행정기관,국가보훈처,한국보훈복지의료공단,국가보훈처 한국보훈복지의료공단,53,5,48,5,0,5,0,0
국가행정기관,국가보훈처,광주보훈병원,국가보훈처 한국보훈복지의료공단 광주보훈병원,396,359,37,359,103,256,0,0
국가행정기관,국가보훈처,광주보훈요양원,국가보훈처 한국보훈복지의료공단 광주보훈요양원,69,69,0,69,0,69,0,0
국가행정기관,국가보훈처,김해보훈요양원,국가보훈처 한국보훈복지의료공단 김해보훈요양원,88,88,0,88,0,88,0,0
국가행정기관,국가보훈처,남양주보훈요양원,국가보훈처 한국보훈복지의료공단 남양주보훈요양원,82,14,68,14,0,14,0,0
국가행정기관,국가보훈처,대구보훈병원,국가보훈처 한국보훈복지의료공단 대구보훈병원,216,216,0,216,0,216,0,0
국가행정기관,국가보훈처,대구보훈요양원,국가보훈처 한국보훈복지의료공단 대구보훈요양원,56,56,0,56,0,56,0,0
국가행정기관,국가보훈처,대전보훈병원,국가보훈처 한국보훈복지의료공단 대전보훈병원,128,128,0,128,40,88,0,0
국가행정기관,국가보훈처,대전보훈요양원,국가보훈처 한국보훈복지의료공단 대전보훈요양원,69,69,0,69,0,69,0,0
국가행정기관,국가보훈처,보훈교육연구원,국가보훈처 한국보훈복지의료공단 보훈교육연구원,30,30,0,30,5,25,0,0
국가행정기관,국가보훈처,보훈원,국가보훈처 한국보훈복지의료공단 보훈원,78,78,0,78,38,40,0,0
국가행정기관,국가보훈처,보훈재활체육센터,국가보훈처 한국보훈복지의료공단 보훈재활체육센터,77,77,0,77,0,77,0,0
국가행정기관,국가보훈처,보훈휴양원,국가보훈처 한국보훈복지의료공단 보훈휴양원,33,33,0,33,7,20,6,0
국가행정기관,국가보훈처,부산보훈병원,국가보훈처 한국보훈복지의료공단 부산보훈병원,374,374,0,374,0,374,0,0
국가행정기관,국가보훈처,원주보훈요양원,국가보훈처 한국보훈복지의료공단 원주보훈요양원,79,79,0,79,0,79,0,0
국가행정기관,국가보훈처,위탁병원관리단,국가보훈처 한국보훈복지의료공단 위탁병원관리단,0,0,0,0,0,0,0,0
국가행정기관,국가보훈처,인천보훈병원,국가보훈처 한국보훈복지의료공단 인천보훈병원,144,140,4,140,0,140,0,0
국가행정기관,국가보훈처,전주보훈요양원,국가보훈처 한국보훈복지의료공단 전주보훈요양원,86,86,0,86,0,86,0,0
국가행정기관,국가보훈처,중앙보훈병원,국가보훈처 한국보훈복지의료공단 중앙보훈병원,779,717,62,717,0,717,0,0
국가행정기관,국무조정실,국무조정실,국무조정실,0,0,0,0,0,0,0,0
국가행정기관,국무조정실,경제·인문사회연구회,국무조정실 경제·인문사회연구회,10,0,10,0,0,0,0,0
국가행정기관,국무조정실,건축공간연구원,국무조정실 경제·인문사회연구회 건축공간연구원,0,0,0,0,0,0,0,0
국가행정기관,국무조정실,국토연구원,국무조정실 경제·인문사회연구회 국토연구원,72,64,8,64,0,64,0,0
국가행정기관,국무조정실,대외경제정책연구원,국무조정실 경제·인문사회연구회 대외경제정책연구원,0,0,0,0,0,0,0,0
국가행정기관,국무조정실,에너지경제연구원,국무조정실 경제·인문사회연구회 에너지경제연구원,52,52,0,52,0,52,0,0
국가행정기관,국무조정실,육아정책연구소,국무조정실 경제·인문사회연구회 육아정책연구소,0,0,0,0,0,0,0,0
국가행정기관,국무조정실,정보통신정책연구원,국무조정실 경제·인문사회연구회 정보통신정책연구원,64,0,64,0,0,0,0,0
국가행정기관,국무조정실,통일연구원,국무조정실 경제·인문사회연구회 통일연구원,0,0,0,0,0,0,0,0
국가행정기관,국무조정실,한국개발연구원,국무조정실 경제·인문사회연구회 한국개발연구원,175,35,140,35,0,35,0,0
국가행정기관,국무조정실,한국교육개발원,국무조정실 경제·인문사회연구회 한국교육개발원,91,91,0,91,0,91,0,0
국가행정기관,국무조정실,한국교육과정평가원,국무조정실 경제·인문사회연구회 한국교육과정평가원,126,33,93,33,0,33,0,0
국가행정기관,국무조정실,한국교통연구원,국무조정실 경제·인문사회연구회 한국교통연구원,0,0,0,0,0,0,0,0
국가행정기관,국무조정실,한국노동연구원,국무조정실 경제·인문사회연구회 한국노동연구원,0,0,0,0,0,0,0,0
국가행정기관,국무조정실,한국농촌경제연구원,국무조정실 경제·인문사회연구회 한국농촌경제연구원,79,74,5,74,14,60,0,0
국가행정기관,국무조정실,한국법제연구원,국무조정실 경제·인문사회연구회 한국법제연구원,25,9,16,9,0,9,0,0
국가행정기관,국무조정실,한국보건사회연구원,국무조정실 경제·인문사회연구회 한국보건사회연구원,0,0,0,0,0,0,0,0
국가행정기관,국무조정실,한국여성정책연구원,국무조정실 경제·인문사회연구회 한국여성정책연구원,57,57,0,57,0,57,0,0
국가행정기관,국무조정실,한국조세재정연구원,국무조정실 경제·인문사회연구회 한국조세재정연구원,39,9,30,9,0,9,0,0
국가행정기관,국무조정실,한국직업능력연구원,국무조정실 경제·인문사회연구회 한국직업능력연구원,0,0,0,0,0,0,0,0
국가행정기관,국무조정실,한국청소년정책연구원,국무조정실 경제·인문사회연구회 한국청소년정책연구원,0,0,0,0,0,0,0,0
국가행정기관,국무조정실,한국해양수산개발원,국무조정실 경제·인문사회연구회 한국해양수산개발원,60,16,44,16,16,0,0,0
국가행정기관,국무조정실,한국행정연구원,국무조정실 경제·인문사회연구회 한국행정연구원,33,32,1,32,0,32,0,0
국가행정기관,국무조정실,한국환경연구원,국무조정실 경제·인문사회연구회 한국환경연구원,6,0,6,0,0,0,0,0
국가행정기관,국민권익위원회,국민권익위원회,국민권익위원회,0,0,0,0,0,0,0,0
국가행정기관,국민권익위원회,정부합동민원센터,국민권익위원회 정부합동민원센터,27,27,0,27,24,3,0,0
국가행정기관,국민권익위원회,청렴연수원,국민권익위원회 청렴연수원,37,36,1,36,20,16,0,0
국가행정기관,국방부,국방부,국방부,18,6,12,6,6,0,0,0
국가행정기관,국방부,국립서울현충원,국방부 국립서울현충원,122,122,0,122,0,122,0,0
국가행정기관,국방부,국방전산정보원,국방부 국방전산정보원,24,0,24,0,0,0,0,0
국가행정기관,국방부,국방전직교육원,국방부 국방전직교육원,8,0,8,0,0,0,0,0
국가행정기관,국방부,국방홍보원,국방부 국방홍보원,18,12,6,12,0,12,0,0
국가행정기관,국방부,전쟁기념사업회,국방부 전쟁기념사업회,232,232,0,232,0,232,0,0
국가행정기관,국방부,한국국방연구원,국방부 한국국방연구원,90,84,6,84,0,84,0,0
국가행정기관,국세청,국세청,국세청,18,0,18,0,0,0,0,0
국가행정기관,국세청,광주지방국세청,국세청 광주지방국세청,13,13,0,13,13,0,0,0
국가행정기관,국세청,광산세무서,국세청 광주지방국세청 광산세무서,60,51,9,51,0,51,0,0
국가행정기관,국세청,광주세무서,국세청 광주지방국세청 광주세무서,26,26,0,26,0,26,0,0
국가행정기관,국세청,군산세무서,국세청 광주지방국세청 군산세무서,34,33,1,33,18,3,6,6
국가행정기관,국세청,나주세무서,국세청 광주지방국세청 나주세무서,12,12,0,12,12,0,0,0
국가행정기관,국세청,남원세무서,국세청 광주지방국세청 남원세무서,38,32,6,32,7,16,8,1
국가행정기관,국세청,목포세무서,국세청 광주지방국세청 목포세무서,14,14,0,14,0,10,0,4
국가행정기관,국세청,북광주세무서,국세청 광주지방국세청 북광주세무서,36,3,33,3,0,3,0,0
국가행정기관,국세청,북전주세무서,국세청 광주지방국세청 북전주세무서,24,22,2,22,10,12,0,0
국가행정기관,국세청,서광주세무서,국세청 광주지방국세청 서광주세무서,44,44,0,44,0,44,0,0
국가행정기관,국세청,순천세무서,국세청 광주지방국세청 순천세무서,55,52,3,52,6,46,0,0
국가행정기관,국세청,여수세무서,국세청 광주지방국세청 여수세무서,23,15,8,15,15,0,0,0
국가행정기관,국세청,익산세무서,국세청 광주지방국세청 익산세무서,23,17,6,17,0,17,0,0
국가행정기관,국세청,전주세무서,국세청 광주지방국세청 전주세무서,20,20,0,20,0,20,0,0
국가행정기관,국세청,정읍세무서,국세청 광주지방국세청 정읍세무서,19,19,0,19,9,10,0,0
국가행정기관,국세청,해남세무서,국세청 광주지방국세청 해남세무서,29,29,0,29,14,15,0,0
국가행정기관,국세청,국세공무원교육원,국세청 국세공무원교육원,198,35,163,35,0,35,0,0
국가행정기관,국세청,국세청주류면허지원센터,국세청 국세청주류면허지원센터,41,10,31,10,0,10,0,0
국가행정기관,국세청,대구지방국세청,국세청 대구지방국세청,17,4,13,4,0,4,0,0
국가행정기관,국세청,경산세무서,국세청 대구지방국세청 경산세무서,13,12,1,12,0,12,0,0
국가행정기관,국세청,경주세무서,국세청 대구지방국세청 경주세무서,27,26,1,26,0,26,0,0
국가행정기관,국세청,구미세무서,국세청 대구지방국세청 구미세무서,27,21,6,21,21,0,0,0
국가행정기관,국세청,김천세무서,국세청 대구지방국세청 김천세무서,16,16,0,16,11,5,0,0
국가행정기관,국세청,남대구세무서,국세청 대구지방국세청 남대구세무서,65,65,0,65,26,23,16,0
국가행정기관,국세청,동대구세무서,국세청 대구지방국세청 동대구세무서,35,35,0,35,0,35,0,0
국가행정기관,국세청,북대구세무서,국세청 대구지방국세청 북대구세무서,30,30,0,30,0,30,0,0
국가행정기관,국세청,상주세무서,국세청 대구지방국세청 상주세무서,19,19,0,19,0,19,0,0
국가행정기관,국세청,서대구세무서,국세청 대구지방국세청 서대구세무서,38,36,2,36,2,18,15,1
국가행정기관,국세청,수성세무서,국세청 대구지방국세청 수성세무서,19,18,1,18,18,0,0,0
국가행정기관,국세청,안동세무서,국세청 대구지방국세청 안동세무서,33,30,3,30,4,26,0,0
국가행정기관,국세청,영덕세무서,국세청 대구지방국세청 영덕세무서,26,18,8,18,0,18,0,0
국가행정기관,국세청,영주세무서,국세청 대구지방국세청 영주세무서,22,19,3,19,0,19,0,0
국가행정기관,국세청,포항세무서,국세청 대구지방국세청 포항세무서,36,34,2,34,0,34,0,0
국가행정기관,국세청,대전지방국세청,국세청 대전지방국세청,108,30,78,30,30,0,0,0
국가행정기관,국세청,공주세무서,국세청 대전지방국세청 공주세무서,34,17,17,17,6,11,0,0
국가행정기관,국세청,논산세무서,국세청 대전지방국세청 논산세무서,27,23,4,23,12,11,0,0
국가행정기관,국세청,대전세무서,국세청 대전지방국세청 대전세무서,21,20,1,20,18,2,0,0
국가행정기관,국세청,동청주세무서,국세청 대전지방국세청 동청주세무서,28,19,9,19,7,12,0,0
국가행정기관,국세청,보령세무서,국세청 대전지방국세청 보령세무서,16,12,4,12,0,12,0,0
국가행정기관,국세청,북대전세무서,국세청 대전지방국세청 북대전세무서,63,35,28,35,20,15,0,0
국가행정기관,국세청,서대전세무서,국세청 대전지방국세청 서대전세무서,36,15,21,15,15,0,0,0
국가행정기관,국세청,서산세무서,국세청 대전지방국세청 서산세무서,15,9,6,9,3,6,0,0
국가행정기관,국세청,세종세무서,국세청 대전지방국세청 세종세무서,53,49,4,49,26,23,0,0
국가행정기관,국세청,아산세무서,국세청 대전지방국세청 아산세무서,18,14,4,14,10,4,0,0
국가행정기관,국세청,영동세무서,국세청 대전지방국세청 영동세무서,18,18,0,18,5,13,0,0
국가행정기관,국세청,예산세무서,국세청 대전지방국세청 예산세무서,47,44,3,44,8,36,0,0
국가행정기관,국세청,제천세무서,국세청 대전지방국세청 제천세무서,41,40,1,40,14,26,0,0
국가행정기관,국세청,천안세무서,국세청 대전지방국세청 천안세무서,54,51,3,51,37,14,0,0
국가행정기관,국세청,청주세무서,국세청 대전지방국세청 청주세무서,18,11,7,11,0,11,0,0
국가행정기관,국세청,충주세무서,국세청 대전지방국세청 충주세무서,20,14,6,14,3,11,0,0
국가행정기관,국세청,홍성세무서,국세청 대전지방국세청 홍성세무서,17,16,1,16,0,16,0,0
국가행정기관,국세청,부산지방국세청,국세청 부산지방국세청,92,37,55,37,0,37,0,0
국가행정기관,국세청,거창세무서,국세청 부산지방국세청 거창세무서,12,11,1,11,11,0,0,0
국가행정기관,국세청,금정세무서,국세청 부산지방국세청 금정세무서,29,29,0,29,10,19,0,0
국가행정기관,국세청,김해세무서,국세청 부산지방국세청 김해세무서,43,37,6,37,17,17,2,1
국가행정기관,국세청,동래세무서,국세청 부산지방국세청 동래세무서,63,39,24,39,0,39,0,0
국가행정기관,국세청,동울산세무서,국세청 부산지방국세청 동울산세무서,25,15,10,15,0,15,0,0
국가행정기관,국세청,마산세무서,국세청 부산지방국세청 마산세무서,64,34,30,34,8,26,0,0
국가행정기관,국세청,부산강서세무서,국세청 부산지방국세청 부산강서세무서,18,11,7,11,0,11,0,0
국가행정기관,국세청,부산진세무서,국세청 부산지방국세청 부산진세무서,39,12,27,12,4,8,0,0
국가행정기관,국세청,북부산세무서,국세청 부산지방국세청 북부산세무서,31,23,8,23,5,18,0,0
국가행정기관,국세청,서부산세무서,국세청 부산지방국세청 서부산세무서,38,36,2,36,9,27,0,0
국가행정기관,국세청,수영세무서,국세청 부산지방국세청 수영세무서,44,44,0,44,0,44,0,0
국가행정기관,국세청,양산세무서,국세청 부산지방국세청 양산세무서,17,16,1,16,0,16,0,0
국가행정기관,국세청,울산세무서,국세청 부산지방국세청 울산세무서,23,14,9,14,0,14,0,0
국가행정기관,국세청,제주세무서,국세청 부산지방국세청 제주세무서,22,19,3,19,19,0,0,0
국가행정기관,국세청,중부산세무서,국세청 부산지방국세청 중부산세무서,18,12,6,12,5,7,0,0
국가행정기관,국세청,진주세무서,국세청 부산지방국세청 진주세무서,53,46,7,46,2,44,0,0
국가행정기관,국세청,창원세무서,국세청 부산지방국세청 창원세무서,24,24,0,24,0,24,0,0
국가행정기관,국세청,통영세무서,국세청 부산지방국세청 통영세무서,18,18,0,18,0,18,0,0
국가행정기관,국세청,해운대세무서,국세청 부산지방국세청 해운대세무서,26,15,11,15,0,15,0,0
국가행정기관,국세청,서울지방국세청,국세청 서울지방국세청,42,19,23,19,6,13,0,0
국가행정기관,국세청,강남세무서,국세청 서울지방국세청 강남세무서,41,38,3,38,0,38,0,0
국가행정기관,국세청,강동세무서,국세청 서울지방국세청 강동세무서,20,20,0,20,0,20,0,0
국가행정기관,국세청,강서세무서,국세청 서울지방국세청 강서세무서,48,46,2,46,0,46,0,0
국가행정기관,국세청,관악세무서,국세청 서울지방국세청 관악세무서,23,22,1,22,6,16,0,0
국가행정기관,국세청,구로세무서,국세청 서울지방국세청 구로세무서,23,23,0,23,16,7,0,0
국가행정기관,국세청,금천세무서,국세청 서울지방국세청 금천세무서,18,8,10,8,0,8,0,0
국가행정기관,국세청,남대문세무서,국세청 서울지방국세청 남대문세무서,12,12,0,12,0,12,0,0
국가행정기관,국세청,노원세무서,국세청 서울지방국세청 노원세무서,28,28,0,28,0,28,0,0
국가행정기관,국세청,도봉세무서,국세청 서울지방국세청 도봉세무서,26,23,3,23,0,18,5,0
국가행정기관,국세청,동대문세무서,국세청 서울지방국세청 동대문세무서,37,37,0,37,12,25,0,0
국가행정기관,국세청,동작세무서,국세청 서울지방국세청 동작세무서,46,29,17,29,0,29,0,0
국가행정기관,국세청,마포세무서,국세청 서울지방국세청 마포세무서,91,91,0,91,17,74,0,0
국가행정기관,국세청,반포세무서,국세청 서울지방국세청 반포세무서,76,56,20,56,36,20,0,0
국가행정기관,국세청,삼성세무서,국세청 서울지방국세청 삼성세무서,10,10,0,10,10,0,0,0
국가행정기관,국세청,서대문세무서,국세청 서울지방국세청 서대문세무서,36,9,27,9,0,9,0,0
국가행정기관,국세청,서초세무서,국세청 서울지방국세청 서초세무서,10,10,0,10,0,10,0,0
국가행정기관,국세청,성동세무서,국세청 서울지방국세청 성동세무서,55,55,0,55,0,55,0,0
국가행정기관,국세청,성북세무서,국세청 서울지방국세청 성북세무서,43,43,0,43,27,16,0,0
국가행정기관,국세청,송파세무서,국세청 서울지방국세청 송파세무서,21,21,0,21,0,21,0,0
국가행정기관,국세청,양천세무서,국세청 서울지방국세청 양천세무서,20,20,0,20,0,20,0,0
국가행정기관,국세청,역삼세무서,국세청 서울지방국세청 역삼세무서,29,29,0,29,29,0,0,0
국가행정기관,국세청,영등포세무서,국세청 서울지방국세청 영등포세무서,23,23,0,23,8,15,0,0
국가행정기관,국세청,용산세무서,국세청 서울지방국세청 용산세무서,20,20,0,20,0,20,0,0
국가행정기관,국세청,은평세무서,국세청 서울지방국세청 은평세무서,17,17,0,17,0,17,0,0
국가행정기관,국세청,잠실세무서,국세청 서울지방국세청 잠실세무서,29,13,16,13,5,8,0,0
국가행정기관,국세청,종로세무서,국세청 서울지방국세청 종로세무서,30,28,2,28,0,28,0,0
국가행정기관,국세청,중랑세무서,국세청 서울지방국세청 중랑세무서,45,45,0,45,0,45,0,0
국가행정기관,국세청,중부세무서,국세청 서울지방국세청 중부세무서,31,9,22,9,0,9,0,0
국가행정기관,국세청,인천지방국세청,국세청 인천지방국세청,31,0,31,0,0,0,0,0
국가행정기관,국세청,계양세무서,국세청 인천지방국세청 계양세무서,48,34,14,34,0,34,0,0
국가행정기관,국세청,고양세무서,국세청 인천지방국세청 고양세무서,36,26,10,26,26,0,0,0
국가행정기관,국세청,광명세무서,국세청 인천지방국세청 광명세무서,18,17,1,17,0,17,0,0
국가행정기관,국세청,김포세무서,국세청 인천지방국세청 김포세무서,28,28,0,28,0,28,0,0
국가행정기관,국세청,남동세무서,국세청 인천지방국세청 남동세무서,33,30,3,30,0,30,0,0
국가행정기관,국세청,남부천세무서,국세청 인천지방국세청 남부천세무서,43,15,28,15,0,15,0,0
국가행정기관,국세청,동고양세무서,국세청 인천지방국세청 동고양세무서,19,19,0,19,19,0,0,0
국가행정기관,국세청,부천세무서,국세청 인천지방국세청 부천세무서,41,41,0,41,41,0,0,0
국가행정기관,국세청,부평세무서,국세청 인천지방국세청 부평세무서,48,45,3,45,12,33,0,0
국가행정기관,국세청,서인천세무서,국세청 인천지방국세청 서인천세무서,55,27,28,27,15,12,0,0
국가행정기관,국세청,연수세무서,국세청 인천지방국세청 연수세무서,20,11,9,11,0,11,0,0
국가행정기관,국세청,의정부세무서,국세청 인천지방국세청 의정부세무서,23,23,0,23,0,23,0,0
국가행정기관,국세청,인천세무서,국세청 인천지방국세청 인천세무서,31,31,0,31,0,31,0,0
국가행정기관,국세청,파주세무서,국세청 인천지방국세청 파주세무서,24,24,0,24,0,24,0,0
국가행정기관,국세청,포천세무서,국세청 인천지방국세청 포천세무서,16,4,12,4,0,4,0,0
국가행정기관,국세청,중부지방국세청,국세청 중부지방국세청,93,89,4,89,71,18,0,0
국가행정기관,국세청,강릉세무서,국세청 중부지방국세청 강릉세무서,21,21,0,21,5,16,0,0
국가행정기관,국세청,경기광주세무서,국세청 중부지방국세청 경기광주세무서,36,35,1,35,0,35,0,0
국가행정기관,국세청,구리세무서,국세청 중부지방국세청 구리세무서,30,30,0,30,30,0,0,0
국가행정기관,국세청,기흥세무서,국세청 중부지방국세청 기흥세무서,36,34,2,34,28,4,1,1
국가행정기관,국세청,남양주세무서,국세청 중부지방국세청 남양주세무서,9,9,0,9,0,9,0,0
국가행정기관,국세청,동수원세무서,국세청 중부지방국세청 동수원세무서,18,18,0,18,0,18,0,0
국가행정기관,국세청,동안산세무서,국세청 중부지방국세청 동안산세무서,32,7,25,7,7,0,0,0
국가행정기관,국세청,동안양세무서,국세청 중부지방국세청 동안양세무서,29,29,0,29,4,25,0,0
국가행정기관,국세청,동화성세무서,국세청 중부지방국세청 동화성세무서,26,17,9,17,17,0,0,0
국가행정기관,국세청,분당세무서,국세청 중부지방국세청 분당세무서,72,72,0,72,15,57,0,0
국가행정기관,국세청,삼척세무서,국세청 중부지방국세청 삼척세무서,40,36,4,36,0,36,0,0
국가행정기관,국세청,성남세무서,국세청 중부지방국세청 성남세무서,42,42,0,42,0,42,0,0
국가행정기관,국세청,속초세무서,국세청 중부지방국세청 속초세무서,23,23,0,23,15,8,0,0
국가행정기관,국세청,수원세무서,국세청 중부지방국세청 수원세무서,23,19,4,19,0,11,8,0
국가행정기관,국세청,시흥세무서,국세청 중부지방국세청 시흥세무서,31,31,0,31,13,18,0,0
국가행정기관,국세청,안산세무서,국세청 중부지방국세청 안산세무서,61,55,6,55,34,21,0,0
국가행정기관,국세청,안양세무서,국세청 중부지방국세청 안양세무서,36,35,1,35,10,25,0,0
국가행정기관,국세청,영월세무서,국세청 중부지방국세청 영월세무서,20,13,7,13,4,9,0,0
국가행정기관,국세청,용인세무서,국세청 중부지방국세청 용인세무서,39,18,21,18,0,18,0,0
국가행정기관,국세청,원주세무서,국세청 중부지방국세청 원주세무서,24,24,0,24,6,18,0,0
국가행정기관,국세청,이천세무서,국세청 중부지방국세청 이천세무서,28,27,1,27,22,5,0,0
국가행정기관,국세청,춘천세무서,국세청 중부지방국세청 춘천세무서,13,13,0,13,0,13,0,0
국가행정기관,국세청,평택세무서,국세청 중부지방국세청 평택세무서,43,42,1,42,0,42,0,0
국가행정기관,국세청,홍천세무서,국세청 중부지방국세청 홍천세무서,20,16,4,16,12,4,0,0
국가행정기관,국세청,화성세무서,국세청 중부지방국세청 화성세무서,21,21,0,21,0,21,0,0
국가행정기관,국토교통부,건설기술교육원,국토교통부 건설기술교육원,57,57,0,57,0,57,0,0
국가행정기관,국토교통부,공간정보품질관리원,국토교통부 공간정보품질관리원,8,6,2,6,6,0,0,0
국가행정기관,국토교통부,국가철도공단,국토교통부 국가철도공단,575,105,470,105,0,105,0,0
국가행정기관,국토교통부,국립항공박물관,국토교통부 국립항공박물관,136,127,9,127,20,107,0,0
국가행정기관,국토교통부,국토교통인재개발원,국토교통부 국토교통인재개발원,72,72,0,72,0,72,0,0
국가행정기관,국토교통부,국토안전관리원,국토교통부 국토안전관리원,126,126,0,126,0,126,0,0
국가행정기관,국토교통부,국토지리정보원,국토교통부 국토지리정보원,79,62,17,62,23,39,0,0
국가행정기관,국토교통부,대전지방국토관리청,국토교통부 대전지방국토관리청,2396,2396,0,2396,0,0,0,2396
국가행정기관,국토교통부,부산지방국토관리청,국토교통부 부산지방국토관리청,2973,2949,24,2949,0,1154,0,1795
국가행정기관,국토교통부,김해국토관리사무소,국토교통부 부산지방국토관리청 김해국토관리사무소,642,633,9,633,5,620,0,8
국가행정기관,국토교통부,대구국토관리사무소,국토교통부 부산지방국토관리청 대구국토관리사무소,315,315,0,315,0,307,0,8
국가행정기관,국토교통부,영주국토관리사무소,국토교통부 부산지방국토관리청 영주국토관리사무소,214,214,0,214,0,214,0,0
국가행정기관,국토교통부,포항국토관리사무소,국토교통부 부산지방국토관리청 포항국토관리사무소,365,365,0,365,0,349,16,0
국가행정기관,국토교통부,새만금개발공사,국토교통부 새만금개발공사,12,12,0,12,0,12,0,0
국가행정기관,국토교통부,서울지방국토관리청,국토교통부 서울지방국토관리청,605,601,4,601,0,0,0,601
국가행정기관,국토교통부,수원국토관리사무소,국토교통부 서울지방국토관리청 수원국토관리사무소,265,252,13,252,0,231,0,21
국가행정기관,국토교통부,의정부국토관리사무소,국토교통부 서울지방국토관리청 의정부국토관리사무소,351,344,7,344,3,341,0,0
국가행정기관,국토교통부,원주지방국토관리청,국토교통부 원주지방국토관리청,1348,1337,11,1337,0,0,0,1337
국가행정기관,국토교통부,익산지방국토관리청,국토교통부 익산지방국토관리청,612,612,0,612,4,0,0,608
국가행정기관,국토교통부,광주국토관리사무소,국토교통부 익산지방국토관리청 광주국토관리사무소,285,285,0,285,0,285,0,0
국가행정기관,국토교통부,전주국토관리사무소,국토교통부 익산지방국토관리청 전주국토관리사무소,10,10,0,10,0,10,0,0
국가행정기관,국토교통부,인천국제공항공사,국토교통부 인천국제공항공사,11871,8966,2905,8966,7582,1022,53,309
국가행정기관,국토교통부,재단법인 대한건설기계안전관리원,국토교통부 재단법인 대한건설기계안전관리원,28,27,1,27,0,27,0,0
국가행정기관,국토교통부,제주국제자유도시개발센터,국토교통부 제주국제자유도시개발센터,1263,1049,214,1049,82,967,0,0
국가행정기관,국토교통부,제주지방항공청,국토교통부 제주지방항공청,5,5,0,5,0,5,0,0
국가행정기관,국토교통부,주식회사 에스알,국토교통부 주식회사 에스알,1206,1188,18,1188,960,228,0,0
국가행정기관,국토교통부,주택관리공단(주),국토교통부 주택관리공단(주),31,31,0,31,10,21,0,0
국가행정기관,국토교통부,주택도시보증공사,국토교통부 주택도시보증공사,193,184,9,184,72,112,0,0
국가행정기관,국토교통부,중앙토지수용위원회,국토교통부 중앙토지수용위원회,0,0,0,0,0,0,0,0
국가행정기관,국토교통부,철도특별사법경찰대,국토교통부 철도특별사법경찰대,1524,1524,0,1524,1524,0,0,0
국가행정기관,국토교통부,코레일네트웍스(주),국토교통부 코레일네트웍스(주),1205,1199,6,1199,1119,80,0,0
국가행정기관,국토교통부,코레일로지스(주),국토교통부 코레일로지스(주),24,0,24,0,0,0,0,0
국가행정기관,국토교통부,코레일유통(주),국토교통부 코레일유통(주),110,110,0,110,0,110,0,0
국가행정기관,국토교통부,코레일테크(주),국토교통부 코레일테크(주),5,2,3,2,0,2,0,0
국가행정기관,국토교통부,한국공항공사,국토교통부 한국공항공사,6010,3039,2971,3039,1369,1663,7,0
국가행정기관,국토교통부,한국교통안전공단,국토교통부 한국교통안전공단,1369,1002,367,1002,187,815,0,0
국가행정기관,국토교통부,한국도로공사,국토교통부 한국도로공사,15706,15501,205,15501,2679,4623,0,8199
국가행정기관,국토교통부,한국도로공사서비스(주),국토교통부 한국도로공사서비스(주),10,7,3,7,0,7,0,0
국가행정기관,국토교통부,한국부동산원,국토교통부 한국부동산원,125,125,0,125,0,125,0,0
국가행정기관,국토교통부,한국철도공사,국토교통부 한국철도공사,27753,20399,7354,20399,1436,18963,0,0
국가행정기관,국토교통부,한국토지주택공사,국토교통부 한국토지주택공사,1480,1421,59,1421,562,800,12,47
국가행정기관,국토교통부,한국해외인프라도시개발지원공사,국토교통부 한국해외인프라도시개발지원공사,0,0,0,0,0,0,0,0
국가행정기관,국토교통부,항공교통본부,국토교통부 항공교통본부,0,0,0,0,0,0,0,0
국가행정기관,국토교통부,항공안전기술원,국토교통부 항공안전기술원,94,85,9,85,0,85,0,0
국가행정기관,국토교통부,항공철도사고조사위원회,국토교통부 항공철도사고조사위원회,0,0,0,0,0,0,0,0
국가행정기관,금융위원회,금융위원회,금융위원회,14,0,14,0,0,0,0,0
국가행정기관,금융위원회,금융감독원,금융위원회 금융감독원,250,23,227,23,2,21,0,0
국가행정기관,금융위원회,보험개발원,금융위원회 보험개발원,63,16,47,16,16,0,0,0
국가행정기관,금융위원회,서민금융진흥원,금융위원회 서민금융진흥원,73,52,21,52,0,52,0,0
국가행정기관,금융위원회,신용보증기금,금융위원회 신용보증기금,421,396,25,396,0,396,0,0
국가행정기관,금융위원회,예금보험공사,금융위원회 예금보험공사,27,27,0,27,0,27,0,0
국가행정기관,금융위원회,중소기업은행,금융위원회 중소기업은행,12523,10302,2221,10302,10302,0,0,0
국가행정기관,금융위원회,한국산업은행,금융위원회 한국산업은행,2166,1616,550,1616,580,1036,0,0
국가행정기관,금융위원회,한국자산관리공사,금융위원회 한국자산관리공사,471,471,0,471,0,471,0,0
국가행정기관,금융위원회,한국주택금융공사,금융위원회 한국주택금융공사,24,0,24,0,0,0,0,0
국가행정기관,기상청,기상청,기상청,194,34,160,34,0,34,0,0
국가행정기관,기상청,(재)APEC기후센터,기상청 (재)APEC기후센터,21,7,14,7,0,7,0,0
국가행정기관,기상청,(재)차세대수치예보모델개발사업단,기상청 (재)차세대수치예보모델개발사업단,7,0,7,0,0,0,0,0
국가행정기관,기상청,강원지방기상청,기상청 강원지방기상청,53,8,45,8,0,8,0,0
국가행정기관,기상청,광주지방기상청,기상청 광주지방기상청,48,7,41,7,0,7,0,0
국가행정기관,기상청,전주기상지청,기상청 광주지방기상청 전주기상지청,62,18,44,18,0,18,0,0
국가행정기관,기상청,국가기상위성센터,기상청 국가기상위성센터,52,0,52,0,0,0,0,0
국가행정기관,기상청,국립기상과학원 ,기상청 국립기상과학원 ,123,2,121,2,0,2,0,0
국가행정기관,기상청,기상레이더센터,기상청 기상레이더센터,154,8,146,8,0,8,0,0
국가행정기관,기상청,대구지방기상청,기상청 대구지방기상청,84,22,62,22,0,22,0,0
국가행정기관,기상청,대전지방기상청,기상청 대전지방기상청,46,19,27,19,0,19,0,0
국가행정기관,기상청,청주기상지청,기상청 대전지방기상청 청주기상지청,63,22,41,22,0,22,0,0
국가행정기관,기상청,부산지방기상청,기상청 부산지방기상청,137,28,109,28,0,28,0,0
국가행정기관,기상청,수도권기상청,기상청 수도권기상청,66,0,66,0,0,0,0,0
국가행정기관,기상청,제주지방기상청,기상청 제주지방기상청,30,0,30,0,0,0,0,0
국가행정기관,기상청,한국기상산업기술원,기상청 한국기상산업기술원,6,0,6,0,0,0,0,0
국가행정기관,기상청,항공기상청,기상청 항공기상청,6,3,3,3,0,3,0,0
국가행정기관,기획재정부,기획재정부,기획재정부,10,0,10,0,0,0,0,0
국가행정기관,기획재정부,한국수출입은행,기획재정부 한국수출입은행,118,5,113,5,0,5,0,0
국가행정기관,기획재정부,한국은행,기획재정부 한국은행,1619,619,1000,619,0,619,0,0
국가행정기관,기획재정부,한국재정정보원,기획재정부 한국재정정보원,58,24,34,24,0,24,0,0
국가행정기관,기획재정부,한국조폐공사,기획재정부 한국조폐공사,1020,44,976,44,30,14,0,0
국가행정기관,기획재정부,한국투자공사,기획재정부 한국투자공사,25,0,25,0,0,0,0,0
국가행정기관,농림축산식품부,농림축산식품부,농림축산식품부,0,0,0,0,0,0,0,0
국가행정기관,농림축산식품부,가축위생방역지원본부,농림축산식품부 가축위생방역지원본부,6,4,2,4,2,2,0,0
국가행정기관,농림축산식품부,국립농산물품질관리원,농림축산식품부 국립농산물품질관리원,742,617,125,617,112,505,0,0
국가행정기관,농림축산식품부,국립종자원,농림축산식품부 국립종자원,588,130,458,130,0,130,0,0
국가행정기관,농림축산식품부,국제식물검역인증원,농림축산식품부 국제식물검역인증원,0,0,0,0,0,0,0,0
국가행정기관,농림축산식품부,농림수산식품교육문화정보원,농림축산식품부 농림수산식품교육문화정보원,34,34,0,34,0,34,0,0
국가행정기관,농림축산식품부,농림식품기술기획평가원,농림축산식품부 농림식품기술기획평가원,24,24,0,24,0,24,0,0
국가행정기관,농림축산식품부,농림축산검역본부,농림축산식품부 농림축산검역본부,414,108,306,108,3,105,0,0
국가행정기관,농림축산식품부,농식품공무원교육원,농림축산식품부 농식품공무원교육원,71,71,0,71,0,71,0,0
국가행정기관,농림축산식품부,농업정책보험금융원,농림축산식품부 농업정책보험금융원,0,0,0,0,0,0,0,0
국가행정기관,농림축산식품부,축산물품질평가원,농림축산식품부 축산물품질평가원,28,23,5,23,0,23,0,0
국가행정기관,농림축산식품부,축산환경관리원,농림축산식품부 축산환경관리원,0,0,0,0,0,0,0,0
국가행정기관,농림축산식품부,한국농수산대학,농림축산식품부 한국농수산대학,250,54,196,54,0,54,0,0
국가행정기관,농림축산식품부,한국농수산식품유통공사,농림축산식품부 한국농수산식품유통공사,821,820,1,820,19,801,0,0
국가행정기관,농림축산식품부,한국농어촌공사,농림축산식품부 한국농어촌공사,6772,2093,4679,2093,111,1982,0,0
국가행정기관,농림축산식품부,한국마사회,농림축산식품부 한국마사회,6613,5425,1188,5425,6,5419,0,0
국가행정기관,농림축산식품부,한국식품산업클러스터진흥원,농림축산식품부 한국식품산업클러스터진흥원,195,195,0,195,0,195,0,0
국가행정기관,농림축산식품부,한식진흥원,농림축산식품부 한식진흥원,40,40,0,40,0,40,0,0
국가행정기관,농촌진흥청,농촌진흥청,농촌진흥청,268,268,0,268,0,268,0,0
국가행정기관,농촌진흥청,국립농업과학원,농촌진흥청 국립농업과학원,766,766,0,766,0,766,0,0
국가행정기관,농촌진흥청,국립식량과학원,농촌진흥청 국립식량과학원,262,262,0,262,0,262,0,0
국가행정기관,농촌진흥청,국립원예특작과학원,농촌진흥청 국립원예특작과학원,364,314,50,314,0,314,0,0
국가행정기관,농촌진흥청,국립축산과학원,농촌진흥청 국립축산과학원,523,147,376,147,0,147,0,0
국가행정기관,농촌진흥청,농촌인적자원개발센터,농촌진흥청 농촌인적자원개발센터,65,0,65,0,0,0,0,0
국가행정기관,농촌진흥청,한국농업기술진흥원,농촌진흥청 한국농업기술진흥원,96,96,0,96,0,96,0,0
국가행정기관,대검찰청,대검찰청,대검찰청,173,0,173,0,0,0,0,0
국가행정기관,대검찰청,강릉지청,대검찰청 강릉지청,50,29,21,29,0,29,0,0
국가행정기관,대검찰청,거창지청,대검찰청 거창지청,17,14,3,14,0,14,0,0
국가행정기관,대검찰청,경주지청,대검찰청 경주지청,23,4,19,4,4,0,0,0
국가행정기관,대검찰청,고양지청,대검찰청 고양지청,57,30,27,30,21,9,0,0
국가행정기관,대검찰청,공주지청,대검찰청 공주지청,55,12,43,12,0,12,0,0
국가행정기관,대검찰청,광주고등검찰청,대검찰청 광주고등검찰청,132,91,41,91,0,91,0,0
국가행정기관,대검찰청,광주지방검찰청,대검찰청 광주지방검찰청,42,42,0,42,0,42,0,0
국가행정기관,대검찰청,김천지청,대검찰청 김천지청,47,17,30,17,0,17,0,0
국가행정기관,대검찰청,남양주지청,대검찰청 남양주지청,85,38,47,38,14,24,0,0
국가행정기관,대검찰청,남원지청,대검찰청 남원지청,16,16,0,16,0,16,0,0
국가행정기관,대검찰청,논산지청,대검찰청 논산지청,22,7,15,7,0,7,0,0
국가행정기관,대검찰청,대구고등검찰청,대검찰청 대구고등검찰청,54,32,22,32,0,32,0,0
국가행정기관,대검찰청,대구지방검찰청,대검찰청 대구지방검찰청,25,4,21,4,0,4,0,0
국가행정기관,대검찰청,대전고등검찰청,대검찰청 대전고등검찰청,144,16,128,16,0,16,0,0
국가행정기관,대검찰청,대전지방검찰청,대검찰청 대전지방검찰청,26,2,24,2,0,2,0,0
국가행정기관,대검찰청,동부지청,대검찰청 동부지청,73,22,51,22,1,21,0,0
국가행정기관,대검찰청,마산지청,대검찰청 마산지청,50,9,41,9,1,8,0,0
국가행정기관,대검찰청,목포지청,대검찰청 목포지청,33,33,0,33,0,33,0,0
국가행정기관,대검찰청,밀양지청,대검찰청 밀양지청,18,10,8,10,0,10,0,0
국가행정기관,대검찰청,부산고등검찰청,대검찰청 부산고등검찰청,41,41,0,41,0,41,0,0
국가행정기관,대검찰청,부산지방검찰청,대검찰청 부산지방검찰청,52,9,43,9,6,3,0,0
국가행정기관,대검찰청,부천지청,대검찰청 부천지청,147,120,27,120,0,120,0,0
국가행정기관,대검찰청,상주지청,대검찰청 상주지청,25,12,13,12,11,1,0,0
국가행정기관,대검찰청,서부지청,대검찰청 서부지청,94,19,75,19,0,19,0,0
국가행정기관,대검찰청,서부지청,대검찰청 서부지청,75,19,56,19,14,5,0,0
국가행정기관,대검찰청,서산지청,대검찰청 서산지청,41,14,27,14,14,0,0,0
국가행정기관,대검찰청,서울고등검찰청,대검찰청 서울고등검찰청,514,59,455,59,0,59,0,0
국가행정기관,대검찰청,서울남부지방검찰청,대검찰청 서울남부지방검찰청,138,102,36,102,69,33,0,0
국가행정기관,대검찰청,서울동부지방검찰청,대검찰청 서울동부지방검찰청,287,30,257,30,0,30,0,0
국가행정기관,대검찰청,서울북부지방검찰청,대검찰청 서울북부지방검찰청,102,25,77,25,16,9,0,0
국가행정기관,대검찰청,서울서부지방검찰청,대검찰청 서울서부지방검찰청,103,66,37,66,39,7,20,0
국가행정기관,대검찰청,서울중앙지방검찰청,대검찰청 서울중앙지방검찰청,86,25,61,25,25,0,0,0
국가행정기관,대검찰청,성남지청,대검찰청 성남지청,58,39,19,39,7,32,0,0
국가행정기관,대검찰청,속초지청,대검찰청 속초지청,42,11,31,11,0,11,0,0
국가행정기관,대검찰청,수원고등검찰청,대검찰청 수원고등검찰청,317,31,286,31,0,31,0,0
국가행정기관,대검찰청,수원지방검찰청,대검찰청 수원지방검찰청,15,15,0,15,15,0,0,0
국가행정기관,대검찰청,순천지청,대검찰청 순천지청,59,18,41,18,0,18,0,0
국가행정기관,대검찰청,안동지청,대검찰청 안동지청,32,25,7,25,0,25,0,0
국가행정기관,대검찰청,안산지청,대검찰청 안산지청,126,83,43,83,0,83,0,0
국가행정기관,대검찰청,안양지청,대검찰청 안양지청,95,38,57,38,27,11,0,0
국가행정기관,대검찰청,여주지청,대검찰청 여주지청,77,44,33,44,14,30,0,0
국가행정기관,대검찰청,영덕지청,대검찰청 영덕지청,32,32,0,32,1,31,0,0
국가행정기관,대검찰청,영동지청,대검찰청 영동지청,11,2,9,2,0,2,0,0
국가행정기관,대검찰청,영월지청,대검찰청 영월지청,28,28,0,28,7,21,0,0
국가행정기관,대검찰청,울산지방검찰청,대검찰청 울산지방검찰청,188,85,103,85,0,85,0,0
국가행정기관,대검찰청,원주지청,대검찰청 원주지청,79,53,26,53,53,0,0,0
국가행정기관,대검찰청,의성지청,대검찰청 의성지청,27,19,8,19,0,19,0,0
국가행정기관,대검찰청,의정부지방검찰청,대검찰청 의정부지방검찰청,33,33,0,33,18,6,4,5
국가행정기관,대검찰청,인천지방검찰청,대검찰청 인천지방검찰청,199,79,120,79,0,79,0,0
국가행정기관,대검찰청,장흥지청,대검찰청 장흥지청,11,11,0,11,7,4,0,0
국가행정기관,대검찰청,전주지방검찰청,대검찰청 전주지방검찰청,137,11,126,11,0,11,0,0
국가행정기관,대검찰청,정읍지청,대검찰청 정읍지청,56,23,33,23,14,9,0,0
국가행정기관,대검찰청,제주지방검찰청,대검찰청 제주지방검찰청,58,33,25,33,0,33,0,0
국가행정기관,대검찰청,제천지청,대검찰청 제천지청,19,0,19,0,0,0,0,0
국가행정기관,대검찰청,진주지청,대검찰청 진주지청,95,27,68,27,15,12,0,0
국가행정기관,대검찰청,창원지방검찰청,대검찰청 창원지방검찰청,135,37,98,37,37,0,0,0
국가행정기관,대검찰청,천안지청,대검찰청 천안지청,99,55,44,55,0,55,0,0
국가행정기관,대검찰청,청주지방검찰청,대검찰청 청주지방검찰청,134,95,39,95,0,95,0,0
국가행정기관,대검찰청,춘천지방검찰청,대검찰청 춘천지방검찰청,31,31,0,31,7,24,0,0
국가행정기관,대검찰청,충주지청,대검찰청 충주지청,22,13,9,13,0,13,0,0
국가행정기관,대검찰청,통영지청,대검찰청 통영지청,60,23,37,23,0,23,0,0
국가행정기관,대검찰청,평택지청,대검찰청 평택지청,33,26,7,26,16,10,0,0
국가행정기관,대검찰청,포항지청,대검찰청 포항지청,18,18,0,18,2,16,0,0
국가행정기관,대검찰청,해남지청,대검찰청 해남지청,12,12,0,12,0,12,0,0
국가행정기관,대검찰청,홍성지청,대검찰청 홍성지청,16,16,0,16,0,16,0,0
국가행정기관,문화재청,문화재청,문화재청,4,1,3,1,0,1,0,0
국가행정기관,문화재청,경복궁관리소,문화재청 경복궁관리소,411,375,36,375,0,375,0,0
국가행정기관,문화재청,국립고궁박물관,문화재청 국립고궁박물관,173,105,68,105,102,3,0,0
국가행정기관,문화재청,국립무형유산원,문화재청 국립무형유산원,212,195,17,195,0,195,0,0
국가행정기관,문화재청,국립문화재연구원,문화재청 국립문화재연구원,121,121,0,121,0,121,0,0
국가행정기관,문화재청,국립가야문화재연구소,문화재청 국립문화재연구원 국립가야문화재연구소,41,27,14,27,6,21,0,0
국가행정기관,문화재청,국립경주문화재연구소,문화재청 국립문화재연구원 국립경주문화재연구소,188,188,0,188,0,188,0,0
국가행정기관,문화재청,국립나주문화재연구소,문화재청 국립문화재연구원 국립나주문화재연구소,39,17,22,17,10,7,0,0
국가행정기관,문화재청,국립부여문화재연구소,문화재청 국립문화재연구원 국립부여문화재연구소,111,81,30,81,81,0,0,0
국가행정기관,문화재청,국립서울문화재연구소,문화재청 국립문화재연구원 국립서울문화재연구소,4,2,2,2,0,2,0,0
국가행정기관,문화재청,국립완주문화재연구소,문화재청 국립문화재연구원 국립완주문화재연구소,26,19,7,19,0,19,0,0
국가행정기관,문화재청,국립중원문화재연구소,문화재청 국립문화재연구원 국립중원문화재연구소,48,18,30,18,0,18,0,0
국가행정기관,문화재청,국립해양문화재연구소,문화재청 국립해양문화재연구소,154,116,38,116,0,116,0,0
국가행정기관,문화재청,국외소재문화재재단,문화재청 국외소재문화재재단,0,0,0,0,0,0,0,0
국가행정기관,문화재청,궁능유적본부,문화재청 궁능유적본부,0,0,0,0,0,0,0,0
국가행정기관,문화재청,덕수궁관리소,문화재청 덕수궁관리소,156,156,0,156,0,156,0,0
국가행정기관,문화재청,동부지구관리소,문화재청 동부지구관리소,131,104,27,104,0,104,0,0
국가행정기관,문화재청,만인의총관리소,문화재청 만인의총관리소,18,18,0,18,0,18,0,0
국가행정기관,문화재청,문화유산국민신탁,문화재청 문화유산국민신탁,25,25,0,25,0,25,0,0
국가행정기관,문화재청,백제왕도핵심유적보존ㆍ관리사업추진단,문화재청 백제왕도핵심유적보존ㆍ관리사업추진단,0,0,0,0,0,0,0,0
국가행정기관,문화재청,서부지구관리소,문화재청 서부지구관리소,567,335,232,335,0,335,0,0
국가행정기관,문화재청,세종대왕유적관리소,문화재청 세종대왕유적관리소,142,138,4,138,26,112,0,0
국가행정기관,문화재청,유네스코아시아태평양무형문화유산국제정보네트워킹센터,문화재청 유네스코아시아태평양무형문화유산국제정보네트워킹센터,0,0,0,0,0,0,0,0
국가행정기관,문화재청,재단법인유네스코세계유산국제해석설명센터,문화재청 재단법인유네스코세계유산국제해석설명센터,0,0,0,0,0,0,0,0
국가행정기관,문화재청,전통건축수리기술진흥재단,문화재청 전통건축수리기술진흥재단,57,38,19,38,0,38,0,0
국가행정기관,문화재청,종묘관리소,문화재청 종묘관리소,96,96,0,96,0,96,0,0
국가행정기관,문화재청,중부지구관리소,문화재청 중부지구관리소,68,68,0,68,0,68,0,0
국가행정기관,문화재청,창경궁관리소,문화재청 창경궁관리소,160,78,82,78,0,78,0,0
국가행정기관,문화재청,창덕궁관리소,문화재청 창덕궁관리소,330,174,156,174,0,174,0,0
국가행정기관,문화재청,칠백의총관리소,문화재청 칠백의총관리소,35,35,0,35,33,2,0,0
국가행정기관,문화재청,한국문화재재단,문화재청 한국문화재재단,227,227,0,227,11,216,0,0
국가행정기관,문화재청,한국전통문화대학교,문화재청 한국전통문화대학교,393,389,4,389,0,389,0,0
국가행정기관,문화재청,현충사관리소,문화재청 현충사관리소,34,34,0,34,32,2,0,0
국가행정기관,문화체육관광부,게임물관리위원회,문화체육관광부 게임물관리위원회,3,0,3,0,0,0,0,0
국가행정기관,문화체육관광부,국립국악고등학교,문화체육관광부 국립국악고등학교,104,104,0,104,0,104,0,0
국가행정기관,문화체육관광부,국립국악원,문화체육관광부 국립국악원,172,163,9,163,0,163,0,0
국가행정기관,문화체육관광부,남도국악원,문화체육관광부 국립국악원 남도국악원,33,33,0,33,0,33,0,0
국가행정기관,문화체육관광부,민속국악원,문화체육관광부 국립국악원 민속국악원,77,77,0,77,0,77,0,0
국가행정기관,문화체육관광부,부산국악원,문화체육관광부 국립국악원 부산국악원,84,84,0,84,0,84,0,0
국가행정기관,문화체육관광부,국립국어원,문화체육관광부 국립국어원,35,35,0,35,22,13,0,0
국가행정기관,문화체육관광부,국립민속박물관,문화체육관광부 국립민속박물관,224,153,71,153,0,153,0,0
국가행정기관,문화체육관광부,국립박물관문화재단,문화체육관광부 국립박물관문화재단,23,18,5,18,18,0,0,0
국가행정기관,문화체육관광부,국립아시아문화전당,문화체육관광부 국립아시아문화전당,438,325,113,325,0,325,0,0
국가행정기관,문화체육관광부,국립장애인도서관,문화체육관광부 국립장애인도서관,0,0,0,0,0,0,0,0
국가행정기관,문화체육관광부,국립전통예술고등학교,문화체육관광부 국립전통예술고등학교,117,117,0,117,3,112,2,0
국가행정기관,문화체육관광부,국립중앙극장,문화체육관광부 국립중앙극장,347,347,0,347,0,347,0,0
국가행정기관,문화체육관광부,국립중앙도서관,문화체육관광부 국립중앙도서관,255,201,54,201,97,94,3,7
국가행정기관,문화체육관광부,국립세종도서관,문화체육관광부 국립중앙도서관 국립세종도서관,145,102,43,102,0,102,0,0
국가행정기관,문화체육관광부,국립어린이청소년도서관,문화체육관광부 국립중앙도서관 국립어린이청소년도서관,60,50,10,50,10,40,0,0
국가행정기관,문화체육관광부,국립중앙박물관,문화체육관광부 국립중앙박물관,79,79,0,79,0,79,0,0
국가행정기관,문화체육관광부,경주박물관,문화체육관광부 국립중앙박물관 경주박물관,207,166,41,166,0,166,0,0
국가행정기관,문화체육관광부,공주박물관,문화체육관광부 국립중앙박물관 공주박물관,114,84,30,84,42,42,0,0
국가행정기관,문화체육관광부,광주박물관,문화체육관광부 국립중앙박물관 광주박물관,88,88,0,88,0,86,0,2
국가행정기관,문화체육관광부,김해박물관,문화체육관광부 국립중앙박물관 김해박물관,130,130,0,130,0,130,0,0
국가행정기관,문화체육관광부,나주박물관,문화체육관광부 국립중앙박물관 나주박물관,113,77,36,77,33,44,0,0
국가행정기관,문화체육관광부,대구박물관,문화체육관광부 국립중앙박물관 대구박물관,79,79,0,79,0,79,0,0
국가행정기관,문화체육관광부,부여박물관,문화체육관광부 국립중앙박물관 부여박물관,73,73,0,73,56,17,0,0
국가행정기관,문화체육관광부,익산박물관,문화체육관광부 국립중앙박물관 익산박물관,85,65,20,65,0,65,0,0
국가행정기관,문화체육관광부,전주박물관,문화체육관광부 국립중앙박물관 전주박물관,67,45,22,45,0,45,0,0
국가행정기관,문화체육관광부,제주박물관,문화체육관광부 국립중앙박물관 제주박물관,67,67,0,67,0,67,0,0
국가행정기관,문화체육관광부,진주박물관,문화체육관광부 국립중앙박물관 진주박물관,83,60,23,60,30,30,0,0
국가행정기관,문화체육관광부,청주박물관,문화체육관광부 국립중앙박물관 청주박물관,85,85,0,85,16,69,0,0
국가행정기관,문화체육관광부,춘천박물관,문화체육관광부 국립중앙박물관 춘천박물관,116,92,24,92,0,92,0,0
국가행정기관,문화체육관광부,국립한글박물관,문화체육관광부 국립한글박물관,123,0,123,0,0,0,0,0
국가행정기관,문화체육관광부,국립현대미술관,문화체육관광부 국립현대미술관,230,230,0,230,0,230,0,0
국가행정기관,문화체육관광부,국제방송교류재단,문화체육관광부 국제방송교류재단,40,40,0,40,0,40,0,0
국가행정기관,문화체육관광부,그랜드코리아레저(주),문화체육관광부 그랜드코리아레저(주),1500,76,1424,76,0,76,0,0
국가행정기관,문화체육관광부,대한민국역사박물관,문화체육관광부 대한민국역사박물관,125,109,16,109,0,109,0,0
국가행정기관,문화체육관광부,대한장애인체육회,문화체육관광부 대한장애인체육회,9,9,0,9,0,9,0,0
국가행정기관,문화체육관광부,대한체육회,문화체육관광부 대한체육회,600,56,544,56,0,56,0,0
국가행정기관,문화체육관광부,서울올림픽기념국민체육진흥공단,문화체육관광부 서울올림픽기념국민체육진흥공단,2471,2312,159,2312,316,1996,0,0
국가행정기관,문화체육관광부,영상물등급위원회,문화체육관광부 영상물등급위원회,0,0,0,0,0,0,0,0
국가행정기관,문화체육관광부,영화진흥위원회,문화체육관광부 영화진흥위원회,87,80,7,80,0,80,0,0
국가행정기관,문화체육관광부,예술경영지원센터,문화체육관광부 예술경영지원센터,0,0,0,0,0,0,0,0
국가행정기관,문화체육관광부,예술원사무국,문화체육관광부 예술원사무국,1,1,0,1,0,1,0,0
국가행정기관,문화체육관광부,예술의전당,문화체육관광부 예술의전당,568,568,0,568,0,568,0,0
국가행정기관,문화체육관광부,재단법인 국악방송,문화체육관광부 재단법인 국악방송,3,3,0,3,1,2,0,0
국가행정기관,문화체육관광부,태권도진흥재단,문화체육관광부 태권도진흥재단,267,257,10,257,243,14,0,0
국가행정기관,문화체육관광부,한국공예디자인문화진흥원,문화체육관광부 한국공예디자인문화진흥원,35,35,0,35,0,35,0,0
국가행정기관,문화체육관광부,한국관광공사,문화체육관광부 한국관광공사,364,325,39,325,55,270,0,0
국가행정기관,문화체육관광부,한국도박문제예방치유원,문화체육관광부 한국도박문제예방치유원,33,32,1,32,0,32,0,0
국가행정기관,문화체육관광부,한국문학번역원,문화체육관광부 한국문학번역원,7,7,0,7,4,3,0,0
국가행정기관,문화체육관광부,한국문화예술위원회,문화체육관광부 한국문화예술위원회,144,121,23,121,100,21,0,0
국가행정기관,문화체육관광부,한국문화정보원,문화체육관광부 한국문화정보원,8,0,8,0,0,0,0,0
국가행정기관,문화체육관광부,한국문화진흥(주),문화체육관광부 한국문화진흥(주),77,77,0,77,20,57,0,0
국가행정기관,문화체육관광부,한국언론진흥재단,문화체육관광부 한국언론진흥재단,0,0,0,0,0,0,0,0
국가행정기관,문화체육관광부,한국영상자료원,문화체육관광부 한국영상자료원,116,68,48,68,53,15,0,0
국가행정기관,문화체육관광부,한국예술인복지재단,문화체육관광부 한국예술인복지재단,7,7,0,7,0,7,0,0
국가행정기관,문화체육관광부,한국예술종합학교,문화체육관광부 한국예술종합학교,288,288,0,288,0,288,0,0
국가행정기관,문화체육관광부,한국저작권보호원,문화체육관광부 한국저작권보호원,13,0,13,0,0,0,0,0
국가행정기관,문화체육관광부,한국저작권위원회,문화체육관광부 한국저작권위원회,19,9,10,9,0,9,0,0
국가행정기관,문화체육관광부,한국체육산업개발주식회사,문화체육관광부 한국체육산업개발주식회사,683,596,87,596,372,224,0,0
국가행정기관,문화체육관광부,한국출판문화산업진흥원,문화체육관광부 한국출판문화산업진흥원,0,0,0,0,0,0,0,0
국가행정기관,문화체육관광부,한국콘텐츠진흥원,문화체육관광부 한국콘텐츠진흥원,325,246,79,246,29,217,0,0
국가행정기관,민주평화통일자문회의사무처,민주평화통일자문회의사무처,민주평화통일자문회의사무처,11,9,2,9,0,9,0,0
국가행정기관,방송통신위원회,방송통신위원회,방송통신위원회,4,0,4,0,0,0,0,0
국가행정기관,방송통신위원회,시청자미디어재단,방송통신위원회 시청자미디어재단,203,197,6,197,14,183,0,0
국가행정기관,방송통신위원회,한국방송광고진흥공사,방송통신위원회 한국방송광고진흥공사,275,270,5,270,0,270,0,0
국가행정기관,방위사업청,방위사업청,방위사업청,108,0,108,0,0,0,0,0
국가행정기관,방위사업청,국방과학연구소,방위사업청 국방과학연구소,1486,11,1475,11,0,11,0,0
국가행정기관,방위사업청,국방기술품질원,방위사업청 국방기술품질원,406,48,358,48,0,48,0,0
국가행정기관,방위사업청,국방기술진흥연구소,방위사업청 국방기술품질원 국방기술진흥연구소,82,14,68,14,3,0,11,0
국가행정기관,법무부,법무부,법무부,23784,2429,21355,2429,142,2287,0,0
국가행정기관,법무부,대한법률구조공단,법무부 대한법률구조공단,101,93,8,93,0,93,0,0
국가행정기관,법무부,한국법무보호복지공단,법무부 한국법무보호복지공단,559,406,153,406,81,325,0,0
국가행정기관,병무청,병무청,병무청,39,0,39,0,0,0,0,0
국가행정기관,병무청,강원영동병무지청,병무청 강원영동병무지청,22,21,1,21,0,21,0,0
국가행정기관,병무청,강원지방병무청,병무청 강원지방병무청,53,52,1,52,17,35,0,0
국가행정기관,병무청,경기북부병무지청,병무청 경기북부병무지청,32,30,2,30,14,16,0,0
국가행정기관,병무청,경남지방병무청,병무청 경남지방병무청,29,28,1,28,11,17,0,0
국가행정기관,병무청,경인지방병무청,병무청 경인지방병무청,62,51,11,51,23,26,0,2
국가행정기관,병무청,광주전남지방병무청,병무청 광주전남지방병무청,49,44,5,44,13,31,0,0
국가행정기관,병무청,대구경북지방병무청,병무청 대구경북지방병무청,49,49,0,49,0,49,0,0
국가행정기관,병무청,대전충남지방병무청,병무청 대전충남지방병무청,57,54,3,54,7,47,0,0
국가행정기관,병무청,대체역심사위원회,병무청 대체역심사위원회,20,8,12,8,0,8,0,0
국가행정기관,병무청,병무민원상담소,병무청 병무민원상담소,0,0,0,0,0,0,0,0
국가행정기관,병무청,부산울산지방병무청,병무청 부산울산지방병무청,61,60,1,60,0,60,0,0
국가행정기관,병무청,사회복무연수센터,병무청 사회복무연수센터,170,167,3,167,42,125,0,0
국가행정기관,병무청,서울지방병무청,병무청 서울지방병무청,61,57,4,57,3,54,0,0
국가행정기관,병무청,인천병무지청,병무청 인천병무지청,33,31,2,31,11,20,0,0
국가행정기관,병무청,전북지방병무청,병무청 전북지방병무청,37,34,3,34,16,18,0,0
국가행정기관,병무청,제주지방병무청,병무청 제주지방병무청,17,12,5,12,3,9,0,0
국가행정기관,병무청,중앙병역판정검사소,병무청 중앙병역판정검사소,36,35,1,35,20,15,0,0
국가행정기관,병무청,충북지방병무청,병무청 충북지방병무청,24,22,2,22,13,9,0,0
국가행정기관,보건복지부,보건복지부,보건복지부,12,2,10,2,2,0,0,0
국가행정기관,보건복지부,(재)한국보건의료정보원,보건복지부 (재)한국보건의료정보원,25,0,25,0,0,0,0,0
국가행정기관,보건복지부,건강보험분쟁조정위원회사무국,보건복지부 건강보험분쟁조정위원회사무국,0,0,0,0,0,0,0,0
국가행정기관,보건복지부,건강보험심사평가원,보건복지부 건강보험심사평가원,669,260,409,260,0,260,0,0
국가행정기관,보건복지부,국립공주병원,보건복지부 국립공주병원,46,12,34,12,0,12,0,0
국가행정기관,보건복지부,국립나주병원,보건복지부 국립나주병원,65,16,49,16,0,16,0,0
국가행정기관,보건복지부,국립망향의동산관리원,보건복지부 국립망향의동산관리원,16,16,0,16,10,6,0,0
국가행정기관,보건복지부,국립부곡병원,보건복지부 국립부곡병원,48,31,17,31,0,31,0,0
국가행정기관,보건복지부,국립소록도병원,보건복지부 국립소록도병원,30,22,8,22,7,15,0,0
국가행정기관,보건복지부,국립암센터,보건복지부 국립암센터,628,628,0,628,264,364,0,0
국가행정기관,보건복지부,국립장기조직혈액관리원,보건복지부 국립장기조직혈액관리원,2,0,2,0,0,0,0,0
국가행정기관,보건복지부,국립재활원,보건복지부 국립재활원,225,218,7,218,0,218,0,0
국가행정기관,보건복지부,국립정신건강센터,보건복지부 국립정신건강센터,367,225,142,225,0,225,0,0
국가행정기관,보건복지부,국립중앙의료원,보건복지부 국립중앙의료원,303,199,104,199,199,0,0,0
국가행정기관,보건복지부,국립춘천병원,보건복지부 국립춘천병원,38,17,21,17,1,16,0,0
국가행정기관,보건복지부,국민건강보험공단,보건복지부 국민건강보험공단,2479,2304,175,2304,1159,1145,0,0
국가행정기관,보건복지부,일산병원,보건복지부 국민건강보험공단 일산병원,702,371,331,371,0,371,0,0
국가행정기관,보건복지부,국민연금공단,보건복지부 국민연금공단,1253,1162,91,1162,0,1162,0,0
국가행정기관,보건복지부,대구경북첨단의료산업진흥재단,보건복지부 대구경북첨단의료산업진흥재단,223,223,0,223,0,223,0,0
국가행정기관,보건복지부,대한적십자사,보건복지부 대한적십자사,1939,1727,212,1727,324,1403,0,0
국가행정기관,보건복지부,아동권리보장원,보건복지부 아동권리보장원,14,4,10,4,4,0,0,0
국가행정기관,보건복지부,오송생명과학단지지원센터,보건복지부 오송생명과학단지지원센터,1138,21,1117,21,21,0,0,0
국가행정기관,보건복지부,오송첨단의료산업진흥재단,보건복지부 오송첨단의료산업진흥재단,200,25,175,25,0,25,0,0
국가행정기관,보건복지부,재단법인 의료기관평가인증원,보건복지부 재단법인 의료기관평가인증원,0,0,0,0,0,0,0,0
국가행정기관,보건복지부,재단법인 한국공공조직은행,보건복지부 재단법인 한국공공조직은행,28,0,28,0,0,0,0,0
국가행정기관,보건복지부,재단법인 한국자활복지개발원,보건복지부 재단법인 한국자활복지개발원,40,40,0,40,7,33,0,0
국가행정기관,보건복지부,재단법인 한국장기조직기증원,보건복지부 재단법인 한국장기조직기증원,2,0,2,0,0,0,0,0
국가행정기관,보건복지부,재단법인국가생명윤리정책원,보건복지부 재단법인국가생명윤리정책원,1,0,1,0,0,0,0,0
국가행정기관,보건복지부,첨단재생의료및첨단바이오의약품심의위원회사무국,보건복지부 첨단재생의료및첨단바이오의약품심의위원회사무국,0,0,0,0,0,0,0,0
국가행정기관,보건복지부,한국건강증진개발원,보건복지부 한국건강증진개발원,0,0,0,0,0,0,0,0
국가행정기관,보건복지부,한국국제보건의료재단,보건복지부 한국국제보건의료재단,3,0,3,0,0,0,0,0
국가행정기관,보건복지부,한국노인인력개발원,보건복지부 한국노인인력개발원,11,8,3,8,0,8,0,0
국가행정기관,보건복지부,한국보건복지인재원,보건복지부 한국보건복지인재원,0,0,0,0,0,0,0,0
국가행정기관,보건복지부,한국보건산업진흥원,보건복지부 한국보건산업진흥원,0,0,0,0,0,0,0,0
국가행정기관,보건복지부,한국보건의료연구원,보건복지부 한국보건의료연구원,4,0,4,0,0,0,0,0
국가행정기관,보건복지부,한국보건의료인국가시험원,보건복지부 한국보건의료인국가시험원,20,4,16,4,2,2,0,0
국가행정기관,보건복지부,한국보육진흥원,보건복지부 한국보육진흥원,0,0,0,0,0,0,0,0
국가행정기관,보건복지부,한국사회보장정보원,보건복지부 한국사회보장정보원,41,41,0,41,0,41,0,0
국가행정기관,보건복지부,한국사회복지협의회,보건복지부 한국사회복지협의회,11,0,11,0,0,0,0,0
국가행정기관,보건복지부,한국의료분쟁조정중재원,보건복지부 한국의료분쟁조정중재원,25,20,5,20,0,20,0,0
국가행정기관,보건복지부,한국장애인개발원,보건복지부 한국장애인개발원,60,55,5,55,0,55,0,0
국가행정기관,보건복지부,한국한의약진흥원,보건복지부 한국한의약진흥원,64,59,5,59,0,59,0,0
국가행정기관,산림청,산림청,산림청,2619,2458,161,2458,0,2458,0,0
국가행정기관,산림청,한국등산트레킹지원센터,산림청 한국등산트레킹지원센터,94,87,7,87,3,84,0,0
국가행정기관,산림청,한국산림복지진흥원,산림청 한국산림복지진흥원,558,547,11,547,0,547,0,0
국가행정기관,산림청,한국수목원정원관리원,산림청 한국수목원정원관리원,711,473,238,473,200,273,0,0
국가행정기관,산림청,한국임업진흥원,산림청 한국임업진흥원,28,25,3,25,0,25,0,0
국가행정기관,산업통상자원부,산업통상자원부,산업통상자원부,0,0,0,0,0,0,0,0
국가행정기관,산업통상자원부,(주)한국가스기술공사,산업통상자원부 (주)한국가스기술공사,65,65,0,65,26,39,0,0
국가행정기관,산업통상자원부,군산자유무역지역관리원,산업통상자원부 군산자유무역지역관리원,17,17,0,17,6,11,0,0
국가행정기관,산업통상자원부,김제자유무역지역관리원,산업통상자원부 김제자유무역지역관리원,107,107,0,107,0,107,0,0
국가행정기관,산업통상자원부,대불자유무역지역관리원,산업통상자원부 대불자유무역지역관리원,134,134,0,134,0,134,0,0
국가행정기관,산업통상자원부,대한무역투자진흥공사,산업통상자원부 대한무역투자진흥공사,155,149,6,149,0,149,0,0
국가행정기관,산업통상자원부,대한석탄공사,산업통상자원부 대한석탄공사,262,12,250,12,0,12,0,0
국가행정기관,산업통상자원부,동해자유무역지역관리원,산업통상자원부 동해자유무역지역관리원,37,37,0,37,0,37,0,0
국가행정기관,산업통상자원부,마산자유무역지역관리원,산업통상자원부 마산자유무역지역관리원,177,177,0,177,0,0,177,0
국가행정기관,산업통상자원부,율촌자유무역지역관리원,산업통상자원부 율촌자유무역지역관리원,40,40,0,40,19,21,0,0
국가행정기관,산업통상자원부,재단법인한국에너지재단,산업통상자원부 재단법인한국에너지재단,9,3,6,3,0,3,0,0
국가행정기관,산업통상자원부,주식회사 강원랜드,산업통상자원부 주식회사 강원랜드,5077,4565,512,4565,2417,2148,0,0
국가행정기관,산업통상자원부,학교법인한국전력국제원자력대학원대학교,산업통상자원부 학교법인한국전력국제원자력대학원대학교,79,76,3,76,0,76,0,0
국가행정기관,산업통상자원부,한국가스공사,산업통상자원부 한국가스공사,2716,0,2716,0,0,0,0,0
국가행정기관,산업통상자원부,한국가스안전공사,산업통상자원부 한국가스안전공사,422,393,29,393,86,307,0,0
국가행정기관,산업통상자원부,한국광해광업공단,산업통상자원부 한국광해광업공단,255,254,1,254,0,254,0,0
국가행정기관,산업통상자원부,한국남동발전(주),산업통상자원부 한국남동발전(주),3328,144,3184,144,26,118,0,0
국가행정기관,산업통상자원부,한국남부발전(주),산업통상자원부 한국남부발전(주),3248,166,3082,166,47,119,0,0
국가행정기관,산업통상자원부,한국동서발전(주),산업통상자원부 한국동서발전(주),3271,28,3243,28,2,26,0,0
국가행정기관,산업통상자원부,한국디자인진흥원,산업통상자원부 한국디자인진흥원,135,131,4,131,99,4,28,0
국가행정기관,산업통상자원부,한국로봇산업진흥원,산업통상자원부 한국로봇산업진흥원,85,85,0,85,0,85,0,0
국가행정기관,산업통상자원부,한국무역보험공사,산업통상자원부 한국무역보험공사,130,113,17,113,0,113,0,0
국가행정기관,산업통상자원부,한국산업기술시험원,산업통상자원부 한국산업기술시험원,344,152,192,152,19,133,0,0
국가행정기관,산업통상자원부,한국산업기술평가관리원,산업통상자원부 한국산업기술평가관리원,51,51,0,51,0,51,0,0
국가행정기관,산업통상자원부,한국산업단지공단,산업통상자원부 한국산업단지공단,79,79,0,79,0,79,0,0
국가행정기관,산업통상자원부,한국서부발전(주),산업통상자원부 한국서부발전(주),3488,373,3115,373,373,0,0,0
국가행정기관,산업통상자원부,한국석유공사,산업통상자원부 한국석유공사,556,144,412,144,113,31,0,0
국가행정기관,산업통상자원부,한국석유관리원,산업통상자원부 한국석유관리원,182,0,182,0,0,0,0,0
국가행정기관,산업통상자원부,한국세라믹기술원,산업통상자원부 한국세라믹기술원,188,45,143,45,0,45,0,0
국가행정기관,산업통상자원부,한국수력원자력(주),산업통상자원부 한국수력원자력(주),7204,1909,5295,1909,1365,544,0,0
국가행정기관,산업통상자원부,한국에너지공단,산업통상자원부 한국에너지공단,107,107,0,107,96,11,0,0
국가행정기관,산업통상자원부,한국에너지기술평가원,산업통상자원부 한국에너지기술평가원,10,7,3,7,4,3,0,0
국가행정기관,산업통상자원부,한국에너지정보문화재단,산업통상자원부 한국에너지정보문화재단,18,18,0,18,10,5,3,0
국가행정기관,산업통상자원부,한국원자력환경공단,산업통상자원부 한국원자력환경공단,171,20,151,20,0,20,0,0
국가행정기관,산업통상자원부,한국전기안전공사,산업통상자원부 한국전기안전공사,431,354,77,354,0,354,0,0
국가행정기관,산업통상자원부,한국전력거래소,산업통상자원부 한국전력거래소,225,0,225,0,0,0,0,0
국가행정기관,산업통상자원부,한국전력공사,산업통상자원부 한국전력공사,23227,3814,19413,3814,205,3609,0,0
국가행정기관,산업통상자원부,한국전력기술(주),산업통상자원부 한국전력기술(주),314,120,194,120,20,100,0,0
국가행정기관,산업통상자원부,한국제품안전관리원,산업통상자원부 한국제품안전관리원,4,4,0,4,0,4,0,0
국가행정기관,산업통상자원부,한국중부발전(주),산업통상자원부 한국중부발전(주),4758,257,4501,257,92,165,0,0
국가행정기관,산업통상자원부,한국지역난방공사,산업통상자원부 한국지역난방공사,1374,0,1374,0,0,0,0,0
국가행정기관,산업통상자원부,한국탄소산업진흥원,산업통상자원부 한국탄소산업진흥원,63,63,0,63,0,63,0,0
국가행정기관,산업통상자원부,한전KDN(주),산업통상자원부 한전KDN(주),446,133,313,133,0,133,0,0
국가행정기관,산업통상자원부,한전엠씨에스(주),산업통상자원부 한전엠씨에스(주),5,5,0,5,0,5,0,0
국가행정기관,산업통상자원부,한전원자력연료(주),산업통상자원부 한전원자력연료(주),379,10,369,10,0,10,0,0
국가행정기관,산업통상자원부,한전케이피에스주식회사,산업통상자원부 한전케이피에스주식회사,494,168,326,168,72,96,0,0
국가행정기관,새만금개발청,새만금개발청,새만금개발청,27,27,0,27,0,27,0,0
국가행정기관,소방청,국립소방연구원,소방청  국립소방연구원,10,10,0,10,0,10,0,0
국가행정기관,소방청,중앙119구조본부,소방청  중앙119구조본부,135,87,48,87,13,74,0,0
국가행정기관,소방청,중앙소방학교,소방청  중앙소방학교,288,288,0,288,0,288,0,0
국가행정기관,소방청,한국소방산업기술원,소방청  한국소방산업기술원,99,99,0,99,0,99,0,0
국가행정기관,소방청,한국소방안전원,소방청  한국소방안전원,152,138,14,138,5,133,0,0
국가행정기관,식품의약품안전처,식품의약품안전처,식품의약품안전처,20,16,4,16,16,0,0,0
국가행정기관,식품의약품안전처,경인지방식품의약품안전청,식품의약품안전처 경인지방식품의약품안전청,12,12,0,12,0,12,0,0
국가행정기관,식품의약품안전처,광주지방식품의약품안전청,식품의약품안전처 광주지방식품의약품안전청,7,2,5,2,0,2,0,0
국가행정기관,식품의약품안전처,대구지방식품의약품안전청,식품의약품안전처 대구지방식품의약품안전청,0,0,0,0,0,0,0,0
국가행정기관,식품의약품안전처,대전지방식품의약품안전청,식품의약품안전처 대전지방식품의약품안전청,15,11,4,11,0,11,0,0
국가행정기관,식품의약품안전처,부산지방식품의약품안전청,식품의약품안전처 부산지방식품의약품안전청,0,0,0,0,0,0,0,0
국가행정기관,식품의약품안전처,서울지방식품의약품안전청,식품의약품안전처 서울지방식품의약품안전청,32,32,0,32,12,20,0,0
국가행정기관,식품의약품안전처,식품안전정보원,식품의약품안전처 식품안전정보원,1,0,1,0,0,0,0,0
국가행정기관,식품의약품안전처,식품의약품안전평가원,식품의약품안전처 식품의약품안전평가원,103,97,6,97,0,97,0,0
국가행정기관,식품의약품안전처,한국식품안전관리인증원,식품의약품안전처 한국식품안전관리인증원,0,0,0,0,0,0,0,0
국가행정기관,식품의약품안전처,한국의료기기안전정보원,식품의약품안전처 한국의료기기안전정보원,2,0,2,0,0,0,0,0
국가행정기관,식품의약품안전처,한국의약품안전관리원,식품의약품안전처 한국의약품안전관리원,8,3,5,3,3,0,0,0
국가행정기관,여성가족부,여성가족부,여성가족부,0,0,0,0,0,0,0,0
국가행정기관,여성가족부,한국건강가정진흥원,여성가족부 한국건강가정진흥원,0,0,0,0,0,0,0,0
국가행정기관,여성가족부,한국양성평등교육진흥원,여성가족부 한국양성평등교육진흥원,14,14,0,14,0,14,0,0
국가행정기관,여성가족부,한국여성인권진흥원,여성가족부 한국여성인권진흥원,6,5,1,5,0,5,0,0
국가행정기관,여성가족부,한국청소년상담복지개발원,여성가족부 한국청소년상담복지개발원,20,0,20,0,0,0,0,0
국가행정기관,여성가족부,한국청소년활동진흥원,여성가족부 한국청소년활동진흥원,408,403,5,403,188,215,0,0
국가행정기관,외교부,외교부,외교부,127,8,119,8,2,6,0,0
국가행정기관,외교부,국립외교원,외교부 국립외교원,99,38,61,38,0,38,0,0
국가행정기관,외교부,재외동포재단,외교부 재외동포재단,11,4,7,4,4,0,0,0
국가행정기관,외교부,한국국제교류재단,외교부 한국국제교류재단,99,77,22,77,57,20,0,0
국가행정기관,외교부,한아프리카재단,외교부 한아프리카재단,3,3,0,3,2,1,0,0
국가행정기관,원자력안전위원회,원자력안전위원회,원자력안전위원회,12,12,0,12,0,12,0,0
국가행정기관,원자력안전위원회,한국원자력안전기술원,원자력안전위원회 한국원자력안전기술원,100,0,100,0,0,0,0,0
국가행정기관,원자력안전위원회,한국원자력안전재단,원자력안전위원회 한국원자력안전재단,26,22,4,22,0,22,0,0
국가행정기관,원자력안전위원회,한국원자력통제기술원,원자력안전위원회 한국원자력통제기술원,27,27,0,27,0,27,0,0
국가행정기관,인사혁신처,인사혁신처,인사혁신처,169,4,165,4,0,4,0,0
국가행정기관,인사혁신처,공무원연금공단,인사혁신처 공무원연금공단,569,563,6,563,4,559,0,0
국가행정기관,인사혁신처,국가공무원인재개발원,인사혁신처 국가공무원인재개발원,156,156,0,156,0,156,0,0
국가행정기관,조달청,조달청,조달청,379,176,203,176,59,116,0,1
국가행정기관,중소벤처기업부,중소벤처기업부,중소벤처기업부,106,106,0,106,0,106,0,0
국가행정기관,중소벤처기업부,강원지방중소벤처기업청,중소벤처기업부 강원지방중소벤처기업청,16,16,0,16,16,0,0,0
국가행정기관,중소벤처기업부,경기지방중소벤처기업청,중소벤처기업부 경기지방중소벤처기업청,61,12,49,12,0,12,0,0
국가행정기관,중소벤처기업부,경남지방중소벤처기업청,중소벤처기업부 경남지방중소벤처기업청,16,16,0,16,16,0,0,0
국가행정기관,중소벤처기업부,구미전자공업고등학교,중소벤처기업부 구미전자공업고등학교,250,250,0,250,120,130,0,0
국가행정기관,중소벤처기업부,기술보증기금 ,중소벤처기업부 기술보증기금 ,149,20,129,20,0,20,0,0
국가행정기관,중소벤처기업부,대구.경북지방중소벤처기업청,중소벤처기업부 대구.경북지방중소벤처기업청,21,21,0,21,0,21,0,0
국가행정기관,중소벤처기업부,대전·세종지방중소벤처기업청,중소벤처기업부 대전·세종지방중소벤처기업청,8,8,0,8,4,4,0,0
국가행정기관,중소벤처기업부,부산기계공업고등학교,중소벤처기업부 부산기계공업고등학교,171,170,1,170,77,93,0,0
국가행정기관,중소벤처기업부,부산지방중소벤처기업청,중소벤처기업부 부산지방중소벤처기업청,21,21,0,21,0,21,0,0
국가행정기관,중소벤처기업부,소상공인시장진흥공단,중소벤처기업부 소상공인시장진흥공단,294,248,46,248,0,248,0,0
국가행정기관,중소벤처기업부,신용보증재단중앙회,중소벤처기업부 신용보증재단중앙회,6,0,6,0,0,0,0,0
국가행정기관,중소벤처기업부,인천지방중소벤처기업청,중소벤처기업부 인천지방중소벤처기업청,12,12,0,12,0,12,0,0
국가행정기관,중소벤처기업부,재단법인 장애인기업종합지원센터,중소벤처기업부 재단법인 장애인기업종합지원센터,110,104,6,104,3,101,0,0
국가행정기관,중소벤처기업부,전북기계공업고등학교,중소벤처기업부 전북기계공업고등학교,188,188,0,188,53,135,0,0
국가행정기관,중소벤처기업부,전북지방중소벤처기업청,중소벤처기업부 전북지방중소벤처기업청,21,21,0,21,5,16,0,0
국가행정기관,중소벤처기업부,주식회사 공영홈쇼핑,중소벤처기업부 주식회사 공영홈쇼핑,50,26,24,26,0,26,0,0
국가행정기관,중소벤처기업부,중소기업기술정보진흥원,중소벤처기업부 중소기업기술정보진흥원,100,96,4,96,86,10,0,0
국가행정기관,중소벤처기업부,중소기업유통센터,중소벤처기업부 중소기업유통센터,297,296,1,296,0,296,0,0
국가행정기관,중소벤처기업부,중소벤처기업연구원,중소벤처기업부 중소벤처기업연구원,18,18,0,18,18,0,0,0
국가행정기관,중소벤처기업부,중소벤처기업진흥공단,중소벤처기업부 중소벤처기업진흥공단,519,519,0,519,0,519,0,0
국가행정기관,중소벤처기업부,창업진흥원,중소벤처기업부 창업진흥원,59,39,20,39,0,39,0,0
국가행정기관,중소벤처기업부,충북지방중소벤처기업청,중소벤처기업부 충북지방중소벤처기업청,13,13,0,13,0,13,0,0
국가행정기관,중소벤처기업부,한국벤처투자,중소벤처기업부 한국벤처투자,71,60,11,60,0,60,0,0
국가행정기관,질병관리청,질병관리청,질병관리청,122,0,122,0,0,0,0,0
국가행정기관,질병관리청,경남권질병대응센터,질병관리청 경남권질병대응센터,5,0,5,0,0,0,0,0
국가행정기관,질병관리청,국립부산검역소,질병관리청 경남권질병대응센터 국립부산검역소,0,0,0,0,0,0,0,0
국가행정기관,질병관리청,경북권질병대응센터,질병관리청 경북권질병대응센터,0,0,0,0,0,0,0,0
국가행정기관,질병관리청,국립울산검역소,질병관리청 경북권질병대응센터 국립울산검역소,3,3,0,3,1,2,0,0
국가행정기관,질병관리청,국립포항검역소,질병관리청 경북권질병대응센터 국립포항검역소,0,0,0,0,0,0,0,0
국가행정기관,질병관리청,국립마산병원,질병관리청 국립마산병원,116,113,3,113,0,113,0,0
국가행정기관,질병관리청,국립목포병원,질병관리청 국립목포병원,41,20,21,20,0,20,0,0
국가행정기관,질병관리청,국립보건연구원,질병관리청 국립보건연구원,193,0,193,0,0,0,0,0
국가행정기관,질병관리청,수도권질병대응센터,질병관리청 수도권질병대응센터,2,2,0,2,1,1,0,0
국가행정기관,질병관리청,국립동해검역소,질병관리청 수도권질병대응센터 국립동해검역소,0,0,0,0,0,0,0,0
국가행정기관,질병관리청,국립인천검역소,질병관리청 수도권질병대응센터 국립인천검역소,0,0,0,0,0,0,0,0
국가행정기관,질병관리청,국립인천공항검역소,질병관리청 수도권질병대응센터 국립인천공항검역소,32,0,32,0,0,0,0,0
국가행정기관,질병관리청,충청권질병대응센터,질병관리청 충청권질병대응센터,8,0,8,0,0,0,0,0
국가행정기관,질병관리청,국립평택검역소,질병관리청 충청권질병대응센터 국립평택검역소,3,0,3,0,0,0,0,0
국가행정기관,질병관리청,국립목포검역소,질병관리청 호남권질병대응센터 국립목포검역소,2,0,2,0,0,0,0,0
국가행정기관,질병관리청,국립제주검역소,질병관리청 호남권질병대응센터 국립제주검역소,6,0,6,0,0,0,0,0
국가행정기관,통계청,통계청,통계청,33,25,8,25,0,25,0,0
국가행정기관,통계청,경인지방통계청,통계청 경인지방통계청,0,0,0,0,0,0,0,0
국가행정기관,통계청,고양사무소,통계청 경인지방통계청 고양사무소,0,0,0,0,0,0,0,0
국가행정기관,통계청,구리사무소,통계청 경인지방통계청 구리사무소,0,0,0,0,0,0,0,0
국가행정기관,통계청,서울사무소,통계청 경인지방통계청 서울사무소,16,16,0,16,0,16,0,0
국가행정기관,통계청,성남사무소,통계청 경인지방통계청 성남사무소,6,6,0,6,0,6,0,0
국가행정기관,통계청,수원사무소,통계청 경인지방통계청 수원사무소,8,8,0,8,0,8,0,0
국가행정기관,통계청,의정부사무소,통계청 경인지방통계청 의정부사무소,0,0,0,0,0,0,0,0
국가행정기관,통계청,인천사무소,통계청 경인지방통계청 인천사무소,12,12,0,12,0,12,0,0
국가행정기관,통계청,동남지방통계청,통계청 동남지방통계청,0,0,0,0,0,0,0,0
국가행정기관,통계청,김해사무소,통계청 동남지방통계청 김해사무소,10,10,0,10,0,10,0,0
국가행정기관,통계청,울산사무소,통계청 동남지방통계청 울산사무소,9,9,0,9,0,9,0,0
국가행정기관,통계청,진주사무소,통계청 동남지방통계청 진주사무소,14,14,0,14,0,14,0,0
국가행정기관,통계청,창원사무소,통계청 동남지방통계청 창원사무소,16,16,0,16,0,16,0,0
국가행정기관,통계청,통영사무소,통계청 동남지방통계청 통영사무소,7,7,0,7,0,7,0,0
국가행정기관,통계청,동북지방통계청,통계청 동북지방통계청,19,19,0,19,0,19,0,0
국가행정기관,통계청,강릉사무소,통계청 동북지방통계청 강릉사무소,0,0,0,0,0,0,0,0
국가행정기관,통계청,강원지방통계지청,통계청 동북지방통계청 강원지방통계지청,0,0,0,0,0,0,0,0
국가행정기관,통계청,구미사무소,통계청 동북지방통계청 구미사무소,4,4,0,4,0,4,0,0
국가행정기관,통계청,상주사무소,통계청 동북지방통계청 상주사무소,2,2,0,2,0,2,0,0
국가행정기관,통계청,안동사무소,통계청 동북지방통계청 안동사무소,8,8,0,8,0,8,0,0
국가행정기관,통계청,영월사무소,통계청 동북지방통계청 영월사무소,5,5,0,5,0,5,0,0
국가행정기관,통계청,원주사무소,통계청 동북지방통계청 원주사무소,0,0,0,0,0,0,0,0
국가행정기관,통계청,포항사무소,통계청 동북지방통계청 포항사무소,13,13,0,13,0,13,0,0
국가행정기관,통계청,충청지방통계청,통계청 충청지방통계청,0,0,0,0,0,0,0,0
국가행정기관,통계청,보령사무소,통계청 충청지방통계청 보령사무소,4,4,0,4,0,4,0,0
국가행정기관,통계청,서산사무소,통계청 충청지방통계청 서산사무소,8,8,0,8,0,8,0,0
국가행정기관,통계청,세종사무소,통계청 충청지방통계청 세종사무소,0,0,0,0,0,0,0,0
국가행정기관,통계청,천안사무소,통계청 충청지방통계청 천안사무소,5,5,0,5,0,5,0,0
국가행정기관,통계청,청주사무소,통계청 충청지방통계청 청주사무소,12,12,0,12,0,12,0,0
국가행정기관,통계청,충주사무소,통계청 충청지방통계청 충주사무소,0,0,0,0,0,0,0,0
국가행정기관,통계청,홍성사무소,통계청 충청지방통계청 홍성사무소,0,0,0,0,0,0,0,0
국가행정기관,통계청,통계개발원,통계청 통계개발원,0,0,0,0,0,0,0,0
국가행정기관,통계청,통계교육원,통계청 통계교육원,0,0,0,0,0,0,0,0
국가행정기관,통계청,호남지방통계청,통계청 호남지방통계청,0,0,0,0,0,0,0,0
국가행정기관,통계청,강진사무소,통계청 호남지방통계청 강진사무소,10,10,0,10,0,10,0,0
국가행정기관,통계청,군산사무소,통계청 호남지방통계청 군산사무소,6,6,0,6,0,6,0,0
국가행정기관,통계청,남원사무소,통계청 호남지방통계청 남원사무소,4,4,0,4,0,4,0,0
국가행정기관,통계청,목포사무소,통계청 호남지방통계청 목포사무소,8,8,0,8,0,8,0,0
국가행정기관,통계청,보성사무소,통계청 호남지방통계청 보성사무소,4,4,0,4,0,4,0,0
국가행정기관,통계청,순천사무소,통계청 호남지방통계청 순천사무소,12,12,0,12,0,12,0,0
국가행정기관,통계청,전주사무소,통계청 호남지방통계청 전주사무소,19,19,0,19,0,19,0,0
국가행정기관,통계청,제주사무소,통계청 호남지방통계청 제주사무소,0,0,0,0,0,0,0,0
국가행정기관,통일부,통일부,통일부,753,208,545,208,0,208,0,0
국가행정기관,특허청,특허청,특허청,17,14,3,14,14,0,0,0
국가행정기관,특허청,(재)한국지식재산연구원,특허청 (재)한국지식재산연구원,5,5,0,5,0,5,0,0
국가행정기관,특허청,국제지식재산연수원,특허청 국제지식재산연수원,72,68,4,68,68,0,0,0
국가행정기관,특허청,재단법인한국특허기술진흥원,특허청 재단법인한국특허기술진흥원,49,9,40,9,0,9,0,0
국가행정기관,특허청,재단법인한국특허정보원,특허청 재단법인한국특허정보원,13,0,13,0,0,0,0,0
국가행정기관,특허청,한국발명진흥회,특허청 한국발명진흥회,110,110,0,110,7,103,0,0
국가행정기관,특허청,한국특허전략개발원,특허청 한국특허전략개발원,17,10,7,10,0,10,0,0
국가행정기관,해양경찰청,해양경찰청,해양경찰청,121,56,65,56,0,56,0,0
국가행정기관,해양경찰청,남해지방해양경찰청,해양경찰청 남해지방해양경찰청,224,28,196,28,0,28,0,0
국가행정기관,해양경찰청,부산해양경찰서,해양경찰청 남해지방해양경찰청 부산해양경찰서,276,112,164,112,62,50,0,0
국가행정기관,해양경찰청,사천해양경찰서,해양경찰청 남해지방해양경찰청 사천해양경찰서,103,47,56,47,16,31,0,0
국가행정기관,해양경찰청,울산해양경찰서,해양경찰청 남해지방해양경찰청 울산해양경찰서,219,79,140,79,37,42,0,0
국가행정기관,해양경찰청,창원해양경찰서,해양경찰청 남해지방해양경찰청 창원해양경찰서,164,89,75,89,35,54,0,0
국가행정기관,해양경찰청,통영해양경찰서,해양경찰청 남해지방해양경찰청 통영해양경찰서,225,80,145,80,21,59,0,0
국가행정기관,해양경찰청,동해지방해양경찰청,해양경찰청 동해지방해양경찰청,217,40,177,40,7,33,0,0
국가행정기관,해양경찰청,동해해양경찰서,해양경찰청 동해지방해양경찰청 동해해양경찰서,121,112,9,112,41,71,0,0
국가행정기관,해양경찰청,속초해양경찰서,해양경찰청 동해지방해양경찰청 속초해양경찰서,221,99,122,99,67,32,0,0
국가행정기관,해양경찰청,울진해양경찰서,해양경찰청 동해지방해양경찰청 울진해양경찰서,94,30,64,30,12,18,0,0
국가행정기관,해양경찰청,포항해양경찰서,해양경찰청 동해지방해양경찰청 포항해양경찰서,219,68,151,68,7,61,0,0
국가행정기관,해양경찰청,서해지방해양경찰청,해양경찰청 서해지방해양경찰청,274,31,243,31,0,31,0,0
국가행정기관,해양경찰청,군산해양경찰서,해양경찰청 서해지방해양경찰청 군산해양경찰서,262,111,151,111,58,53,0,0
국가행정기관,해양경찰청,목포해양경찰서,해양경찰청 서해지방해양경찰청 목포해양경찰서,301,78,223,78,44,34,0,0
국가행정기관,해양경찰청,부안해양경찰서,해양경찰청 서해지방해양경찰청 부안해양경찰서,127,75,52,75,12,63,0,0
국가행정기관,해양경찰청,여수해양경찰서,해양경찰청 서해지방해양경찰청 여수해양경찰서,289,150,139,150,33,117,0,0
국가행정기관,해양경찰청,완도해양경찰서,해양경찰청 서해지방해양경찰청 완도해양경찰서,109,92,17,92,22,70,0,0
국가행정기관,해양경찰청,제주지방해양경찰청,해양경찰청 제주지방해양경찰청,91,49,42,49,0,49,0,0
국가행정기관,해양경찰청,서귀포해양경찰서,해양경찰청 제주지방해양경찰청 서귀포해양경찰서,206,72,134,72,31,41,0,0
국가행정기관,해양경찰청,제주해양경찰서,해양경찰청 제주지방해양경찰청 제주해양경찰서,177,43,134,43,22,21,0,0
국가행정기관,해양경찰청,중부지방해양경찰청,해양경찰청 중부지방해양경찰청,223,70,153,70,0,70,0,0
국가행정기관,해양경찰청,보령해양경찰서 ,해양경찰청 중부지방해양경찰청 보령해양경찰서 ,160,87,73,87,9,78,0,0
국가행정기관,해양경찰청,서해5도특별경비단,해양경찰청 중부지방해양경찰청 서해5도특별경비단,185,27,158,27,0,27,0,0
국가행정기관,해양경찰청,인천해양경찰서,해양경찰청 중부지방해양경찰청 인천해양경찰서,291,132,159,132,106,26,0,0
국가행정기관,해양경찰청,태안해양경찰서,해양경찰청 중부지방해양경찰청 태안해양경찰서,217,99,118,99,65,34,0,0
국가행정기관,해양경찰청,평택해양경찰서,해양경찰청 중부지방해양경찰청 평택해양경찰서,92,85,7,85,41,44,0,0
국가행정기관,해양경찰청,중앙해양특수구조단,해양경찰청 중앙해양특수구조단,43,0,43,0,0,0,0,0
국가행정기관,해양경찰청,해양경찰교육원,해양경찰청 해양경찰교육원,251,251,0,251,0,251,0,0
국가행정기관,해양경찰청,해양경찰연구센터,해양경찰청 해양경찰연구센터,32,0,32,0,0,0,0,0
국가행정기관,해양경찰청,해양경찰정비창,해양경찰청 해양경찰정비창,36,22,14,22,0,22,0,0
국가행정기관,해양수산부,해양수산부,해양수산부,13,0,13,0,0,0,0,0
국가행정기관,해양수산부,국립수산과학원,해양수산부 국립수산과학원,516,382,134,382,1,381,0,0
국가행정기관,해양수산부,국립수산물품질관리원,해양수산부 국립수산물품질관리원,35,35,0,35,0,35,0,0
국가행정기관,해양수산부,국립해양과학관,해양수산부 국립해양과학관,119,119,0,119,50,51,13,5
국가행정기관,해양수산부,국립해양박물관,해양수산부 국립해양박물관,167,144,23,144,144,0,0,0
국가행정기관,해양수산부,국립해양생물자원관,해양수산부 국립해양생물자원관,95,48,47,48,0,48,0,0
국가행정기관,해양수산부,국립해양조사원,해양수산부 국립해양조사원,259,40,219,40,0,40,0,0
국가행정기관,해양수산부,남해해양조사사무소,해양수산부 국립해양조사원 남해해양조사사무소,67,0,67,0,0,0,0,0
국가행정기관,해양수산부,동해해양조사사무소,해양수산부 국립해양조사원 동해해양조사사무소,11,6,5,6,0,6,0,0
국가행정기관,해양수산부,서해해양조사사무소,해양수산부 국립해양조사원 서해해양조사사무소,30,2,28,2,0,2,0,0
국가행정기관,해양수산부,국립해양측위정보원 ,해양수산부 국립해양측위정보원 ,188,43,145,43,0,43,0,0
국가행정기관,해양수산부,군산지방해양수산청,해양수산부 군산지방해양수산청,411,87,324,87,2,85,0,0
국가행정기관,해양수산부,남해어업관리단,해양수산부 남해어업관리단,232,232,0,232,0,232,0,0
국가행정기관,해양수산부,대산지방해양수산청,해양수산부 대산지방해양수산청,186,13,173,13,2,11,0,0
국가행정기관,해양수산부,동해어업관리단,해양수산부 동해어업관리단,273,217,56,217,0,217,0,0
국가행정기관,해양수산부,동해지방해양수산청,해양수산부 동해지방해양수산청,382,53,329,53,12,41,0,0
국가행정기관,해양수산부,마산지방해양수산청,해양수산부 마산지방해양수산청,216,10,206,10,0,10,0,0
국가행정기관,해양수산부,목포지방해양수산청,해양수산부 목포지방해양수산청,402,201,201,201,0,201,0,0
국가행정기관,해양수산부,부산지방해양수산청,해양수산부 부산지방해양수산청,276,90,186,90,11,64,0,15
국가행정기관,해양수산부,부산항만공사,해양수산부 부산항만공사,2058,1057,1001,1057,76,783,36,162
국가행정기관,해양수산부,부산해사고등학교,해양수산부 부산해사고등학교,103,103,0,103,15,88,0,0
국가행정기관,해양수산부,서해어업관리단,해양수산부 서해어업관리단,246,160,86,160,0,160,0,0
국가행정기관,해양수산부,여수광양항만공사,해양수산부 여수광양항만공사,506,212,294,212,0,212,0,0
국가행정기관,해양수산부,여수지방해양수산청,해양수산부 여수지방해양수산청,49,40,9,40,0,40,0,0
국가행정기관,해양수산부,울산지방해양수산청,해양수산부 울산지방해양수산청,88,67,21,67,0,66,0,1
국가행정기관,해양수산부,울산항만공사,해양수산부 울산항만공사,249,41,208,41,6,35,0,0
국가행정기관,해양수산부,인천지방해양수산청,해양수산부 인천지방해양수산청,115,15,100,15,0,15,0,0
국가행정기관,해양수산부,인천항만공사,해양수산부 인천항만공사,1391,474,917,474,0,464,0,10
국가행정기관,해양수산부,인천해사고등학교,해양수산부 인천해사고등학교,90,89,1,89,0,89,0,0
국가행정기관,해양수산부,중앙해양안전심판원,해양수산부 중앙해양안전심판원,4,4,0,4,0,4,0,0
국가행정기관,해양수산부,평택지방해양수산청,해양수산부 평택지방해양수산청,395,194,201,194,194,0,0,0
국가행정기관,해양수산부,포항지방해양수산청,해양수산부 포항지방해양수산청,326,77,249,77,1,76,0,0
국가행정기관,해양수산부,한국수산자원공단,해양수산부 한국수산자원공단,67,39,28,39,10,29,0,0
국가행정기관,해양수산부,한국어촌어항공단,해양수산부 한국어촌어항공단,285,281,4,281,0,281,0,0
국가행정기관,해양수산부,한국항로표지기술원,해양수산부 한국항로표지기술원,134,109,25,109,2,107,0,0
국가행정기관,해양수산부,한국해양과학기술원,해양수산부 한국해양과학기술원,337,337,0,337,0,337,0,0
국가행정기관,해양수산부,한국해양교통안전공단,해양수산부 한국해양교통안전공단,79,71,8,71,29,42,0,0
국가행정기관,해양수산부,한국해양수산연수원,해양수산부 한국해양수산연수원,221,221,0,221,0,221,0,0
국가행정기관,해양수산부,한국해양조사협회,해양수산부 한국해양조사협회,7,3,4,3,0,3,0,0
국가행정기관,해양수산부,한국해양진흥공사,해양수산부 한국해양진흥공사,16,11,5,11,0,11,0,0
국가행정기관,해양수산부,해양수산과학기술진흥원,해양수산부 해양수산과학기술진흥원,2,0,2,0,0,0,0,0
국가행정기관,해양수산부,해양수산인재개발원,해양수산부 해양수산인재개발원,21,21,0,21,0,21,0,0
국가행정기관,해양수산부,해양환경공단,해양수산부 해양환경공단,527,45,482,45,0,45,0,0
국가행정기관,행정안전부,행정안전부,행정안전부,72,15,57,15,0,15,0,0
국가행정기관,행정안전부,(재)일제강제동원피해자지원재단,행정안전부 (재)일제강제동원피해자지원재단,92,91,1,91,0,91,0,0
국가행정기관,행정안전부,국가기록원,행정안전부 국가기록원,386,6,380,6,5,1,0,0
국가행정기관,행정안전부,국가정보자원관리원,행정안전부 국가정보자원관리원,1477,6,1471,6,2,4,0,0
국가행정기관,행정안전부,국립과학수사연구원,행정안전부 국립과학수사연구원,247,12,235,12,6,6,0,0
국가행정기관,행정안전부,국립재난안전연구원,행정안전부 국립재난안전연구원,76,65,11,65,0,65,0,0
국가행정기관,행정안전부,대통령기록관,행정안전부 대통령기록관,178,95,83,95,0,95,0,0
국가행정기관,행정안전부,대한지방행정공제회,행정안전부 대한지방행정공제회,16,7,9,7,3,4,0,0
국가행정기관,행정안전부,민주화운동기념사업회,행정안전부 민주화운동기념사업회,32,32,0,32,0,32,0,0
국가행정기관,행정안전부,이북5도,행정안전부 이북5도,30,30,0,30,0,30,0,0
국가행정기관,행정안전부,정부청사관리본부,행정안전부 정부청사관리본부,4761,1790,2971,1790,0,1790,0,0
국가행정기관,행정안전부,지방공기업평가원,행정안전부 지방공기업평가원,12,12,0,12,0,12,0,0
국가행정기관,행정안전부,지방자치인재개발원,행정안전부 지방자치인재개발원,145,145,0,145,20,125,0,0
국가행정기관,행정안전부,한국섬진흥원,행정안전부 한국섬진흥원,0,0,0,0,0,0,0,0
국가행정기관,행정안전부,한국승강기안전공단,행정안전부 한국승강기안전공단,14,14,0,14,0,14,0,0
국가행정기관,행정안전부,한국지방재정공제회,행정안전부 한국지방재정공제회,44,44,0,44,0,44,0,0
국가행정기관,행정안전부,한국지방행정연구원,행정안전부 한국지방행정연구원,31,13,18,13,0,13,0,0
국가행정기관,행정안전부,한국지역정보개발원,행정안전부 한국지역정보개발원,95,25,70,25,0,25,0,0
국가행정기관,행정중심복합도시건설청,행정중심복합도시건설청,행정중심복합도시건설청,0,0,0,0,0,0,0,0
국가행정기관,환경부,환경부,환경부,10,2,8,2,2,0,0,0
국가행정기관,환경부,국가미세먼지정보센터,환경부 국가미세먼지정보센터,3,3,0,3,0,3,0,0
국가행정기관,환경부,국립공원공단,환경부 국립공원공단,2919,2825,94,2825,821,1995,2,7
국가행정기관,환경부,국립낙동강생물자원관,환경부 국립낙동강생물자원관,156,80,76,80,8,49,0,23
국가행정기관,환경부,국립생물자원관,환경부 국립생물자원관,138,138,0,138,0,138,0,0
국가행정기관,환경부,국립생태원,환경부 국립생태원,544,257,287,257,4,253,0,0
국가행정기관,환경부,국립야생동물질병관리원,환경부 국립야생동물질병관리원,91,15,76,15,6,7,1,1
국가행정기관,환경부,국립호남권생물자원관,환경부 국립호남권생물자원관,57,53,4,53,0,53,0,0
국가행정기관,환경부,국립환경과학원,환경부 국립환경과학원,384,111,273,111,0,111,0,0
국가행정기관,환경부,금강물환경연구소,환경부 국립환경과학원 금강물환경연구소,18,9,9,9,1,8,0,0
국가행정기관,환경부,낙동강물환경연구소,환경부 국립환경과학원 낙동강물환경연구소,39,35,4,35,0,35,0,0
국가행정기관,환경부,영산강물환경연구소,환경부 국립환경과학원 영산강물환경연구소,8,1,7,1,0,1,0,0
국가행정기관,환경부,한강물환경연구소,환경부 국립환경과학원 한강물환경연구소,33,24,9,24,0,24,0,0
국가행정기관,환경부,국립환경인재개발원,환경부 국립환경인재개발원,57,11,46,11,0,11,0,0
국가행정기관,환경부,금강유역환경청,환경부 금강유역환경청,26,24,2,24,1,23,0,0
국가행정기관,환경부,금강홍수통제소,환경부 금강홍수통제소,100,69,31,69,12,57,0,0
국가행정기관,환경부,낙동강유역환경청,환경부 낙동강유역환경청,21,21,0,21,10,11,0,0
국가행정기관,환경부,낙동강홍수통제소,환경부 낙동강홍수통제소,130,121,9,121,8,113,0,0
국가행정기관,환경부,대구지방환경청,환경부 대구지방환경청,17,17,0,17,0,17,0,0
국가행정기관,환경부,수도권대기환경청,환경부 수도권대기환경청,15,15,0,15,0,15,0,0
국가행정기관,환경부,수도권매립지관리공사,환경부 수도권매립지관리공사,665,665,0,665,0,665,0,0
국가행정기관,환경부,수자원환경산업진흥(주),환경부 수자원환경산업진흥(주),102,99,3,99,0,99,0,0
국가행정기관,환경부,영산강유역환경청,환경부 영산강유역환경청,38,23,15,23,0,23,0,0
국가행정기관,환경부,영산강홍수통제소,환경부 영산강홍수통제소,101,101,0,101,0,101,0,0
국가행정기관,환경부,온실가스종합정보센터,환경부 온실가스종합정보센터,6,0,6,0,0,0,0,0
국가행정기관,환경부,원주지방환경청,환경부 원주지방환경청,28,28,0,28,0,28,0,0
국가행정기관,환경부,전북지방환경청,환경부 전북지방환경청,19,19,0,19,0,19,0,0
국가행정기관,환경부,한강유역환경청,환경부 한강유역환경청,32,27,5,27,0,27,0,0
국가행정기관,환경부,한강홍수통제소,환경부 한강홍수통제소,261,213,48,213,0,213,0,0
국가행정기관,환경부,한국상하수도협회,환경부 한국상하수도협회,21,21,0,21,0,21,0,0
국가행정기관,환경부,한국수자원공사,환경부 한국수자원공사,5424,1342,4082,1342,169,1169,0,4
국가행정기관,환경부,한국환경공단,환경부 한국환경공단,3441,448,2993,448,0,448,0,0
국가행정기관,환경부,한국환경산업기술원,환경부 한국환경산업기술원,375,206,169,206,91,115,0,0
국가행정기관,환경부,화학물질안전원,환경부 화학물질안전원,73,71,2,71,0,71,0,0
국가행정기관,환경부,환경보전협회,환경부 환경보전협회,23,23,0,23,0,23,0,0
자치단체,서울특별시,서울특별시,서울특별시,3433,2973,460,2973,98,1745,399,731
자치단체,서울특별시,(재)서울시립교향악단,서울특별시 (재)서울시립교향악단,5,0,5,0,0,0,0,0
자치단체,서울특별시,(재)서울특별시평생교육진흥원,서울특별시 (재)서울특별시평생교육진흥원,128,128,0,128,0,128,0,0
자치단체,서울특별시,강남구,서울특별시 강남구,7243,7243,0,7243,6495,126,622,0
자치단체,서울특별시,강동구,서울특별시 강동구,3190,3190,0,3190,3086,0,104,0
자치단체,서울특별시,강북구,서울특별시 강북구,3319,3319,0,3319,3182,35,102,0
자치단체,서울특별시,강서구,서울특별시 강서구,3746,3665,81,3665,3170,380,114,1
자치단체,서울특별시,강서구시설관리공단,서울특별시 강서구 강서구시설관리공단,587,587,0,587,0,587,0,0
자치단체,서울특별시,관악구,서울특별시 관악구,5398,5398,0,5398,4029,719,650,0
자치단체,서울특별시,서울특별시관악구시설관리공단,서울특별시 관악구 서울특별시관악구시설관리공단,978,956,22,956,69,887,0,0
자치단체,서울특별시,광진구,서울특별시 광진구,3493,3480,13,3480,3253,141,86,0
자치단체,서울특별시,구로구,서울특별시 구로구,4693,4693,0,4693,4013,265,415,0
자치단체,서울특별시,금천구,서울특별시 금천구,2653,2653,0,2653,2498,0,155,0
자치단체,서울특별시,금천구시설관리공단,서울특별시 금천구 금천구시설관리공단,560,542,18,542,0,542,0,0
자치단체,서울특별시,남부도로사업소,서울특별시 남부도로사업소,232,232,0,232,39,193,0,0
자치단체,서울특별시,노원구,서울특별시 노원구,2617,2617,0,2617,2284,180,153,0
자치단체,서울특별시,농업기술센터,서울특별시 농업기술센터,6,6,0,6,0,6,0,0
자치단체,서울특별시,데이터센터,서울특별시 데이터센터,165,0,165,0,0,0,0,0
자치단체,서울특별시,도봉구,서울특별시 도봉구,2600,2600,0,2600,1833,667,100,0
자치단체,서울특별시,도봉구시설관리공단,서울특별시 도봉구 도봉구시설관리공단,462,462,0,462,0,462,0,0
자치단체,서울특별시,동대문구,서울특별시 동대문구,2759,2759,0,2759,2601,1,157,0
자치단체,서울특별시,동대문구시설관리공단,서울특별시 동대문구 동대문구시설관리공단,836,836,0,836,0,836,0,0
자치단체,서울특별시,동부공원녹지사업소,서울특별시 동부공원녹지사업소,155,155,0,155,0,155,0,0
자치단체,서울특별시,동작구,서울특별시 동작구,2671,2671,0,2671,2404,99,63,105
자치단체,서울특별시,마포구,서울특별시 마포구,2628,2628,0,2628,2500,0,128,0
자치단체,서울특별시,보건환경연구원,서울특별시 보건환경연구원,106,106,0,106,100,6,0,0
자치단체,서울특별시,북부도로사업소,서울특별시 북부도로사업소,250,216,34,216,0,216,0,0
자치단체,서울특별시,상수도사업본부,서울특별시 상수도사업본부,31,31,0,31,0,31,0,0
자치단체,서울특별시,강남수도사업소,서울특별시 상수도사업본부 강남수도사업소,65,12,53,12,0,12,0,0
자치단체,서울특별시,강동수도사업소,서울특별시 상수도사업본부 강동수도사업소,40,16,24,16,0,16,0,0
자치단체,서울특별시,강북아리수정수센터,서울특별시 상수도사업본부 강북아리수정수센터,189,0,189,0,0,0,0,0
자치단체,서울특별시,강서수도사업소,서울특별시 상수도사업본부 강서수도사업소,82,57,25,57,0,57,0,0
자치단체,서울특별시,광암아리수정수센터,서울특별시 상수도사업본부 광암아리수정수센터,80,0,80,0,0,0,0,0
자치단체,서울특별시,구의아리수정수센터,서울특별시 상수도사업본부 구의아리수정수센터,95,3,92,3,0,3,0,0
자치단체,서울특별시,남부수도사업소,서울특별시 상수도사업본부 남부수도사업소,93,9,84,9,0,9,0,0
자치단체,서울특별시,동부수도사업소,서울특별시 상수도사업본부 동부수도사업소,50,14,36,14,1,13,0,0
자치단체,서울특별시,뚝도아리수정수센터,서울특별시 상수도사업본부 뚝도아리수정수센터,140,33,107,33,0,33,0,0
자치단체,서울특별시,북부수도사업소,서울특별시 상수도사업본부 북부수도사업소,61,61,0,61,0,61,0,0
자치단체,서울특별시,서부수도사업소,서울특별시 상수도사업본부 서부수도사업소,8,2,6,2,1,0,1,0
자치단체,서울특별시,수도자재관리센터,서울특별시 상수도사업본부 수도자재관리센터,22,22,0,22,0,22,0,0
자치단체,서울특별시,암사아리수정수센터,서울특별시 상수도사업본부 암사아리수정수센터,172,172,0,172,0,172,0,0
자치단체,서울특별시,영등포아리수정수센터,서울특별시 상수도사업본부 영등포아리수정수센터,156,0,156,0,0,0,0,0
자치단체,서울특별시,중부수도사업소,서울특별시 상수도사업본부 중부수도사업소,92,92,0,92,0,92,0,0
자치단체,서울특별시,서대문구,서울특별시 서대문구,3445,3445,0,3445,2796,277,372,0
자치단체,서울특별시,서대문구도시관리공단,서울특별시 서대문구 서대문구도시관리공단,540,540,0,540,30,510,0,0
자치단체,서울특별시,서부공원녹지사업소,서울특별시 서부공원녹지사업소,396,396,0,396,0,396,0,0
자치단체,서울특별시,서울교통공사,서울특별시 서울교통공사,22573,19077,3496,19077,0,19077,0,0
자치단체,서울특별시,서울기록원,서울특별시 서울기록원,112,112,0,112,0,112,0,0
자치단체,서울특별시,서울대공원,서울특별시 서울대공원,695,695,0,695,191,504,0,0
자치단체,서울특별시,서울도서관,서울특별시 서울도서관,47,47,0,47,0,47,0,0
자치단체,서울특별시,서울물재생시설공단,서울특별시 서울물재생시설공단,463,463,0,463,105,358,0,0
자치단체,서울특별시,서울산업진흥원,서울특별시 서울산업진흥원,870,870,0,870,0,870,0,0
자치단체,서울특별시,서울시립과학관,서울특별시 서울시립과학관,87,87,0,87,0,87,0,0
자치단체,서울특별시,서울시설공단,서울특별시 서울시설공단,5480,4992,488,4992,0,4628,0,364
자치단체,서울특별시,서울식물원,서울특별시 서울식물원,329,329,0,329,329,0,0,0
자치단체,서울특별시,서울신용보증재단,서울특별시 서울신용보증재단,49,49,0,49,0,49,0,0
자치단체,서울특별시,서울에너지공사,서울특별시 서울에너지공사,116,53,63,53,0,53,0,0
자치단체,서울특별시,서울역사박물관,서울특별시 서울역사박물관,497,487,10,487,0,487,0,0
자치단체,서울특별시,서울역사편찬원,서울특별시 서울역사편찬원,11,11,0,11,0,11,0,0
자치단체,서울특별시,서울연구원,서울특별시 서울연구원,11,11,0,11,0,11,0,0
자치단체,서울특별시,서울의료원,서울특별시 서울의료원,456,456,0,456,0,456,0,0
자치단체,서울특별시,서울종합방재센터,서울특별시 서울종합방재센터,63,47,16,47,0,47,0,0
자치단체,서울특별시,서울주택도시공사,서울특별시 서울주택도시공사,26523,26523,0,26523,6528,19155,640,200
자치단체,서울특별시,서울특별시50플러스재단,서울특별시 서울특별시50플러스재단,126,121,5,121,0,121,0,0
자치단체,서울특별시,서울특별시농수산식품공사,서울특별시 서울특별시농수산식품공사,1222,1092,130,1092,0,911,0,181
자치단체,서울특별시,서울특별시미디어재단티비에스,서울특별시 서울특별시미디어재단티비에스,10,0,10,0,0,0,0,0
자치단체,서울특별시,서울특별시여성가족재단,서울특별시 서울특별시여성가족재단,272,272,0,272,0,272,0,0
자치단체,서울특별시,서초구,서울특별시 서초구,5561,5553,8,5553,3205,1220,1128,0
자치단체,서울특별시,재단법인서초문화재단,서울특별시 서초구 재단법인서초문화재단,46,46,0,46,0,46,0,0
자치단체,서울특별시,성동구,서울특별시 성동구,4047,4047,0,4047,3521,106,420,0
자치단체,서울특별시,성동도로사업소,서울특별시 성동도로사업소,101,101,0,101,0,101,0,0
자치단체,서울특별시,성북구,서울특별시 성북구,4810,4810,0,4810,4157,400,235,18
자치단체,서울특별시,성북구도시관리공단,서울특별시 성북구 성북구도시관리공단,633,633,0,633,0,633,0,0
자치단체,서울특별시,송파구,서울특별시 송파구,3204,3204,0,3204,2856,65,283,0
자치단체,서울특별시,송파구시설관리공단,서울특별시 송파구 송파구시설관리공단,344,344,0,344,87,257,0,0
자치단체,서울특별시,시립미술관,서울특별시 시립미술관,310,250,60,250,0,250,0,0
자치단체,서울특별시,아동복지센터,서울특별시 아동복지센터,24,0,24,0,0,0,0,0
자치단체,서울특별시,양천구,서울특별시 양천구,4472,4408,64,4408,3609,627,172,0
자치단체,서울특별시,영등포구,서울특별시 영등포구,4397,4397,0,4397,3820,5,572,0
자치단체,서울특별시,용산구,서울특별시 용산구,2970,2970,0,2970,2245,402,323,0
자치단체,서울특별시,은평구,서울특별시 은평구,4541,4541,0,4541,4103,266,172,0
자치단체,서울특별시,은평병원,서울특별시 은평병원,157,79,78,79,0,79,0,0
자치단체,서울특별시,인재개발원,서울특별시 인재개발원,68,61,7,61,0,61,0,0
자치단체,서울특별시,재단법인서울디자인재단,서울특별시 재단법인서울디자인재단,680,680,0,680,0,680,0,0
자치단체,서울특별시,재단법인서울특별시사회서비스원,서울특별시 재단법인서울특별시사회서비스원,201,201,0,201,0,201,0,0
자치단체,서울특별시,재단법인세종문화회관,서울특별시 재단법인세종문화회관,144,131,13,131,0,131,0,0
자치단체,서울특별시,종로구,서울특별시 종로구,2949,2949,0,2949,2058,713,178,0
자치단체,서울특별시,종로구시설관리공단,서울특별시 종로구 종로구시설관리공단,583,583,0,583,0,583,0,0
자치단체,서울특별시,중랑구,서울특별시 중랑구,4193,4193,0,4193,3856,59,278,0
자치단체,서울특별시,중랑구시설관리공단,서울특별시 중랑구 중랑구시설관리공단,733,733,0,733,0,733,0,0
자치단체,서울특별시,중랑물재생센터,서울특별시 중랑물재생센터,360,60,300,60,42,12,0,6
자치단체,서울특별시,중부공원녹지사업소,서울특별시 중부공원녹지사업소,206,206,0,206,188,18,0,0
자치단체,서울특별시,체육시설관리사업소,서울특별시 체육시설관리사업소,183,183,0,183,0,183,0,0
자치단체,서울특별시,품질시험소,서울특별시 품질시험소,12,12,0,12,0,12,0,0
자치단체,서울특별시,한강사업본부,서울특별시 한강사업본부,966,966,0,966,557,409,0,0
자치단체,서울특별시,한성백제박물관,서울특별시 한성백제박물관,119,112,7,112,0,112,0,0
자치단체,부산광역시,부산광역시,부산광역시,7062,7013,49,7013,6145,665,203,0
자치단체,부산광역시,(재)부산문화재단,부산광역시 (재)부산문화재단,98,98,0,98,49,49,0,0
자치단체,부산광역시,강서구,부산광역시 강서구,1387,1387,0,1387,1250,30,107,0
자치단체,부산광역시,교통정보서비스센터,부산광역시 교통정보서비스센터,217,217,0,217,0,0,0,217
자치단체,부산광역시,국제수산물유통시설관리사업소,부산광역시 국제수산물유통시설관리사업소,291,291,0,291,0,291,0,0
자치단체,부산광역시,금련산청소년수련원,부산광역시 금련산청소년수련원,18,18,0,18,0,18,0,0
자치단체,부산광역시,금정구,부산광역시 금정구,1541,1541,0,1541,1284,50,207,0
자치단체,부산광역시,기장군,부산광역시 기장군,1515,1515,0,1515,1215,31,269,0
자치단체,부산광역시,기장군도시관리공단,부산광역시 기장군 기장군도시관리공단,522,522,0,522,0,522,0,0
자치단체,부산광역시,낙동강관리본부,부산광역시 낙동강관리본부,156,156,0,156,156,0,0,0
자치단체,부산광역시,남구,부산광역시 남구,1841,1829,12,1829,1213,394,222,0
자치단체,부산광역시,남항관리사업소,부산광역시 남항관리사업소,172,172,0,172,0,172,0,0
자치단체,부산광역시,동구,부산광역시 동구,1270,1270,0,1270,1093,50,127,0
자치단체,부산광역시,동래구,부산광역시 동래구,1263,1263,0,1263,863,203,197,0
자치단체,부산광역시,반여농산물도매시장관리사업소,부산광역시 반여농산물도매시장관리사업소,101,101,0,101,0,101,0,0
자치단체,부산광역시,보건환경연구원,부산광역시 보건환경연구원,30,21,9,21,21,0,0,0
자치단체,부산광역시,부산관광공사,부산광역시 부산관광공사,116,114,2,114,0,114,0,0
자치단체,부산광역시,부산광역시 시립박물관,부산광역시 부산광역시 시립박물관,95,65,30,65,0,65,0,0
자치단체,부산광역시,복천박물관,부산광역시 부산광역시 시립박물관 복천박물관,40,40,0,40,20,20,0,0
자치단체,부산광역시,정관박물관,부산광역시 부산광역시 시립박물관 정관박물관,32,28,4,28,0,28,0,0
자치단체,부산광역시,부산교통공사,부산광역시 부산교통공사,6051,5419,632,5419,0,5419,0,0
자치단체,부산광역시,부산근현대역사관,부산광역시 부산근현대역사관,17,17,0,17,0,17,0,0
자치단체,부산광역시,임시수도기념관,부산광역시 부산근현대역사관 임시수도기념관,24,24,0,24,9,15,0,0
자치단체,부산광역시,부산도서관,부산광역시 부산도서관,129,92,37,92,0,92,0,0
자치단체,부산광역시,부산도시공사,부산광역시 부산도시공사,35,31,4,31,0,31,0,0
자치단체,부산광역시,부산시설공단,부산광역시 부산시설공단,2630,2504,126,2504,2,1908,0,594
자치단체,부산광역시,부산지방공단스포원,부산광역시 부산지방공단스포원,326,326,0,326,146,160,0,20
자치단체,부산광역시,부산진구,부산광역시 부산진구,1645,1645,0,1645,1102,104,431,8
자치단체,부산광역시,북구,부산광역시 북구,1877,1877,0,1877,1811,43,23,0
자치단체,부산광역시,사상구,부산광역시 사상구,906,906,0,906,759,67,80,0
자치단체,부산광역시,사하구,부산광역시 사하구,1952,1952,0,1952,1352,521,79,0
자치단체,부산광역시,상수도사업본부,부산광역시 상수도사업본부,913,158,755,158,0,158,0,0
자치단체,부산광역시,서구,부산광역시 서구,657,653,4,653,515,60,76,2
자치단체,부산광역시,소방재난본부,부산광역시 소방재난본부,38,26,12,26,0,26,0,0
자치단체,부산광역시,강서소방서,부산광역시 소방재난본부 강서소방서,24,24,0,24,6,18,0,0
자치단체,부산광역시,금정소방서,부산광역시 소방재난본부 금정소방서,24,17,7,17,0,17,0,0
자치단체,부산광역시,기장소방서,부산광역시 소방재난본부 기장소방서,15,10,5,10,0,10,0,0
자치단체,부산광역시,남부소방서,부산광역시 소방재난본부 남부소방서,18,18,0,18,0,18,0,0
자치단체,부산광역시,동래소방서,부산광역시 소방재난본부 동래소방서,30,30,0,30,7,23,0,0
자치단체,부산광역시,부산진소방서,부산광역시 소방재난본부 부산진소방서,70,28,42,28,7,21,0,0
자치단체,부산광역시,북부소방서,부산광역시 소방재난본부 북부소방서,38,38,0,38,26,12,0,0
자치단체,부산광역시,사하소방서,부산광역시 소방재난본부 사하소방서,15,7,8,7,0,7,0,0
자치단체,부산광역시,소방학교,부산광역시 소방재난본부 소방학교,15,15,0,15,0,15,0,0
자치단체,부산광역시,중부소방서,부산광역시 소방재난본부 중부소방서,40,40,0,40,7,33,0,0
자치단체,부산광역시,특수구조단,부산광역시 소방재난본부 특수구조단,18,18,0,18,0,18,0,0
자치단체,부산광역시,항만소방서,부산광역시 소방재난본부 항만소방서,27,27,0,27,4,23,0,0
자치단체,부산광역시,해운대소방서,부산광역시 소방재난본부 해운대소방서,23,23,0,23,7,16,0,0
자치단체,부산광역시,수산자원연구소,부산광역시 수산자원연구소,15,9,6,9,0,9,0,0
자치단체,부산광역시,수영구,부산광역시 수영구,1036,1036,0,1036,751,137,148,0
자치단체,부산광역시,시립미술관,부산광역시 시립미술관,68,60,8,60,0,60,0,0
자치단체,부산광역시,엄궁농산물도매시장관리사업소,부산광역시 엄궁농산물도매시장관리사업소,27,27,0,27,0,27,0,0
자치단체,부산광역시,여성문화회관,부산광역시 여성문화회관,14,14,0,14,0,14,0,0
자치단체,부산광역시,여성회관,부산광역시 여성회관,6,6,0,6,6,0,0,0
자치단체,부산광역시,연제구,부산광역시 연제구,845,845,0,845,568,43,234,0
자치단체,부산광역시,영도구,부산광역시 영도구,979,979,0,979,505,431,43,0
자치단체,부산광역시,인재개발원,부산광역시 인재개발원,67,67,0,67,0,67,0,0
자치단체,부산광역시,중구,부산광역시 중구,822,822,0,822,745,42,35,0
자치단체,부산광역시,체육시설관리사업소,부산광역시 체육시설관리사업소,329,329,0,329,0,329,0,0
자치단체,부산광역시,충렬사관리사무소,부산광역시 충렬사관리사무소,18,18,0,18,0,18,0,0
자치단체,부산광역시,푸른도시가꾸기사업소,부산광역시 푸른도시가꾸기사업소,38,38,0,38,38,0,0,0
자치단체,부산광역시,해양자연사박물관,부산광역시 해양자연사박물관,39,39,0,39,0,39,0,0
자치단체,부산광역시,해운대구,부산광역시 해운대구,1870,1870,0,1870,1523,94,253,0
자치단체,부산광역시,현대미술관,부산광역시 현대미술관,68,60,8,60,0,60,0,0
자치단체,대구광역시,대구광역시,대구광역시,1696,1612,84,1612,231,1045,27,309
자치단체,대구광역시,남구,대구광역시 남구,1985,1985,0,1985,989,887,100,9
자치단체,대구광역시,달서구,대구광역시 달서구,3192,3192,0,3192,2331,707,154,0
자치단체,대구광역시,달성군,대구광역시 달성군,2530,2530,0,2530,1585,881,59,5
자치단체,대구광역시,대구공공시설관리공단,대구광역시 대구공공시설관리공단,2755,2325,430,2325,8,2317,0,0
자치단체,대구광역시,대구도시개발공사,대구광역시 대구도시개발공사,623,604,19,604,180,391,0,33
자치단체,대구광역시,대구도시철도공사,대구광역시 대구도시철도공사,4505,3412,1093,3412,0,3412,0,0
자치단체,대구광역시,대구의료원,대구광역시 대구의료원,421,338,83,338,0,297,0,41
자치단체,대구광역시,동구,대구광역시 동구,1602,1602,0,1602,1368,177,57,0
자치단체,대구광역시,북구,대구광역시 북구,2151,2151,0,2151,1303,632,216,0
자치단체,대구광역시,서구,대구광역시 서구,1554,1554,0,1554,1112,390,52,0
자치단체,대구광역시,수성구,대구광역시 수성구,2610,2604,6,2604,1852,522,230,0
자치단체,대구광역시,중구,대구광역시 중구,1689,1689,0,1689,1126,466,97,0
자치단체,인천광역시,인천광역시,인천광역시,1583,1544,39,1544,57,1149,160,178
자치단체,인천광역시,강화군,인천광역시 강화군,3164,3067,97,3067,1891,1149,27,0
자치단체,인천광역시,강화군시설관리공단,인천광역시 강화군 강화군시설관리공단,305,305,0,305,0,305,0,0
자치단체,인천광역시,강화소방서,인천광역시 강화소방서,63,63,0,63,0,63,0,0
자치단체,인천광역시,검단소방서,인천광역시 검단소방서,16,16,0,16,0,16,0,0
자치단체,인천광역시,경제자유구역청,인천광역시 경제자유구역청,2868,2868,0,2868,2015,712,0,141
자치단체,인천광역시,계양공원사업소,인천광역시 계양공원사업소,37,37,0,37,0,37,0,0
자치단체,인천광역시,계양구,인천광역시 계양구,2930,2918,12,2918,2070,772,76,0
자치단체,인천광역시,인천광역시계양구시설관리공단,인천광역시 계양구 인천광역시계양구시설관리공단,513,513,0,513,0,513,0,0
자치단체,인천광역시,계양소방서,인천광역시 계양소방서,24,24,0,24,0,24,0,0
자치단체,인천광역시,공단소방서,인천광역시 공단소방서,46,46,0,46,0,46,0,0
자치단체,인천광역시,남동구,인천광역시 남동구,3518,3490,28,3490,2689,658,143,0
자치단체,인천광역시,인천광역시남동구도시관리공단,인천광역시 남동구 인천광역시남동구도시관리공단,424,423,1,423,0,423,0,0
자치단체,인천광역시,남동소방서,인천광역시 남동소방서,19,19,0,19,0,19,0,0
자치단체,인천광역시,남촌농축산물도매시장관리사무소,인천광역시 남촌농축산물도매시장관리사무소,449,449,0,449,0,449,0,0
자치단체,인천광역시,농업기술센터,인천광역시 농업기술센터,20,20,0,20,0,20,0,0
자치단체,인천광역시,동구,인천광역시 동구,1757,1685,72,1685,1046,617,22,0
자치단체,인천광역시,문화예술회관,인천광역시 문화예술회관,73,73,0,73,0,73,0,0
자치단체,인천광역시,미추홀구,인천광역시 미추홀구,3523,3487,36,3487,2702,703,0,82
자치단체,인천광역시,인천광역시미추홀구시설관리공단,인천광역시 미추홀구 인천광역시미추홀구시설관리공단,381,381,0,381,0,51,0,330
자치단체,인천광역시,미추홀도서관,인천광역시 미추홀도서관,171,171,0,171,0,171,0,0
자치단체,인천광역시,미추홀소방서,인천광역시 미추홀소방서,40,40,0,40,0,40,0,0
자치단체,인천광역시,보건환경연구원,인천광역시 보건환경연구원,19,19,0,19,8,11,0,0
자치단체,인천광역시,부평구,인천광역시 부평구,2017,2012,5,2012,1657,270,85,0
자치단체,인천광역시,인천광역시부평구시설관리공단,인천광역시 부평구 인천광역시부평구시설관리공단,714,698,16,698,0,698,0,0
자치단체,인천광역시,부평소방서,인천광역시 부평소방서,20,19,1,19,0,19,0,0
자치단체,인천광역시,삼산농산물도매시장관리사무소,인천광역시 삼산농산물도매시장관리사무소,85,85,0,85,0,85,0,0
자치단체,인천광역시,상수도사업본부,인천광역시 상수도사업본부,615,123,492,123,0,123,0,0
자치단체,인천광역시,서구,인천광역시 서구,4149,4120,29,4120,3311,647,162,0
자치단체,인천광역시,인천광역시서구시설관리공단,인천광역시 서구 인천광역시서구시설관리공단,887,882,5,882,7,875,0,0
자치단체,인천광역시,서부소방서,인천광역시 서부소방서,27,27,0,27,0,27,0,0
자치단체,인천광역시,서부여성회관,인천광역시 서부여성회관,32,32,0,32,22,10,0,0
자치단체,인천광역시,소방학교,인천광역시 소방학교,18,6,12,6,4,2,0,0
자치단체,인천광역시,송도소방서,인천광역시 송도소방서,33,27,6,27,23,4,0,0
자치단체,인천광역시,수산기술지원센터,인천광역시 수산기술지원센터,15,15,0,15,0,15,0,0
자치단체,인천광역시,수산자원연구소,인천광역시 수산자원연구소,35,35,0,35,15,20,0,0
자치단체,인천광역시,시립박물관,인천광역시 시립박물관,156,156,0,156,0,156,0,0
자치단체,인천광역시,아동복지관,인천광역시 아동복지관,3,3,0,3,0,3,0,0
자치단체,인천광역시,여성복지관,인천광역시 여성복지관,21,21,0,21,0,21,0,0
자치단체,인천광역시,여성의광장,인천광역시 여성의광장,38,38,0,38,0,38,0,0
자치단체,인천광역시,연수구,인천광역시 연수구,1895,1895,0,1895,1658,26,187,24
자치단체,인천광역시,인천광역시연수구시설안전관리공단,인천광역시 연수구 인천광역시연수구시설안전관리공단,300,292,8,292,0,292,0,0
자치단체,인천광역시,영종소방서,인천광역시 영종소방서,32,32,0,32,0,32,0,0
자치단체,인천광역시,옹진군,인천광역시 옹진군,947,947,0,947,552,395,0,0
자치단체,인천광역시,월미공원사업소,인천광역시 월미공원사업소,69,69,0,69,0,69,0,0
자치단체,인천광역시,의회사무처,인천광역시 의회사무처,44,44,0,44,0,44,0,0
자치단체,인천광역시,인재개발원,인천광역시 인재개발원,22,22,0,22,0,22,0,0
자치단체,인천광역시,인천관광공사,인천광역시 인천관광공사,154,154,0,154,0,154,0,0
자치단체,인천광역시,인천광역시의료원,인천광역시 인천광역시의료원,277,228,49,228,47,177,2,2
자치단체,인천광역시,인천교통공사,인천광역시 인천교통공사,4713,4146,567,4146,848,3298,0,0
자치단체,인천광역시,인천대공원사업소,인천광역시 인천대공원사업소,257,257,0,257,0,257,0,0
자치단체,인천광역시,인천도시공사,인천광역시 인천도시공사,1552,1540,12,1540,1540,0,0,0
자치단체,인천광역시,인천시설공단,인천광역시 인천시설공단,2457,2055,402,2055,64,1991,0,0
자치단체,인천광역시,인천환경공단,인천광역시 인천환경공단,605,221,384,221,48,173,0,0
자치단체,인천광역시,종합건설본부,인천광역시 종합건설본부,24,24,0,24,24,0,0,0
자치단체,인천광역시,중구,인천광역시 중구,1609,1606,3,1606,1238,288,80,0
자치단체,인천광역시,인천광역시중구시설관리공단,인천광역시 중구 인천광역시중구시설관리공단,522,521,1,521,0,521,0,0
자치단체,인천광역시,중부소방서,인천광역시 중부소방서,8,8,0,8,2,6,0,0
자치단체,광주광역시,광주광역시,광주광역시,11130,10731,399,10731,9269,1219,57,186
자치단체,광주광역시,광산구,광주광역시 광산구,1531,1515,16,1515,465,921,129,0
자치단체,광주광역시,광산구시설관리공단,광주광역시 광산구시설관리공단,325,325,0,325,0,325,0,0
자치단체,광주광역시,광주광역시도시공사,광주광역시 광주광역시도시공사,673,635,38,635,75,560,0,0
자치단체,광주광역시,광주광역시도시철도공사,광주광역시 광주광역시도시철도공사,1015,821,194,821,59,762,0,0
자치단체,광주광역시,광주환경공단,광주광역시 광주환경공단,336,42,294,42,0,42,0,0
자치단체,광주광역시,김대중컨벤션센터,광주광역시 김대중컨벤션센터,176,176,0,176,0,176,0,0
자치단체,광주광역시,남구,광주광역시 남구,1035,1035,0,1035,472,497,66,0
자치단체,광주광역시,동구,광주광역시 동구,511,510,1,510,242,223,45,0
자치단체,광주광역시,북구,광주광역시 북구,508,508,0,508,28,344,136,0
자치단체,광주광역시,광주광역시북구시설관리공단,광주광역시 북구 광주광역시북구시설관리공단,387,377,10,377,0,377,0,0
자치단체,광주광역시,서구,광주광역시 서구,714,714,0,714,103,488,123,0
자치단체,대전광역시,대전광역시,대전광역시,934,854,80,854,42,586,70,156
자치단체,대전광역시,건설관리본부,대전광역시 건설관리본부,100,100,0,100,11,89,0,0
자치단체,대전광역시,공원관리사업소,대전광역시 공원관리사업소,57,57,0,57,13,44,0,0
자치단체,대전광역시,노은농수산물도매시장관리사무소,대전광역시 노은농수산물도매시장관리사무소,125,125,0,125,0,125,0,0
자치단체,대전광역시,농업기술센터,대전광역시 농업기술센터,32,32,0,32,0,32,0,0
자치단체,대전광역시,대덕구,대전광역시 대덕구,1441,1433,8,1433,1124,203,106,0
자치단체,대전광역시,대덕소방서,대전광역시 대덕소방서,19,19,0,19,0,19,0,0
자치단체,대전광역시,대전광역시시설관리공단,대전광역시 대전광역시시설관리공단,661,506,155,506,0,506,0,0
자치단체,대전광역시,대전교통공사,대전광역시 대전교통공사,1420,1144,276,1144,0,1144,0,0
자치단체,대전광역시,대전도시공사,대전광역시 대전도시공사,1723,1708,15,1708,1465,243,0,0
자치단체,대전광역시,대전동물보호사업소,대전광역시 대전동물보호사업소,87,87,0,87,0,87,0,0
자치단체,대전광역시,대전마케팅공사,대전광역시 대전마케팅공사,485,485,0,485,56,429,0,0
자치단체,대전광역시,대전시립박물관,대전광역시 대전시립박물관,86,67,19,67,0,67,0,0
자치단체,대전광역시,대전시립연정국악원,대전광역시 대전시립연정국악원,55,55,0,55,0,55,0,0
자치단체,대전광역시,대전예술의전당,대전광역시 대전예술의전당,76,76,0,76,0,76,0,0
자치단체,대전광역시,동구,대전광역시 동구,1504,1504,0,1504,1278,148,78,0
자치단체,대전광역시,동부소방서,대전광역시 동부소방서,32,32,0,32,0,32,0,0
자치단체,대전광역시,둔산소방서,대전광역시 둔산소방서,35,35,0,35,0,35,0,0
자치단체,대전광역시,보건환경연구원,대전광역시 보건환경연구원,16,11,5,11,0,11,0,0
자치단체,대전광역시,상수도사업본부,대전광역시 상수도사업본부,335,25,310,25,0,25,0,0
자치단체,대전광역시,서구,대전광역시 서구,2677,2567,110,2567,1855,571,0,141
자치단체,대전광역시,서부소방서,대전광역시 서부소방서,32,32,0,32,0,32,0,0
자치단체,대전광역시,소방본부,대전광역시 소방본부,0,0,0,0,0,0,0,0
자치단체,대전광역시,시립미술관,대전광역시 시립미술관,70,70,0,70,0,70,0,0
자치단체,대전광역시,여성가족원,대전광역시 여성가족원,98,98,0,98,0,98,0,0
자치단체,대전광역시,오정농수산물도매시장관리사업소,대전광역시 오정농수산물도매시장관리사업소,125,125,0,125,0,125,0,0
자치단체,대전광역시,유성구,대전광역시 유성구,1816,1790,26,1790,1239,431,120,0
자치단체,대전광역시,유성소방서,대전광역시 유성소방서,20,20,0,20,0,20,0,0
자치단체,대전광역시,인재개발원,대전광역시 인재개발원,19,19,0,19,0,19,0,0
자치단체,대전광역시,중구,대전광역시 중구,1719,1706,13,1706,1414,233,59,0
자치단체,대전광역시,태평2동,대전광역시 중구 태평2동,7,7,0,7,0,7,0,0
자치단체,대전광역시,차량등록사업소,대전광역시 차량등록사업소,17,17,0,17,0,17,0,0
자치단체,대전광역시,한밭도서관,대전광역시 한밭도서관,56,56,0,56,0,56,0,0
자치단체,대전광역시,한밭수목원,대전광역시 한밭수목원,125,110,15,110,15,95,0,0
자치단체,울산광역시,울산광역시,울산광역시,2163,1697,466,1697,4,1477,18,198
자치단체,울산광역시,남구,울산광역시 남구,2546,2531,15,2531,1957,46,517,11
자치단체,울산광역시,동구,울산광역시 동구,1644,1644,0,1644,1390,148,95,11
자치단체,울산광역시,북구,울산광역시 북구,2192,2186,6,2186,1653,198,310,25
자치단체,울산광역시,울산광역시북구시설관리공단,울산광역시 북구 울산광역시북구시설관리공단,230,225,5,225,65,160,0,0
자치단체,울산광역시,울산광역시도시공사,울산광역시 울산광역시도시공사,375,375,0,375,359,16,0,0
자치단체,울산광역시,울산시설공단,울산광역시 울산시설공단,1103,1043,60,1043,0,1043,0,0
자치단체,울산광역시,울산신용보증재단,울산광역시 울산신용보증재단,21,21,0,21,21,0,0,0
자치단체,울산광역시,울주군,울산광역시 울주군,2060,2060,0,2060,1726,156,178,0
자치단체,울산광역시,재단법인울산문화재단,울산광역시 재단법인울산문화재단,7,7,0,7,0,7,0,0
자치단체,울산광역시,재단법인울산정보산업진흥원,울산광역시 재단법인울산정보산업진흥원,91,81,10,81,81,0,0,0
자치단체,울산광역시,중구,울산광역시 중구,2239,2198,41,2198,1724,404,70,0
자치단체,울산광역시,울산중구도시관리공단,울산광역시 중구 울산중구도시관리공단,385,385,0,385,15,206,0,164
자치단체,세종특별자치시,세종특별자치시,세종특별자치시,3426,3202,224,3202,2811,146,190,55
자치단체,경기도,경기도,경기도,3661,3333,328,3333,827,2404,0,102
자치단체,경기도,가평군,경기도 가평군,2071,1977,94,1977,1219,735,23,0
자치단체,경기도,가평군시설관리공단,경기도 가평군 가평군시설관리공단,288,288,0,288,0,288,0,0
자치단체,경기도,경기관광공사,경기도 경기관광공사,301,301,0,301,0,301,0,0
자치단체,경기도,경기교통공사,경기도 경기교통공사,16,15,1,15,0,15,0,0
자치단체,경기도,경기도의료원,경기도 경기도의료원,911,911,0,911,17,894,0,0
자치단체,경기도,경기주택도시공사,경기도 경기주택도시공사,151,151,0,151,59,92,0,0
자치단체,경기도,경기평택항만공사,경기도 경기평택항만공사,332,321,11,321,120,201,0,0
자치단체,경기도,고양시,경기도 고양시,12953,12522,431,12522,7583,2989,1728,222
자치단체,경기도,고양도시관리공사,경기도 고양시 고양도시관리공사,1095,988,107,988,0,988,0,0
자치단체,경기도,고양문화재단,경기도 고양시 고양문화재단,226,220,6,220,59,161,0,0
자치단체,경기도,과천시,경기도 과천시,1507,1387,120,1387,931,356,42,58
자치단체,경기도,과천도시공사,경기도 과천시 과천도시공사,314,290,24,290,0,290,0,0
자치단체,경기도,재단법인과천문화재단,경기도 과천시 재단법인과천문화재단,0,0,0,0,0,0,0,0
자치단체,경기도,광명시,경기도 광명시,5003,4760,243,4760,2998,1602,89,71
자치단체,경기도,광주시,경기도 광주시,5132,5116,16,5116,3852,1063,117,84
자치단체,경기도,광주도시관리공사,경기도 광주시 광주도시관리공사,702,602,100,602,0,602,0,0
자치단체,경기도,구리시,경기도 구리시,3279,3275,4,3275,2183,909,127,56
자치단체,경기도,구리농수산물공사,경기도 구리시 구리농수산물공사,313,313,0,313,0,274,0,39
자치단체,경기도,구리도시공사,경기도 구리시 구리도시공사,405,405,0,405,0,405,0,0
자치단체,경기도,재단법인 구리시청소년재단,경기도 구리시 재단법인 구리시청소년재단,61,59,2,59,0,59,0,0
자치단체,경기도,재단법인구리문화재단,경기도 구리시 재단법인구리문화재단,66,63,3,63,0,63,0,0
자치단체,경기도,군포시,경기도 군포시,4529,4364,165,4364,3321,905,73,65
자치단체,경기도,군포도시공사,경기도 군포시 군포도시공사,920,920,0,920,0,920,0,0
자치단체,경기도,군포문화재단,경기도 군포시 군포문화재단,173,173,0,173,0,173,0,0
자치단체,경기도,재단법인군포시청소년재단,경기도 군포시 재단법인군포시청소년재단,149,149,0,149,5,144,0,0
자치단체,경기도,김포시,경기도 김포시,8579,7586,993,7586,5265,902,1257,162
자치단체,경기도,김포도시관리공사,경기도 김포시 김포도시관리공사,1334,1262,72,1262,0,1262,0,0
자치단체,경기도,재단법인김포시청소년재단,경기도 김포시 재단법인김포시청소년재단,166,166,0,166,0,166,0,0
자치단체,경기도,남양주시,경기도 남양주시,6871,6863,8,6863,5655,969,238,1
자치단체,경기도,남양주도시공사,경기도 남양주시 남양주도시공사,1437,1377,60,1377,0,1377,0,0
자치단체,경기도,동두천시,경기도 동두천시,3433,3377,56,3377,2527,782,42,26
자치단체,경기도,부천시,경기도 부천시,11605,11554,51,11554,8279,2480,682,113
자치단체,경기도,성남시,경기도 성남시,12655,12357,298,12357,10169,1839,277,72
자치단체,경기도,성남도시개발공사,경기도 성남시 성남도시개발공사,3900,3900,0,3900,0,3900,0,0
자치단체,경기도,수원시,경기도 수원시,17368,17275,93,17275,13443,3285,437,110
자치단체,경기도,수원도시공사,경기도 수원시 수원도시공사,2096,2065,31,2065,2,2063,0,0
자치단체,경기도,재단법인수원문화재단,경기도 수원시 재단법인수원문화재단,343,240,103,240,240,0,0,0
자치단체,경기도,재단법인수원컨벤션센터,경기도 수원시 재단법인수원컨벤션센터,184,171,13,171,23,148,0,0
자치단체,경기도,시흥시,경기도 시흥시,7792,7716,76,7716,6043,1248,146,279
자치단체,경기도,시흥도시공사,경기도 시흥시 시흥도시공사,1715,1633,82,1633,0,1633,0,0
자치단체,경기도,안산시,경기도 안산시,10978,10841,137,10841,8077,1807,776,181
자치단체,경기도,안산도시공사,경기도 안산시 안산도시공사,1833,1712,121,1712,0,1712,0,0
자치단체,경기도,안성시,경기도 안성시,4909,4883,26,4883,3807,966,110,0
자치단체,경기도,안성시시설관리공단,경기도 안성시 안성시시설관리공단,118,118,0,118,0,118,0,0
자치단체,경기도,안양시,경기도 안양시,8757,8527,230,8527,5870,1574,1006,77
자치단체,경기도,안양도시공사,경기도 안양시 안양도시공사,1172,1171,1,1171,0,1171,0,0
자치단체,경기도,양주시,경기도 양주시,6325,6325,0,6325,4336,1587,205,197
자치단체,경기도,양주도시공사,경기도 양주시 양주도시공사,568,568,0,568,0,568,0,0
자치단체,경기도,양평공사,경기도 양평군 양평공사,342,226,116,226,0,226,0,0
자치단체,경기도,여주시,경기도 여주시,3380,3380,0,3380,2273,940,167,0
자치단체,경기도,여주도시관리공단,경기도 여주시 여주도시관리공단,294,294,0,294,0,294,0,0
자치단체,경기도,연천군,경기도 연천군,1920,1616,304,1616,856,590,119,51
자치단체,경기도,연천군시설관리공단,경기도 연천군 연천군시설관리공단,199,199,0,199,49,150,0,0
자치단체,경기도,오산시,경기도 오산시,3379,3269,110,3269,2379,748,142,0
자치단체,경기도,(재)오산문화재단,경기도 오산시 (재)오산문화재단,72,72,0,72,0,72,0,0
자치단체,경기도,재단법인오산교육재단,경기도 오산시 재단법인오산교육재단,1,1,0,1,0,1,0,0
자치단체,경기도,용인시,경기도 용인시,13964,13841,123,13841,10190,3149,415,87
자치단체,경기도,용인도시공사,경기도 용인시 용인도시공사,1329,1317,12,1317,0,1317,0,0
자치단체,경기도,용인문화재단,경기도 용인시 용인문화재단,169,169,0,169,0,169,0,0
자치단체,경기도,용인시산업진흥원,경기도 용인시 용인시산업진흥원,55,55,0,55,4,51,0,0
자치단체,경기도,재단법인용인시청소년미래재단,경기도 용인시 재단법인용인시청소년미래재단,105,105,0,105,0,105,0,0
자치단체,경기도,의왕시,경기도 의왕시,3911,3817,94,3817,2550,854,90,323
자치단체,경기도,의왕도시공사,경기도 의왕시 의왕도시공사,567,567,0,567,22,545,0,0
자치단체,경기도,의정부시,경기도 의정부시,5884,5803,81,5803,4155,877,709,62
자치단체,경기도,의정부시시설관리공단,경기도 의정부시 의정부시시설관리공단,909,901,8,901,106,795,0,0
자치단체,경기도,이천시,경기도 이천시,5013,5013,0,5013,3405,1292,313,3
자치단체,경기도,이천시시설관리공단,경기도 이천시 이천시시설관리공단,341,341,0,341,0,341,0,0
자치단체,경기도,재단법인경기도일자리재단 ,경기도 재단법인경기도일자리재단 ,78,78,0,78,0,78,0,0
자치단체,경기도,파주시,경기도 파주시,6106,6106,0,6106,4119,1395,486,106
자치단체,경기도,파주도시관광공사,경기도 파주시 파주도시관광공사,964,964,0,964,0,964,0,0
자치단체,경기도,평택시,경기도 평택시,11125,11077,48,11077,8241,1383,1396,57
자치단체,경기도,평택도시공사,경기도 평택시 평택도시공사,520,520,0,520,0,520,0,0
자치단체,경기도,포천시,경기도 포천시,2387,2387,0,2387,1780,309,215,83
자치단체,경기도,포천도시공사,경기도 포천시 포천도시공사,231,226,5,226,0,226,0,0
자치단체,경기도,하남시,경기도 하남시,4013,3920,93,3920,3098,570,200,52
자치단체,경기도,하남도시공사,경기도 하남시 하남도시공사,297,294,3,294,215,79,0,0
자치단체,경기도,화성시,경기도 화성시,14292,13971,321,13971,11327,1514,371,759
자치단체,경기도,재단법인화성시사회복지재단,경기도 화성시 재단법인화성시사회복지재단,0,0,0,0,0,0,0,0
자치단체,경기도,재단법인화성시여성가족청소년재단,경기도 화성시 재단법인화성시여성가족청소년재단,301,301,0,301,0,301,0,0
자치단체,경기도,재단법인화성푸드통합지원센터,경기도 화성시 재단법인화성푸드통합지원센터,137,137,0,137,0,137,0,0
자치단체,경기도,화성도시공사,경기도 화성시 화성도시공사,1998,1998,0,1998,0,1998,0,0
자치단체,경기도,화성산업진흥원,경기도 화성시 화성산업진흥원,0,0,0,0,0,0,0,0
자치단체,경기도,화성시문화재단,경기도 화성시 화성시문화재단,598,598,0,598,0,598,0,0
자치단체,경기도,화성시인재육성재단,경기도 화성시 화성시인재육성재단,396,396,0,396,24,372,0,0
자치단체,강원도,강원도,강원도,1860,1777,83,1777,31,1745,0,1
자치단체,강원도,강릉시,강원도 강릉시,3305,3117,188,3117,1598,855,101,563
자치단체,강원도,강원도삼척의료원,강원도 강원도삼척의료원,81,81,0,81,0,81,0,0
자치단체,강원도,강원도영월의료원,강원도 강원도영월의료원,66,66,0,66,0,66,0,0
자치단체,강원도,강원도원주의료원,강원도 강원도원주의료원,206,195,11,195,120,72,2,1
자치단체,강원도,고성군,강원도 고성군,496,496,0,496,436,56,4,0
자치단체,강원도,동해시,강원도 동해시,1665,1665,0,1665,1055,593,17,0
자치단체,강원도,동해시시설관리공단,강원도 동해시 동해시시설관리공단,115,115,0,115,0,115,0,0
자치단체,강원도,삼척시,강원도 삼척시,2483,2340,143,2340,945,1371,24,0
자치단체,강원도,속초시,강원도 속초시,1270,1175,95,1175,757,373,45,0
자치단체,강원도,양구군,강원도 양구군,2035,2018,17,2018,976,1013,29,0
자치단체,강원도,양양군,강원도 양양군,1324,1320,4,1320,609,697,14,0
자치단체,강원도,영월군,강원도 영월군,814,814,0,814,647,107,60,0
자치단체,강원도,영월군시설관리공단,강원도 영월군 영월군시설관리공단,350,350,0,350,48,302,0,0
자치단체,강원도,원주시,강원도 원주시,5063,4681,382,4681,279,3863,150,389
자치단체,강원도,원주시시설관리공단,강원도 원주시 원주시시설관리공단,486,479,7,479,0,479,0,0
자치단체,강원도,인제군,강원도 인제군,841,810,31,810,623,186,1,0
자치단체,강원도,정선군,강원도 정선군,1667,1490,177,1490,729,743,18,0
자치단체,강원도,정선군시설관리공단,강원도 정선군 정선군시설관리공단,328,328,0,328,21,301,6,0
자치단체,강원도,철원군,강원도 철원군,1461,1456,5,1456,592,811,53,0
자치단체,강원도,춘천시,강원도 춘천시,3770,3521,249,3521,2327,1079,115,0
자치단체,강원도,태백시,강원도 태백시,2147,2112,35,2112,1350,748,14,0
자치단체,강원도,평창군,강원도 평창군,1343,1327,16,1327,530,778,19,0
자치단체,강원도,평창군시설관리공단,강원도 평창군 평창군시설관리공단,143,143,0,143,0,143,0,0
자치단체,강원도,홍천군,강원도 홍천군,2011,1923,88,1923,910,1006,7,0
자치단체,강원도,화천군,강원도 화천군,1194,1095,99,1095,328,749,10,8
자치단체,강원도,횡성군,강원도 횡성군,858,853,5,853,668,168,17,0
자치단체,충청북도,충청북도,충청북도,921,878,43,878,69,777,0,32
자치단체,충청북도,괴산군,충청북도 괴산군,1880,1796,84,1796,1055,685,56,0
자치단체,충청북도,괴산소방서,충청북도 괴산소방서,22,22,0,22,7,15,0,0
자치단체,충청북도,단양관광공사,충청북도 단양관광공사,298,298,0,298,0,298,0,0
자치단체,충청북도,단양군,충청북도 단양군,759,759,0,759,542,156,51,10
자치단체,충청북도,단양소방서,충청북도 단양소방서,30,30,0,30,6,24,0,0
자치단체,충청북도,보은군,충청북도 보은군,1398,1345,53,1345,795,522,28,0
자치단체,충청북도,보은소방서,충청북도 보은소방서,32,32,0,32,5,27,0,0
자치단체,충청북도,영동군,충청북도 영동군,840,840,0,840,680,135,25,0
자치단체,충청북도,영동소방서,충청북도 영동소방서,22,15,7,15,0,15,0,0
자치단체,충청북도,옥천군,충청북도 옥천군,621,621,0,621,590,19,12,0
자치단체,충청북도,옥천소방서,충청북도 옥천소방서,27,21,6,21,0,21,0,0
자치단체,충청북도,음성군,충청북도 음성군,2656,2640,16,2640,1406,1105,68,61
자치단체,충청북도,음성소방서,충청북도 음성소방서,27,27,0,27,0,27,0,0
자치단체,충청북도,제천소방서,충청북도 제천소방서,28,28,0,28,7,21,0,0
자치단체,충청북도,제천시,충청북도 제천시,3115,3115,0,3115,2954,70,91,0
자치단체,충청북도,증평군,충청북도 증평군,950,950,0,950,659,186,17,88
자치단체,충청북도,증평소방서,충청북도 증평소방서,10,10,0,10,1,9,0,0
자치단체,충청북도,진천군,충청북도 진천군,1518,1518,0,1518,1279,64,175,0
자치단체,충청북도,진천소방서,충청북도 진천소방서,58,58,0,58,7,51,0,0
자치단체,충청북도,청주동부소방서,충청북도 청주동부소방서,61,61,0,61,0,61,0,0
자치단체,충청북도,청주서부소방서,충청북도 청주서부소방서,22,22,0,22,0,22,0,0
자치단체,충청북도,청주시,충청북도 청주시,8926,8492,434,8492,5656,1593,953,290
자치단체,충청북도,청주시시설관리공단,충청북도 청주시 청주시시설관리공단,571,532,39,532,4,528,0,0
자치단체,충청북도,충북도립대학,충청북도 충북도립대학,101,98,3,98,98,0,0,0
자치단체,충청북도,충주소방서,충청북도 충주소방서,57,57,0,57,12,45,0,0
자치단체,충청북도,충주시,충청북도 충주시,4253,4027,226,4027,2374,1330,251,72
자치단체,충청북도,충주시시설관리공단,충청북도 충주시 충주시시설관리공단,472,396,76,396,0,396,0,0
자치단체,충청북도,충청북도청주의료원 ,충청북도 충청북도청주의료원 ,271,175,96,175,97,17,52,9
자치단체,충청북도,충청북도충주의료원,충청북도 충청북도충주의료원,285,173,112,173,9,164,0,0
자치단체,충청남도,충청남도,충청남도,296,291,5,291,0,291,0,0
자치단체,충청남도,계룡소방서,충청남도 계룡소방서,22,22,0,22,0,22,0,0
자치단체,충청남도,계룡시,충청남도 계룡시,1080,1080,0,1080,493,520,0,67
자치단체,충청남도,공주시,충청남도 공주시,1486,1486,0,1486,1201,160,125,0
자치단체,충청남도,금산군,충청남도 금산군,1374,1374,0,1374,1374,0,0,0
자치단체,충청남도,논산시,충청남도 논산시,2072,2072,0,2072,2010,23,39,0
자치단체,충청남도,농업기술원,충청남도 농업기술원,62,62,0,62,0,62,0,0
자치단체,충청남도,당진시,충청남도 당진시,3354,3290,64,3290,1468,1526,295,1
자치단체,충청남도,보령시,충청남도 보령시,2644,2644,0,2644,2122,522,0,0
자치단체,충청남도,보령시시설관리공단,충청남도 보령시 보령시시설관리공단,218,167,51,167,29,138,0,0
자치단체,충청남도,부여군,충청남도 부여군,1962,1962,0,1962,1087,852,23,0
자치단체,충청남도,부여군시설관리공단 ,충청남도 부여군 부여군시설관리공단 ,183,183,0,183,0,183,0,0
자치단체,충청남도,산림자원연구소,충청남도 산림자원연구소,128,128,0,128,0,128,0,0
자치단체,충청남도,서산시,충청남도 서산시,2947,2947,0,2947,2557,58,269,63
자치단체,충청남도,서천군,충청남도 서천군,1856,1856,0,1856,995,834,27,0
자치단체,충청남도,서천소방서,충청남도 서천소방서,8,8,0,8,0,8,0,0
자치단체,충청남도,수산자원연구소,충청남도 수산자원연구소,60,60,0,60,0,60,0,0
자치단체,충청남도,아산시,충청남도 아산시,5238,5238,0,5238,3080,1902,195,61
자치단체,충청남도,아산시시설관리공단,충청남도 아산시 아산시시설관리공단,953,922,31,922,84,710,0,128
자치단체,충청남도,예산군,충청남도 예산군,2025,2025,0,2025,1458,554,13,0
자치단체,충청남도,인재개발원,충청남도 인재개발원,16,16,0,16,0,16,0,0
자치단체,충청남도,천안서북소방서,충청남도 천안서북소방서,16,16,0,16,0,16,0,0
자치단체,충청남도,천안시,충청남도 천안시,9686,9537,149,9537,6254,2456,735,92
자치단체,충청남도,재단법인천안과학산업진흥원,충청남도 천안시 재단법인천안과학산업진흥원,57,54,3,54,0,54,0,0
자치단체,충청남도,천안시시설관리공단,충청남도 천안시 천안시시설관리공단,804,775,29,775,0,775,0,0
자치단체,충청남도,청양군,충청남도 청양군,2194,2156,38,2156,1467,668,21,0
자치단체,충청남도,청양소방서,충청남도 청양소방서,7,7,0,7,0,7,0,0
자치단체,충청남도,축산기술연구소,충청남도 축산기술연구소,24,24,0,24,0,24,0,0
자치단체,충청남도,충남도립대학교,충청남도 충남도립대학교,124,124,0,124,63,61,0,0
자치단체,충청남도,충남도서관,충청남도 충남도서관,80,69,11,69,48,7,0,14
자치단체,충청남도,충청남도공주의료원,충청남도 충청남도공주의료원,145,145,0,145,0,127,18,0
자치단체,충청남도,충청남도서산의료원,충청남도 충청남도서산의료원,188,180,8,180,0,180,0,0
자치단체,충청남도,충청남도천안의료원,충청남도 충청남도천안의료원,192,176,16,176,150,26,0,0
자치단체,충청남도,충청소방학교,충청남도 충청소방학교,75,75,0,75,18,57,0,0
자치단체,충청남도,태안군,충청남도 태안군,1510,1510,0,1510,1130,163,85,132
자치단체,충청남도,홍성군,충청남도 홍성군,2893,2888,5,2888,1631,1208,49,0
자치단체,전라북도,전라북도,전라북도,187,179,8,179,2,177,0,0
자치단체,전라북도,고창군,전라북도 고창군,1276,1247,29,1247,954,249,44,0
자치단체,전라북도,고창소방서,전라북도 고창소방서,10,10,0,10,6,4,0,0
자치단체,전라북도,군산소방서,전라북도 군산소방서,27,27,0,27,14,13,0,0
자치단체,전라북도,군산시,전라북도 군산시,3481,3337,144,3337,2328,836,0,173
자치단체,전라북도,김제소방서,전라북도 김제소방서,21,21,0,21,6,15,0,0
자치단체,전라북도,김제시,전라북도 김제시,1440,1440,0,1440,960,452,28,0
자치단체,전라북도,남원소방서,전라북도 남원소방서,55,55,0,55,50,5,0,0
자치단체,전라북도,남원시,전라북도 남원시,3804,3804,0,3804,2973,695,40,96
자치단체,전라북도,농업기술원,전라북도 농업기술원,25,25,0,25,0,25,0,0
자치단체,전라북도,도로관리사업소,전라북도 도로관리사업소,114,114,0,114,0,108,6,0
자치단체,전라북도,도립미술관,전라북도 도립미술관,71,71,0,71,0,71,0,0
자치단체,전라북도,동물위생시험소,전라북도 동물위생시험소,22,22,0,22,0,22,0,0
자치단체,전라북도,무주군,전라북도 무주군,1091,1091,0,1091,780,311,0,0
자치단체,전라북도,보건환경연구원,전라북도 보건환경연구원,13,13,0,13,0,13,0,0
자치단체,전라북도,부안군,전라북도 부안군,631,631,0,631,458,102,0,71
자치단체,전라북도,부안소방서,전라북도 부안소방서,4,4,0,4,0,4,0,0
자치단체,전라북도,산림환경연구소,전라북도 산림환경연구소,83,83,0,83,0,83,0,0
자치단체,전라북도,수산기술연구소,전라북도 수산기술연구소,26,26,0,26,0,26,0,0
자치단체,전라북도,순창군,전라북도 순창군,458,421,37,421,127,212,8,74
자치단체,전라북도,순창소방서,전라북도 순창소방서,15,15,0,15,5,10,0,0
자치단체,전라북도,어린이창의체험관,전라북도 어린이창의체험관,46,46,0,46,0,46,0,0
자치단체,전라북도,완주군,전라북도 완주군,2460,2407,53,2407,1222,1185,0,0
자치단체,전라북도,완주소방서,전라북도 완주소방서,26,26,0,26,0,26,0,0
자치단체,전라북도,익산소방서,전라북도 익산소방서,19,19,0,19,15,4,0,0
자치단체,전라북도,익산시,전라북도 익산시,4782,4627,155,4627,3017,1252,347,11
자치단체,전라북도,인재개발원,전라북도 인재개발원,44,44,0,44,0,44,0,0
자치단체,전라북도,임실군,전라북도 임실군,487,480,7,480,403,52,25,0
자치단체,전라북도,장수군,전라북도 장수군,1599,1599,0,1599,744,852,3,0
자치단체,전라북도,장수소방서,전라북도 장수소방서,4,4,0,4,0,4,0,0
자치단체,전라북도,전라북도군산의료원,전라북도 전라북도군산의료원,171,171,0,171,0,171,0,0
자치단체,전라북도,전라북도립여성중고등학교,전라북도 전라북도립여성중고등학교,16,16,0,16,0,16,0,0
자치단체,전라북도,전북개발공사,전라북도 전북개발공사,42,42,0,42,0,42,0,0
자치단체,전라북도,전주덕진소방서,전라북도 전주덕진소방서,10,10,0,10,6,4,0,0
자치단체,전라북도,전주시,전라북도 전주시,5035,5035,0,5035,4027,358,403,247
자치단체,전라북도,전주시시설관리공단,전라북도 전주시 전주시시설관리공단,1003,1003,0,1003,159,816,0,28
자치단체,전라북도,전주완산소방서,전라북도 전주완산소방서,21,21,0,21,11,10,0,0
자치단체,전라북도,정읍소방서,전라북도 정읍소방서,47,47,0,47,42,5,0,0
자치단체,전라북도,정읍시,전라북도 정읍시,1127,1087,40,1087,889,166,21,11
자치단체,전라북도,진안군,전라북도 진안군,1702,1663,39,1663,1385,271,7,0
자치단체,전라북도,진안군의료원,전라북도 진안군 진안군의료원,68,68,0,68,11,57,0,0
자치단체,전라북도,진안소방서,전라북도 진안소방서,11,11,0,11,4,7,0,0
자치단체,전라북도,축산연구소,전라북도 축산연구소,2,2,0,2,0,2,0,0
자치단체,전라남도,전라남도,전라남도,130,130,0,130,0,130,0,0
자치단체,전라남도,강진군,전라남도 강진군,1154,1102,52,1102,666,421,5,10
자치단체,전라남도,강진소방서,전라남도 강진소방서,17,17,0,17,0,17,0,0
자치단체,전라남도,고흥군,전라남도 고흥군,2260,2260,0,2260,1704,495,61,0
자치단체,전라남도,고흥소방서,전라남도 고흥소방서,20,20,0,20,5,15,0,0
자치단체,전라남도,곡성군,전라남도 곡성군,2063,1878,185,1878,1568,310,0,0
자치단체,전라남도,광양만권경제자유구역청,전라남도 광양만권경제자유구역청,17,13,4,13,4,9,0,0
자치단체,전라남도,광양시,전라남도 광양시,1988,1826,162,1826,1028,545,44,209
자치단체,전라남도,구례군,전라남도 구례군,1409,1397,12,1397,681,671,16,29
자치단체,전라남도,나주소방서,전라남도 나주소방서,2,2,0,2,0,2,0,0
자치단체,전라남도,나주시,전라남도 나주시,2876,2755,121,2755,2376,178,77,124
자치단체,전라남도,농업기술원,전라남도 농업기술원,117,93,24,93,1,92,0,0
자치단체,전라남도,농업박물관,전라남도 농업박물관,81,81,0,81,0,81,0,0
자치단체,전라남도,담양군,전라남도 담양군,1147,1147,0,1147,542,459,43,103
자치단체,전라남도,도로관리사업소,전라남도 도로관리사업소,162,18,144,18,0,18,0,0
자치단체,전라남도,동물위생시험소,전라남도 동물위생시험소,15,15,0,15,4,11,0,0
자치단체,전라남도,동부지역본부,전라남도 동부지역본부,7,7,0,7,0,7,0,0
자치단체,전라남도,목포소방서,전라남도 목포소방서,1,1,0,1,0,1,0,0
자치단체,전라남도,목포시,전라남도 목포시,3380,3276,104,3276,2397,753,81,45
자치단체,전라남도,목포시의료원,전라남도 목포시 목포시의료원,84,72,12,72,0,72,0,0
자치단체,전라남도,무안군,전라남도 무안군,1724,1724,0,1724,1016,708,0,0
자치단체,전라남도,보건환경연구원,전라남도 보건환경연구원,15,15,0,15,0,15,0,0
자치단체,전라남도,보성소방서,전라남도 보성소방서,15,15,0,15,15,0,0,0
자치단체,전라남도,소방본부,전라남도 소방본부,15,8,7,8,0,8,0,0
자치단체,전라남도,순천소방서,전라남도 순천소방서,9,9,0,9,0,9,0,0
자치단체,전라남도,순천시,전라남도 순천시,4275,4275,0,4275,3077,899,202,97
자치단체,전라남도,신안군,전라남도 신안군,702,702,0,702,643,59,0,0
자치단체,전라남도,신안소방서,전라남도 신안소방서,10,10,0,10,0,10,0,0
자치단체,전라남도,여수시,전라남도 여수시,2138,2138,0,2138,1741,215,151,31
자치단체,전라남도,여수시도시관리공단,전라남도 여수시 여수시도시관리공단,803,781,22,781,0,781,0,0
자치단체,전라남도,영광군,전라남도 영광군,1801,1801,0,1801,1079,596,61,65
자치단체,전라남도,영광소방서,전라남도 영광소방서,8,8,0,8,0,8,0,0
자치단체,전라남도,영암군,전라남도 영암군,1686,1686,0,1686,1362,52,88,184
자치단체,전라남도,완도군,전라남도 완도군,855,855,0,855,719,124,0,12
자치단체,전라남도,인재개발원,전라남도 인재개발원,105,98,7,98,0,98,0,0
자치단체,전라남도,장성군,전라남도 장성군,1680,1670,10,1670,973,635,37,25
자치단체,전라남도,장성소방서,전라남도 장성소방서,12,11,1,11,0,11,0,0
자치단체,전라남도,장흥군,전라남도 장흥군,1861,1861,0,1861,969,838,54,0
자치단체,전라남도,장흥소방서,전라남도 장흥소방서,9,9,0,9,0,9,0,0
자치단체,전라남도,전남개발공사,전라남도 전남개발공사,31,31,0,31,31,0,0,0
자치단체,전라남도,전남도립대학,전라남도 전남도립대학,172,172,0,172,0,172,0,0
자치단체,전라남도,전남도립미술관,전라남도 전남도립미술관,103,93,10,93,0,93,0,0
자치단체,전라남도,전라남도강진의료원,전라남도 전라남도강진의료원,120,120,0,120,60,60,0,0
자치단체,전라남도,전라남도립도서관,전라남도 전라남도립도서관,47,47,0,47,0,47,0,0
자치단체,전라남도,전라남도순천의료원,전라남도 전라남도순천의료원,197,126,71,126,76,48,2,0
자치단체,전라남도,종자관리소,전라남도 종자관리소,10,10,0,10,0,10,0,0
자치단체,전라남도,진도군,전라남도 진도군,1704,1691,13,1691,833,837,21,0
자치단체,전라남도,진도소방서,전라남도 진도소방서,10,10,0,10,0,10,0,0
자치단체,전라남도,함평군,전라남도 함평군,813,813,0,813,619,169,25,0
자치단체,전라남도,해남군,전라남도 해남군,1754,1754,0,1754,1623,87,44,0
자치단체,전라남도,해남소방서,전라남도 해남소방서,4,4,0,4,4,0,0,0
자치단체,전라남도,해양수산과학원,전라남도 해양수산과학원,256,256,0,256,0,256,0,0
자치단체,전라남도,화순군,전라남도 화순군,2598,2423,175,2423,1692,690,21,20
자치단체,전라남도,화순소방서,전라남도 화순소방서,17,17,0,17,0,17,0,0
자치단체,경상북도,경상북도,경상북도,440,392,48,392,95,289,0,8
자치단체,경상북도,119특수대응단,경상북도 119특수대응단,14,14,0,14,0,14,0,0
자치단체,경상북도,경북도립대학교,경상북도 경북도립대학교,71,71,0,71,0,71,0,0
자치단체,경상북도,경북도서관,경상북도 경북도서관,77,60,17,60,0,60,0,0
자치단체,경상북도,경산소방서,경상북도 경산소방서,11,11,0,11,0,11,0,0
자치단체,경상북도,경산시,경상북도 경산시,4341,4174,167,4174,2641,1424,64,45
자치단체,경상북도,경상북도개발공사,경상북도 경상북도개발공사,333,333,0,333,9,324,0,0
자치단체,경상북도,경상북도김천의료원,경상북도 경상북도김천의료원,242,223,19,223,20,181,22,0
자치단체,경상북도,경상북도문화관광공사,경상북도 경상북도문화관광공사,238,238,0,238,0,236,0,2
자치단체,경상북도,경상북도민물고기연구센터,경상북도 경상북도민물고기연구센터,53,53,0,53,0,53,0,0
자치단체,경상북도,경상북도포항의료원,경상북도 경상북도포항의료원,173,114,59,114,0,86,0,28
자치단체,경상북도,경주소방서,경상북도 경주소방서,71,71,0,71,0,71,0,0
자치단체,경상북도,경주시,경상북도 경주시,4906,4808,98,4808,2646,1714,370,78
자치단체,경상북도,경주시시설관리공단,경상북도 경주시 경주시시설관리공단,523,523,0,523,169,354,0,0
자치단체,경상북도,고령군,경상북도 고령군,1243,1243,0,1243,787,442,14,0
자치단체,경상북도,고령소방서,경상북도 고령소방서,26,26,0,26,0,26,0,0
자치단체,경상북도,구미소방서,경상북도 구미소방서,40,40,0,40,0,40,0,0
자치단체,경상북도,구미시,경상북도 구미시,4299,4257,42,4257,3336,731,108,82
자치단체,경상북도,구미시설공단,경상북도 구미시 구미시설공단,702,666,36,666,55,611,0,0
자치단체,경상북도,군위군,경상북도 군위군,688,688,0,688,676,12,0,0
자치단체,경상북도,김천소방서,경상북도 김천소방서,41,41,0,41,0,41,0,0
자치단체,경상북도,김천시,경상북도 김천시,14,14,0,14,0,14,0,0
자치단체,경상북도,남부건설사업소,경상북도 남부건설사업소,141,141,0,141,0,141,0,0
자치단체,경상북도,농업자원관리원,경상북도 농업자원관리원,6,6,0,6,0,6,0,0
자치단체,경상북도,문경소방서,경상북도 문경소방서,21,21,0,21,0,21,0,0
자치단체,경상북도,문경시,경상북도 문경시,2275,2275,0,2275,1996,216,59,4
자치단체,경상북도,봉화군,경상북도 봉화군,980,980,0,980,898,81,1,0
자치단체,경상북도,봉화약용작물연구소,경상북도 봉화약용작물연구소,8,8,0,8,0,8,0,0
자치단체,경상북도,북부건설사업소,경상북도 북부건설사업소,23,23,0,23,0,10,0,13
자치단체,경상북도,산림자원개발원,경상북도 산림자원개발원,42,42,0,42,0,42,0,0
자치단체,경상북도,산림환경연구원,경상북도 산림환경연구원,18,18,0,18,0,18,0,0
자치단체,경상북도,사방기술교육센터,경상북도 산림환경연구원 사방기술교육센터,12,12,0,12,0,12,0,0
자치단체,경상북도,상주소방서,경상북도 상주소방서,38,38,0,38,0,38,0,0
자치단체,경상북도,상주시,경상북도 상주시,3327,3208,119,3208,2241,937,30,0
자치단체,경상북도,성주소방서,경상북도 성주소방서,16,16,0,16,0,16,0,0
자치단체,경상북도,소방본부,경상북도 소방본부,6,6,0,6,0,6,0,0
자치단체,경상북도,소방학교,경상북도 소방학교,8,8,0,8,0,8,0,0
자치단체,경상북도,수목원관리소,경상북도 수목원관리소,19,19,0,19,0,19,0,0
자치단체,경상북도,수산자원연구원,경상북도 수산자원연구원,9,9,0,9,0,9,0,0
자치단체,경상북도,안동소방서,경상북도 안동소방서,74,74,0,74,0,74,0,0
자치단체,경상북도,안동시,경상북도 안동시,4831,4831,0,4831,2784,1931,116,0
자치단체,경상북도,안동시시설관리공단,경상북도 안동시 안동시시설관리공단,464,439,25,439,319,120,0,0
자치단체,경상북도,어업기술센터,경상북도 어업기술센터,33,3,30,3,3,0,0,0
자치단체,경상북도,영덕군,경상북도 영덕군,1879,1879,0,1879,757,1113,3,6
자치단체,경상북도,영덕소방서,경상북도 영덕소방서,31,31,0,31,0,31,0,0
자치단체,경상북도,영양군,경상북도 영양군,1045,1045,0,1045,416,617,0,12
자치단체,경상북도,영양고추유통공사,경상북도 영양군 영양고추유통공사,23,23,0,23,0,23,0,0
자치단체,경상북도,영주소방서,경상북도 영주소방서,35,35,0,35,0,35,0,0
자치단체,경상북도,영주시,경상북도 영주시,1668,1668,0,1668,1619,49,0,0
자치단체,경상북도,영천소방서,경상북도 영천소방서,31,31,0,31,0,31,0,0
자치단체,경상북도,영천시,경상북도 영천시,1933,1933,0,1933,1563,336,34,0
자치단체,경상북도,영천시시설관리공단,경상북도 영천시 영천시시설관리공단,82,82,0,82,0,82,0,0
자치단체,경상북도,예천군,경상북도 예천군,1953,1953,0,1953,1437,489,27,0
자치단체,경상북도,예천소방서,경상북도 예천소방서,28,28,0,28,0,28,0,0
자치단체,경상북도,울릉군,경상북도 울릉군,685,641,44,641,276,359,6,0
자치단체,경상북도,울진군,경상북도 울진군,1404,1297,107,1297,742,528,27,0
자치단체,경상북도,울진군의료원,경상북도 울진군의료원,69,69,0,69,0,69,0,0
자치단체,경상북도,울진소방서,경상북도 울진소방서,54,54,0,54,50,4,0,0
자치단체,경상북도,의성군,경상북도 의성군,2554,2435,119,2435,1645,755,35,0
자치단체,경상북도,의성소방서,경상북도 의성소방서,43,43,0,43,0,43,0,0
자치단체,경상북도,인재개발원,경상북도 인재개발원,11,11,0,11,0,11,0,0
자치단체,경상북도,잠사곤충사업장,경상북도 잠사곤충사업장,45,40,5,40,0,40,0,0
자치단체,경상북도,재단법인문화엑스포,경상북도 재단법인문화엑스포,87,83,4,83,83,0,0,0
자치단체,경상북도,청도군,경상북도 청도군,1460,1456,4,1456,750,573,12,121
자치단체,경상북도,청도공영사업공사,경상북도 청도군 청도공영사업공사,106,8,98,8,0,8,0,0
자치단체,경상북도,청도복숭아연구소,경상북도 청도복숭아연구소,8,8,0,8,8,0,0,0
자치단체,경상북도,청도소방서,경상북도 청도소방서,17,17,0,17,17,0,0,0
자치단체,경상북도,청송소방서,경상북도 청송소방서,36,36,0,36,0,36,0,0
자치단체,경상북도,축산기술연구소,경상북도 축산기술연구소,26,4,22,4,2,2,0,0
자치단체,경상북도,칠곡군,경상북도 칠곡군,2466,2361,105,2361,1533,789,39,0
자치단체,경상북도,칠곡소방서,경상북도 칠곡소방서,36,36,0,36,0,36,0,0
자치단체,경상북도,토속어류산업화센터,경상북도 토속어류산업화센터,25,25,0,25,0,25,0,0
자치단체,경상북도,팔공산도립공원관리사무소,경상북도 팔공산도립공원관리사무소,25,25,0,25,0,25,0,0
자치단체,경상북도,포항남부소방서,경상북도 포항남부소방서,53,53,0,53,0,53,0,0
자치단체,경상북도,포항북부소방서,경상북도 포항북부소방서,54,54,0,54,0,54,0,0
자치단체,경상북도,포항시,경상북도 포항시,5105,4906,199,4906,3962,627,114,203
자치단체,경상북도,포항시시설관리공단,경상북도 포항시 포항시시설관리공단,627,627,0,627,0,627,0,0
자치단체,경상남도,경상남도,경상남도,381,347,34,347,0,347,0,0
자치단체,경상남도,(재)경남로봇랜드재단,경상남도 (재)경남로봇랜드재단,78,78,0,78,0,78,0,0
자치단체,경상남도,(재)경남테크노파크,경상남도 (재)경남테크노파크,27,27,0,27,14,13,0,0
자치단체,경상남도,(재)경상남도람사르환경재단,경상남도 (재)경상남도람사르환경재단,8,8,0,8,0,8,0,0
자치단체,경상남도,거제소방서,경상남도 거제소방서,12,12,0,12,9,3,0,0
자치단체,경상남도,거제시,경상남도 거제시,2721,2706,15,2706,1454,893,226,133
자치단체,경상남도,거제해양관광개발공사,경상남도 거제시 거제해양관광개발공사,642,553,89,553,0,553,0,0
자치단체,경상남도,거창군,경상남도 거창군,2227,2227,0,2227,2063,108,56,0
자치단체,경상남도,거창소방서,경상남도 거창소방서,30,30,0,30,6,24,0,0
자치단체,경상남도,경남개발공사,경상남도 경남개발공사,9,9,0,9,4,5,0,0
자치단체,경상남도,경남대표도서관,경상남도 경남대표도서관,82,75,7,75,16,59,0,0
자치단체,경상남도,경남도립거창대학,경상남도 경남도립거창대학,66,64,2,64,0,64,0,0
자치단체,경상남도,경남도립남해대학,경상남도 경남도립남해대학,42,42,0,42,0,42,0,0
자치단체,경상남도,경남신용보증재단,경상남도 경남신용보증재단,35,35,0,35,35,0,0,0
자치단체,경상남도,경남연구원,경상남도 경남연구원,34,34,0,34,1,33,0,0
자치단체,경상남도,경상남도기록원,경상남도 경상남도기록원,34,16,18,16,10,6,0,0
자치단체,경상남도,경상남도마산의료원,경상남도 경상남도마산의료원,213,213,0,213,0,213,0,0
자치단체,경상남도,경상남도청소년지원재단,경상남도 경상남도청소년지원재단,6,6,0,6,6,0,0,0
자치단체,경상남도,고성군,경상남도 고성군,2846,2840,6,2840,1741,1057,42,0
자치단체,경상남도,고성소방서,경상남도 고성소방서,11,11,0,11,5,6,0,0
자치단체,경상남도,김해동부소방서,경상남도 김해동부소방서,40,28,12,28,0,28,0,0
자치단체,경상남도,김해서부소방서,경상남도 김해서부소방서,45,45,0,45,8,37,0,0
자치단체,경상남도,김해시,경상남도 김해시,5900,5853,47,5853,4164,705,720,264
자치단체,경상남도,(재)김해문화재단,경상남도 김해시 (재)김해문화재단,316,310,6,310,35,275,0,0
자치단체,경상남도,김해시도시개발공사,경상남도 김해시 김해시도시개발공사,342,272,70,272,0,271,0,1
자치단체,경상남도,재단법인김해시복지재단,경상남도 김해시 재단법인김해시복지재단,340,291,49,291,0,291,0,0
자치단체,경상남도,재단법인김해의생명산업진흥원,경상남도 김해시 재단법인김해의생명산업진흥원,149,149,0,149,0,149,0,0
자치단체,경상남도,남해군,경상남도 남해군,924,921,3,921,709,187,25,0
자치단체,경상남도,남해소방서,경상남도 남해소방서,14,14,0,14,5,9,0,0
자치단체,경상남도,농업기술원,경상남도 농업기술원,15,15,0,15,0,15,0,0
자치단체,경상남도,농업인력자원관리원,경상남도 농업인력자원관리원,81,81,0,81,0,81,0,0
자치단체,경상남도,도로관리사업소,경상남도 도로관리사업소,24,24,0,24,8,16,0,0
자치단체,경상남도,도립미술관,경상남도 도립미술관,32,29,3,29,0,29,0,0
자치단체,경상남도,동물위생시험소,경상남도 동물위생시험소,18,18,0,18,0,18,0,0
자치단체,경상남도,문화예술회관,경상남도 문화예술회관,34,34,0,34,0,34,0,0
자치단체,경상남도,밀양소방서,경상남도 밀양소방서,22,22,0,22,0,22,0,0
자치단체,경상남도,밀양시,경상남도 밀양시,2671,2671,0,2671,2557,79,35,0
자치단체,경상남도,밀양시시설관리공단,경상남도 밀양시 밀양시시설관리공단,234,234,0,234,0,234,0,0
자치단체,경상남도,사천소방서,경상남도 사천소방서,14,14,0,14,0,14,0,0
자치단체,경상남도,사천시,경상남도 사천시,2572,2572,0,2572,2366,100,55,51
자치단체,경상남도,사천시시설관리공단,경상남도 사천시 사천시시설관리공단,145,145,0,145,4,141,0,0
자치단체,경상남도,산림환경연구원,경상남도 산림환경연구원,12,12,0,12,0,12,0,0
자치단체,경상남도,산청군,경상남도 산청군,1263,1263,0,1263,1217,29,17,0
자치단체,경상남도,산청소방서,경상남도 산청소방서,19,19,0,19,0,19,0,0
자치단체,경상남도,수산안전기술원,경상남도 수산안전기술원,12,12,0,12,7,5,0,0
자치단체,경상남도,수산자원연구소,경상남도 수산자원연구소,34,34,0,34,0,34,0,0
자치단체,경상남도,양산소방서,경상남도 양산소방서,13,13,0,13,0,13,0,0
자치단체,경상남도,양산시,경상남도 양산시,3425,3425,0,3425,3235,8,126,56
자치단체,경상남도,(재)양산시복지재단,경상남도 양산시 (재)양산시복지재단,91,91,0,91,16,75,0,0
자치단체,경상남도,양산시시설관리공단,경상남도 양산시 양산시시설관리공단,593,575,18,575,33,542,0,0
자치단체,경상남도,의령군,경상남도 의령군,1314,1306,8,1306,964,269,26,47
자치단체,경상남도,의령소방서,경상남도 의령소방서,24,24,0,24,5,19,0,0
자치단체,경상남도,의회사무처,경상남도 의회사무처,30,30,0,30,16,14,0,0
자치단체,경상남도,재단법인경남문화예술진흥원,경상남도 재단법인경남문화예술진흥원,113,113,0,113,27,86,0,0
자치단체,경상남도,재단법인경남항노화연구원,경상남도 재단법인경남항노화연구원,20,19,1,19,0,19,0,0
자치단체,경상남도,재단법인경상남도관광재단,경상남도 재단법인경상남도관광재단,8,8,0,8,0,8,0,0
자치단체,경상남도,재단법인경상남도투자경제진흥원,경상남도 재단법인경상남도투자경제진흥원,0,0,0,0,0,0,0,0
자치단체,경상남도,제승당관리사무소,경상남도 제승당관리사무소,15,15,0,15,0,15,0,0
자치단체,경상남도,진주소방서,경상남도 진주소방서,28,28,0,28,10,18,0,0
자치단체,경상남도,진주시,경상남도 진주시,5169,5052,117,5052,4024,598,90,340
자치단체,경상남도,창녕군,경상남도 창녕군,2254,2106,148,2106,1094,962,37,13
자치단체,경상남도,창녕군시설관리공단,경상남도 창녕군 창녕군시설관리공단,169,136,33,136,0,136,0,0
자치단체,경상남도,창녕소방서,경상남도 창녕소방서,15,15,0,15,0,15,0,0
자치단체,경상남도,창원시,경상남도 창원시,8576,8335,241,8335,6915,1163,140,117
자치단체,경상남도,재단법인창원문화재단,경상남도 창원시 재단법인창원문화재단,216,216,0,216,0,216,0,0
자치단체,경상남도,창원레포츠파크,경상남도 창원시 창원레포츠파크,780,780,0,780,0,780,0,0
자치단체,경상남도,창원산업진흥원,경상남도 창원시 창원산업진흥원,60,60,0,60,0,60,0,0
자치단체,경상남도,창원시설공단,경상남도 창원시 창원시설공단,1407,1362,45,1362,395,964,0,3
자치단체,경상남도,창원시정연구원,경상남도 창원시 창원시정연구원,6,6,0,6,0,6,0,0
자치단체,경상남도,축산연구소,경상남도 축산연구소,18,0,18,0,0,0,0,0
자치단체,경상남도,통영소방서,경상남도 통영소방서,25,20,5,20,0,20,0,0
자치단체,경상남도,통영시,경상남도 통영시,4,4,0,4,4,0,0,0
자치단체,경상남도,통영관광개발공사,경상남도 통영시 통영관광개발공사,52,46,6,46,0,46,0,0
자치단체,경상남도,하동군,경상남도 하동군,818,818,0,818,608,146,64,0
자치단체,경상남도,하동소방서,경상남도 하동소방서,25,25,0,25,25,0,0,0
자치단체,경상남도,함안군,경상남도 함안군,1758,1688,70,1688,1554,109,25,0
자치단체,경상남도,함안지방공사,경상남도 함안군 함안지방공사,128,88,40,88,0,88,0,0
자치단체,경상남도,함안소방서,경상남도 함안소방서,12,7,5,7,0,7,0,0
자치단체,경상남도,함양군,경상남도 함양군,2141,2141,0,2141,1687,408,38,8
자치단체,경상남도,함양소방서,경상남도 함양소방서,13,13,0,13,0,13,0,0
자치단체,경상남도,합천군,경상남도 합천군,1391,1391,0,1391,724,663,4,0
자치단체,경상남도,합천소방서,경상남도 합천소방서,9,9,0,9,0,9,0,0
자치단체,경상남도,항만관리사업소,경상남도 항만관리사업소,72,72,0,72,0,72,0,0
자치단체,경상남도,환경교육원,경상남도 환경교육원,16,16,0,16,9,7,0,0
자치단체,제주특별자치도,제주특별자치도,제주특별자치도,10323,10323,0,10323,7888,2075,160,200
자치단체,제주특별자치도,서귀포시,제주특별자치도 서귀포시,3655,3625,30,3625,223,3253,149,0
자치단체,제주특별자치도,제주관광공사,제주특별자치도 제주관광공사,99,99,0,99,66,33,0,0
자치단체,제주특별자치도,제주시,제주특별자치도 제주시,6243,6179,64,6179,2787,3063,329,0
자치단체,제주특별자치도,제주에너지공사,제주특별자치도 제주에너지공사,93,61,32,61,16,45,0,0
자치단체,제주특별자치도,제주특별자치도개발공사,제주특별자치도 제주특별자치도개발공사,692,369,323,369,0,369,0,0
자치단체,제주특별자치도,제주특별자치도서귀포의료원,제주특별자치도 제주특별자치도서귀포의료원,123,123,0,123,0,123,0,0
교육기관,교육부,가야대학교,교육부 가야대학교,111,110,1,110,95,15,0,0
교육기관,교육부,가천대학교,교육부 가천대학교,1155,1075,80,1075,707,255,0,113
교육기관,교육부,가톨릭관동대학교,교육부 가톨릭관동대학교,344,344,0,344,20,320,4,0
교육기관,교육부,가톨릭대학교,교육부 가톨릭대학교,484,484,0,484,429,44,11,0
교육기관,교육부,가톨릭상지대학교,교육부 가톨릭상지대학교,114,114,0,114,14,100,0,0
교육기관,교육부,감리교신학대학교,교육부 감리교신학대학교,195,195,0,195,30,147,0,18
교육기관,교육부,강남대학교,교육부 강남대학교,399,373,26,373,0,373,0,0
교육기관,교육부,강동대학교,교육부 강동대학교,181,132,49,132,0,132,0,0
교육기관,교육부,강릉영동대학교,교육부 강릉영동대학교,161,161,0,161,4,157,0,0
교육기관,교육부,강릉원주대학교,교육부 강릉원주대학교,440,440,0,440,200,240,0,0
교육기관,교육부,강릉원주대학교치과병원,교육부 강릉원주대학교치과병원,53,53,0,53,0,53,0,0
교육기관,교육부,강원대학교,교육부 강원대학교,1245,1245,0,1245,1245,0,0,0
교육기관,교육부,강원대학교사범대학부설고등학교,교육부 강원대학교 강원대학교사범대학부설고등학교,81,79,2,79,79,0,0,0
교육기관,교육부,강원대학교병원,교육부 강원대학교병원,364,246,118,246,0,246,0,0
교육기관,교육부,개신대학원대학교,교육부 개신대학원대학교,8,8,0,8,0,8,0,0
교육기관,교육부,건국대학교,교육부 건국대학교,1462,1462,0,1462,1462,0,0,0
교육기관,교육부,건신대학원대학교,교육부 건신대학원대학교,20,20,0,20,0,20,0,0
교육기관,교육부,건양대학교,교육부 건양대학교,498,498,0,498,207,291,0,0
교육기관,교육부,건양사이버대학교,교육부 건양사이버대학교,6,5,1,5,2,3,0,0
교육기관,교육부,경기과학기술대학교,교육부 경기과학기술대학교,220,220,0,220,220,0,0,0
교육기관,교육부,경기대학교,교육부 경기대학교,812,812,0,812,174,557,81,0
교육기관,교육부,경남대학교,교육부 경남대학교,836,836,0,836,0,836,0,0
교육기관,교육부,경남정보대학교,교육부 경남정보대학교,506,506,0,506,0,506,0,0
교육기관,교육부,경동대학교,교육부 경동대학교,460,460,0,460,186,274,0,0
교육기관,교육부,경민대학교,교육부 경민대학교,43,43,0,43,0,43,0,0
교육기관,교육부,경북과학대학,교육부 경북과학대학,16,14,2,14,0,14,0,0
교육기관,교육부,경북대학교,교육부 경북대학교,2928,2312,616,2312,884,1344,72,12
교육기관,교육부,경북대학교사범대학부설고등학교,교육부 경북대학교 경북대학교사범대학부설고등학교,64,64,0,64,17,47,0,0
교육기관,교육부,경북대학교사범대학부설중학교,교육부 경북대학교 경북대학교사범대학부설중학교,32,32,0,32,32,0,0,0
교육기관,교육부,경북대학교병원,교육부 경북대학교병원,531,349,182,349,322,27,0,0
교육기관,교육부,경북대학교치과병원,교육부 경북대학교치과병원,41,40,1,40,20,20,0,0
교육기관,교육부,경북보건대학교,교육부 경북보건대학교,196,196,0,196,0,196,0,0
교육기관,교육부,경북전문대학교,교육부 경북전문대학교,191,186,5,186,44,142,0,0
교육기관,교육부,경상국립대학교,교육부 경상국립대학교,1368,1368,0,1368,1368,0,0,0
교육기관,교육부,경상대학교사범대학부설고등학교,교육부 경상국립대학교 경상대학교사범대학부설고등학교,59,59,0,59,24,30,4,1
교육기관,교육부,경상대학교사범대학부설중학교,교육부 경상국립대학교 경상대학교사범대학부설중학교,46,46,0,46,33,13,0,0
교육기관,교육부,경상국립대학교병원,교육부 경상국립대학교병원,401,386,15,386,114,272,0,0
교육기관,교육부,경성대학교,교육부 경성대학교,884,863,21,863,735,114,14,0
교육기관,교육부,경운대학교,교육부 경운대학교,255,255,0,255,0,253,0,2
교육기관,교육부,경인교육대학교,교육부 경인교육대학교,331,331,0,331,0,331,0,0
교육기관,교육부,경인여자대학,교육부 경인여자대학,116,114,2,114,114,0,0,0
교육기관,교육부,경일대학교,교육부 경일대학교,342,342,0,342,123,219,0,0
교육기관,교육부,경희대학교,교육부 경희대학교,2437,2437,0,2437,2041,318,0,78
교육기관,교육부,경희사이버대학교,교육부 경희사이버대학교,25,25,0,25,6,19,0,0
교육기관,교육부,계명대학교,교육부 계명대학교,644,644,0,644,0,644,0,0
교육기관,교육부,계명문화대학,교육부 계명문화대학,253,253,0,253,59,157,37,0
교육기관,교육부,고려대학교,교육부 고려대학교,2730,2730,0,2730,2730,0,0,0
교육기관,교육부,고려사이버대학교,교육부 고려사이버대학교,37,37,0,37,0,37,0,0
교육기관,교육부,고신대학교,교육부 고신대학교,349,349,0,349,330,19,0,0
교육기관,교육부,공주교육대학교,교육부 공주교육대학교,160,159,1,159,154,1,4,0
교육기관,교육부,공주대학교,교육부 공주대학교,1136,1126,10,1126,1126,0,0,0
교육기관,교육부,광신대학교,교육부 광신대학교,71,71,0,71,0,71,0,0
교육기관,교육부,광양보건대학교,교육부 광양보건대학교,25,25,0,25,0,25,0,0
교육기관,교육부,광운대학교,교육부 광운대학교,215,215,0,215,80,105,0,30
교육기관,교육부,광주가톨릭대학교,교육부 광주가톨릭대학교,14,14,0,14,3,11,0,0
교육기관,교육부,광주교육대학교,교육부 광주교육대학교,190,185,5,185,3,182,0,0
교육기관,교육부,광주대학교,교육부 광주대학교,202,200,2,200,76,124,0,0
교육기관,교육부,광주보건대학교,교육부 광주보건대학교,266,266,0,266,0,266,0,0
교육기관,교육부,광주여자대학교,교육부 광주여자대학교,209,205,4,205,15,190,0,0
교육기관,교육부,구미대학교,교육부 구미대학교,221,217,4,217,0,217,0,0
교육기관,교육부,구세군사관대학원대학교,교육부 구세군사관대학원대학교,32,32,0,32,15,15,2,0
교육기관,교육부,국민대학교,교육부 국민대학교,1010,1010,0,1010,73,937,0,0
교육기관,교육부,국제뇌교육종합대학원대학교,교육부 국제뇌교육종합대학원대학교,12,12,0,12,1,11,0,0
교육기관,교육부,국제대학,교육부 국제대학,253,253,0,253,25,220,8,0
교육기관,교육부,국제법률경영대학원대학교,교육부 국제법률경영대학원대학교,30,30,0,30,0,30,0,0
교육기관,교육부,국제사이버대학교,교육부 국제사이버대학교,8,8,0,8,0,8,0,0
교육기관,교육부,국제신학대학원대학교,교육부 국제신학대학원대학교,0,0,0,0,0,0,0,0
교육기관,교육부,국제영어대학원대학교,교육부 국제영어대학원대학교,23,3,20,3,2,1,0,0
교육기관,교육부,국제예술대학교,교육부 국제예술대학교,51,51,0,51,0,51,0,0
교육기관,교육부,군산간호대학교,교육부 군산간호대학교,130,130,0,130,0,130,0,0
교육기관,교육부,군산대학교,교육부 군산대학교,819,819,0,819,626,193,0,0
교육기관,교육부,군장대학,교육부 군장대학,113,113,0,113,0,113,0,0
교육기관,교육부,극동대학교,교육부 극동대학교,286,286,0,286,11,275,0,0
교육기관,교육부,글로벌사이버대학교,교육부 글로벌사이버대학교,7,5,2,5,0,5,0,0
교육기관,교육부,금오공과대학교,교육부 금오공과대학교,428,428,0,428,0,428,0,0
교육기관,교육부,기독간호대학,교육부 기독간호대학,87,87,0,87,16,71,0,0
교육기관,교육부,김천대학교,교육부 김천대학교,394,394,0,394,0,394,0,0
교육기관,교육부,김포대학,교육부 김포대학,84,40,44,40,24,16,0,0
교육기관,교육부,김해대학,교육부 김해대학,111,111,0,111,0,111,0,0
교육기관,교육부,꽃동네현도사회복지대학교,교육부 꽃동네현도사회복지대학교,39,39,0,39,0,39,0,0
교육기관,교육부,남부대학교,교육부 남부대학교,265,265,0,265,0,265,0,0
교육기관,교육부,농협대학,교육부 농협대학,87,87,0,87,0,87,0,0
교육기관,교육부,능인대학원대학교,교육부 능인대학원대학교,30,30,0,30,7,23,0,0
교육기관,교육부,단국대학교,교육부 단국대학교,1338,1272,66,1272,120,1109,0,43
교육기관,교육부,대경대학,교육부 대경대학,187,187,0,187,0,187,0,0
교육기관,교육부,대구가톨릭대학교,교육부 대구가톨릭대학교,557,547,10,547,98,449,0,0
교육기관,교육부,대구공업대학,교육부 대구공업대학,87,87,0,87,87,0,0,0
교육기관,교육부,대구과학대학교,교육부 대구과학대학교,202,196,6,196,0,196,0,0
교육기관,교육부,대구교육대학교,교육부 대구교육대학교,216,216,0,216,0,216,0,0
교육기관,교육부,대구부설초등학교,교육부 대구교육대학교 대구부설초등학교,50,50,0,50,50,0,0,0
교육기관,교육부,안동부설초등학교,교육부 대구교육대학교 안동부설초등학교,45,45,0,45,8,37,0,0
교육기관,교육부,대구대학교,교육부 대구대학교,1138,1138,0,1138,1107,13,0,18
교육기관,교육부,대구보건대학,교육부 대구보건대학,280,280,0,280,235,0,45,0
교육기관,교육부,대구사이버대학교,교육부 대구사이버대학교,14,13,1,13,0,13,0,0
교육기관,교육부,대구예술대학교,교육부 대구예술대학교,99,99,0,99,55,44,0,0
교육기관,교육부,대구한의대학교,교육부 대구한의대학교,210,194,16,194,154,30,0,10
교육기관,교육부,대덕대학,교육부 대덕대학,149,149,0,149,0,149,0,0
교육기관,교육부,대동대학,교육부 대동대학,119,119,0,119,0,119,0,0
교육기관,교육부,대림대학,교육부 대림대학,313,306,7,306,0,306,0,0
교육기관,교육부,대신대학교,교육부 대신대학교,58,56,2,56,53,1,1,1
교육기관,교육부,대원대학,교육부 대원대학,203,203,0,203,0,203,0,0
교육기관,교육부,대전가톨릭대학교,교육부 대전가톨릭대학교,17,17,0,17,0,17,0,0
교육기관,교육부,대전과학기술대학교,교육부 대전과학기술대학교,320,319,1,319,0,319,0,0
교육기관,교육부,대전대학교,교육부 대전대학교,801,781,20,781,454,321,3,3
교육기관,교육부,대진대학교,교육부 대진대학교,199,198,1,198,0,198,0,0
교육기관,교육부,대한신학대학원대학교,교육부 대한신학대학원대학교,8,8,0,8,2,6,0,0
교육기관,교육부,덕성여자대학교,교육부 덕성여자대학교,496,496,0,496,493,3,0,0
교육기관,교육부,동강대학교,교육부 동강대학교,120,120,0,120,7,113,0,0
교육기관,교육부,동국대학교,교육부 동국대학교,750,750,0,750,691,59,0,0
교육기관,교육부,경주캠퍼스,교육부 동국대학교 경주캠퍼스,537,537,0,537,528,9,0,0
교육기관,교육부,동남보건대학,교육부 동남보건대학,122,119,3,119,0,119,0,0
교육기관,교육부,동덕여자대학교,교육부 동덕여자대학교,464,464,0,464,464,0,0,0
교육기관,교육부,동명대학교,교육부 동명대학교,386,377,9,377,0,377,0,0
교육기관,교육부,동방대학원대학교,교육부 동방대학원대학교,6,6,0,6,2,4,0,0
교육기관,교육부,동서대학교,교육부 동서대학교,823,823,0,823,0,823,0,0
교육기관,교육부,동서울대학,교육부 동서울대학,314,314,0,314,314,0,0,0
교육기관,교육부,동신대학교,교육부 동신대학교,242,242,0,242,12,169,53,8
교육기관,교육부,동아대학교,교육부 동아대학교,1477,1474,3,1474,0,1474,0,0
교육기관,교육부,동아방송예술대학,교육부 동아방송예술대학,248,245,3,245,232,13,0,0
교육기관,교육부,동아보건대학교,교육부 동아보건대학교,74,74,0,74,0,74,0,0
교육기관,교육부,동양대학교,교육부 동양대학교,445,438,7,438,436,0,2,0
교육기관,교육부,동양미래대학,교육부 동양미래대학,240,240,0,240,0,240,0,0
교육기관,교육부,동원과학기술대학교,교육부 동원과학기술대학교,89,89,0,89,4,85,0,0
교육기관,교육부,동원대학,교육부 동원대학,116,116,0,116,0,106,0,10
교육기관,교육부,동주대학,교육부 동주대학,203,203,0,203,87,59,57,0
교육기관,교육부,두원공과대학,교육부 두원공과대학,233,232,1,232,231,0,0,1
교육기관,교육부,디지털서울문화예술대학교,교육부 디지털서울문화예술대학교,22,22,0,22,8,8,6,0
교육기관,교육부,명지대학교,교육부 명지대학교,1023,1023,0,1023,0,1023,0,0
교육기관,교육부,목원대학교,교육부 목원대학교,588,577,11,577,0,569,0,8
교육기관,교육부,목포가톨릭대학교,교육부 목포가톨릭대학교,45,45,0,45,1,44,0,0
교육기관,교육부,목포대학교,교육부 목포대학교,356,337,19,337,0,337,0,0
교육기관,교육부,목포해양대학교,교육부 목포해양대학교,504,504,0,504,83,421,0,0
교육기관,교육부,문경대학,교육부 문경대학,59,59,0,59,10,49,0,0
교육기관,교육부,배재대학교,교육부 배재대학교,312,311,1,311,5,306,0,0
교육기관,교육부,배화여자대학교,교육부 배화여자대학교,101,101,0,101,0,101,0,0
교육기관,교육부,백석대학교,교육부 백석대학교,671,671,0,671,0,671,0,0
교육기관,교육부,백석문화대학,교육부 백석문화대학교,266,266,0,266,0,266,0,0
교육기관,교육부,백제예술대학,교육부 백제예술대학,10,10,0,10,7,3,0,0
교육기관,교육부,부경대학교,교육부 부경대학교,1392,1392,0,1392,1076,272,44,0
교육기관,교육부,부산가톨릭대학교,교육부 부산가톨릭대학교,262,262,0,262,247,15,0,0
교육기관,교육부,부산과학기술대학교,교육부 부산과학기술대학교,278,278,0,278,274,4,0,0
교육기관,교육부,부산교육대학교,교육부 부산교육대학교,341,341,0,341,155,186,0,0
교육기관,교육부,부산대학교,교육부 부산대학교,3321,3321,0,3321,2646,665,10,0
교육기관,교육부,부산대학교병원,교육부 부산대학교병원,1082,996,86,996,473,473,25,25
교육기관,교육부,부산대학교치과병원,교육부 부산대학교치과병원,65,65,0,65,35,30,0,0
교육기관,교육부,부산디지털대학교,교육부 부산디지털대학교,16,16,0,16,16,0,0,0
교육기관,교육부,부산여자대학,교육부 부산여자대학,290,290,0,290,266,24,0,0
교육기관,교육부,부산예술대학,교육부 부산예술대학,66,66,0,66,66,0,0,0
교육기관,교육부,부산외국어대학교,교육부 부산외국어대학교,463,459,4,459,0,459,0,0
교육기관,교육부,부산장신대학교,교육부 부산장신대학교,32,32,0,32,0,32,0,0
교육기관,교육부,부천대학교,교육부 부천대학교,530,523,7,523,22,446,55,0
교육기관,교육부,북한대학원대학교,교육부 북한대학원대학교,16,16,0,16,9,7,0,0
교육기관,교육부,삼육대학교,교육부 삼육대학교,564,556,8,556,93,463,0,0
교육기관,교육부,삼육보건대학,교육부 삼육보건대학,105,105,0,105,16,89,0,0
교육기관,교육부,상명대학교,교육부 상명대학교,803,758,45,758,90,654,14,0
교육기관,교육부,서강대학교,교육부 서강대학교,877,820,57,820,758,62,0,0
교육기관,교육부,서라벌대학교,교육부 서라벌대학교,155,155,0,155,22,133,0,0
교육기관,교육부,서영대학,교육부 서영대학,125,125,0,125,84,41,0,0
교육기관,교육부,서울과학종합대학원대학교,교육부 서울과학종합대학원대학교,18,18,0,18,0,18,0,0
교육기관,교육부,서울교육대학교,교육부 서울교육대학교,293,293,0,293,0,293,0,0
교육기관,교육부,서울대학교,교육부 서울대학교,8101,7437,664,7437,5377,1980,35,45
교육기관,교육부,서울대학교치과병원,교육부 서울대학교치과병원,160,141,19,141,106,35,0,0
교육기관,교육부,서울디지털대학교,교육부 서울디지털대학교,35,3,32,3,0,3,0,0
교육기관,교육부,서울벤처정보대학원대학교,교육부 서울벤처정보대학원대학교,8,8,0,8,0,8,0,0
교육기관,교육부,서울사이버대학교,교육부 서울사이버대학교,131,131,0,131,0,124,7,0
교육기관,교육부,서울사회복지대학원대학교,교육부 서울사회복지대학원대학교,9,9,0,9,9,0,0,0
교육기관,교육부,서울성경신학대학원대학교,교육부 서울성경신학대학원대학교,16,16,0,16,3,13,0,0
교육기관,교육부,서울시립대학교,교육부 서울시립대학교,659,659,0,659,131,528,0,0
교육기관,교육부,서울신학대학교,교육부 서울신학대학교,226,226,0,226,0,226,0,0
교육기관,교육부,서울여자간호대학,교육부 서울여자간호대학,69,68,1,68,16,52,0,0
교육기관,교육부,서울여자대학교,교육부 서울여자대학교,434,399,35,399,0,399,0,0
교육기관,교육부,서울예술대학,교육부 서울예술대학,245,245,0,245,238,7,0,0
교육기관,교육부,서울외국어대학원대학교,교육부 서울외국어대학원대학교,3,3,0,3,0,3,0,0
교육기관,교육부,서울한영대학교,교육부 서울한영대학교,56,56,0,56,52,4,0,0
교육기관,교육부,서원대학교,교육부 서원대학교,510,510,0,510,0,510,0,0
교육기관,교육부,서일대학,교육부 서일대학,289,289,0,289,0,289,0,0
교육기관,교육부,서정대학,교육부 서정대학,111,111,0,111,0,111,0,0
교육기관,교육부,선문대학교,교육부 선문대학교,823,781,42,781,0,774,7,0
교육기관,교육부,선학유피대학원대학교,교육부 선학유피대학원대학교,27,27,0,27,0,27,0,0
교육기관,교육부,성균관대학교,교육부 성균관대학교,1481,1372,109,1372,1372,0,0,0
교육기관,교육부,성산효대학원대학교,교육부 성산효대학원대학교,41,41,0,41,0,41,0,0
교육기관,교육부,성신여자대학교,교육부 성신여자대학교,963,963,0,963,0,963,0,0
교육기관,교육부,성운대학교,교육부 성운대학교,51,51,0,51,8,39,0,4
교육기관,교육부,세경대학,교육부 세경대학,16,16,0,16,14,2,0,0
교육기관,교육부,세명대학교,교육부 세명대학교,912,912,0,912,7,890,0,15
교육기관,교육부,세종대학교,교육부 세종대학교,1129,1129,0,1129,980,149,0,0
교육기관,교육부,세종사이버대학교,교육부 세종사이버대학교,50,13,37,13,0,13,0,0
교육기관,교육부,세한대학교,교육부 세한대학교,347,347,0,347,0,347,0,0
교육기관,교육부,송원대학교,교육부 송원대학교,144,136,8,136,114,3,19,0
교육기관,교육부,송호대학교,교육부 송호대학교,79,79,0,79,0,79,0,0
교육기관,교육부,수원가톨릭대학교,교육부 수원가톨릭대학교,2,2,0,2,1,1,0,0
교육기관,교육부,수원과학대학,교육부 수원과학대학,143,143,0,143,71,72,0,0
교육기관,교육부,수원대학교,교육부 수원대학교,478,470,8,470,465,0,4,1
교육기관,교육부,수원여자대학교,교육부 수원여자대학교,108,108,0,108,61,47,0,0
교육기관,교육부,숙명여자대학교,교육부 숙명여자대학교,694,694,0,694,0,694,0,0
교육기관,교육부,순천제일대학,교육부 순천제일대학,116,116,0,116,60,53,0,3
교육기관,교육부,순천향대학교,교육부 순천향대학교,462,462,0,462,0,462,0,0
교육기관,교육부,숭실대학교,교육부 숭실대학교,756,756,0,756,600,154,0,2
교육기관,교육부,숭실사이버대학교,교육부 숭실사이버대학교,14,0,14,0,0,0,0,0
교육기관,교육부,숭의여자대학교,교육부 숭의여자대학교,67,67,0,67,0,67,0,0
교육기관,교육부,신구대학,교육부 신구대학,313,313,0,313,0,313,0,0
교육기관,교육부,신라대학교,교육부 신라대학교,19,19,0,19,0,19,0,0
교육기관,교육부,신성대학,교육부 신성대학,309,309,0,309,306,0,0,3
교육기관,교육부,신안산대학교,교육부 신안산대학교,240,240,0,240,19,221,0,0
교육기관,교육부,신한대학교,교육부 신한대학교,420,420,0,420,3,417,0,0
교육기관,교육부,실천신학대학원대학교,교육부 실천신학대학원대학교,1,1,0,1,0,1,0,0
교육기관,교육부,아이씨티폴리텍대학,교육부 아이씨티폴리텍대학,148,148,0,148,0,148,0,0
교육기관,교육부,아주대학교,교육부 아주대학교,787,761,26,761,57,626,78,0
교육기관,교육부,아주자동차대학,교육부 아주자동차대학,94,93,1,93,0,93,0,0
교육기관,교육부,안동과학대학교,교육부 안동과학대학교,372,369,3,369,0,369,0,0
교육기관,교육부,안동대학교,교육부 안동대학교,672,672,0,672,664,8,0,0
교육기관,교육부,안산대학교,교육부 안산대학교,148,146,2,146,0,146,0,0
교육기관,교육부,안양대학교,교육부 안양대학교,232,232,0,232,0,232,0,0
교육기관,교육부,양산부산대학교병원,교육부 양산부산대학교병원,1133,733,400,733,5,728,0,0
교육기관,교육부,여주대학,교육부 여주대학,398,291,107,291,0,291,0,0
교육기관,교육부,연성대학교,교육부 연성대학교,239,239,0,239,0,239,0,0
교육기관,교육부,연세대학교,교육부 연세대학교,2390,2390,0,2390,2188,0,192,10
교육기관,교육부,미래캠퍼스,교육부 연세대학교 미래캠퍼스,1130,1100,30,1100,19,1027,0,54
교육기관,교육부,연암공과대학교 ,교육부 연암공과대학교 ,141,141,0,141,0,141,0,0
교육기관,교육부,연암대학교 ,교육부 연암대학교 ,125,81,44,81,0,81,0,0
교육기관,교육부,영남대학교,교육부 영남대학교,2120,2120,0,2120,419,1701,0,0
교육기관,교육부,영남신학대학교,교육부 영남신학대학교,44,44,0,44,0,44,0,0
교육기관,교육부,영남외국어대학,교육부 영남외국어대학,28,28,0,28,0,28,0,0
교육기관,교육부,영남이공대학,교육부 영남이공대학,439,58,381,58,51,7,0,0
교육기관,교육부,영산대학교,교육부 영산대학교,257,257,0,257,0,257,0,0
교육기관,교육부,영진사이버대학,교육부 영진사이버대학,0,0,0,0,0,0,0,0
교육기관,교육부,영진전문대학,교육부 영진전문대학,594,594,0,594,0,594,0,0
교육기관,교육부,예명대학원대학교,교육부 예명대학원대학교,15,15,0,15,0,15,0,0
교육기관,교육부,예수대학교,교육부 예수대학교,36,36,0,36,36,0,0,0
교육기관,교육부,예원예술대학교,교육부 예원예술대학교,56,56,0,56,0,56,0,0
교육기관,교육부,오산대학,교육부 오산대학,169,169,0,169,0,169,0,0
교육기관,교육부,용인대학교,교육부 용인대학교,283,283,0,283,281,2,0,0
교육기관,교육부,용인예술과학대학교,교육부 용인예술과학대학교,248,248,0,248,0,248,0,0
교육기관,교육부,우석대학교,교육부 우석대학교,684,683,1,683,32,651,0,0
교육기관,교육부,우송대학교,교육부 우송대학교,740,740,0,740,564,176,0,0
교육기관,교육부,우송정보대학,교육부 우송정보대학,155,155,0,155,85,70,0,0
교육기관,교육부,울산과학대학,교육부 울산과학대학,386,386,0,386,0,386,0,0
교육기관,교육부,울산대학교,교육부 울산대학교,369,369,0,369,250,119,0,0
교육기관,교육부,원광대학교,교육부 원광대학교,848,829,19,829,124,705,0,0
교육기관,교육부,원광디지털대학교,교육부 원광디지털대학교,0,0,0,0,0,0,0,0
교육기관,교육부,원광보건대학,교육부 원광보건대학,61,19,42,19,8,11,0,0
교육기관,교육부,원불교대학원대학교,교육부 원불교대학원대학교,0,0,0,0,0,0,0,0
교육기관,교육부,위덕대학교,교육부 위덕대학교,169,169,0,169,0,149,20,0
교육기관,교육부,유원대학교,교육부 유원대학교,104,104,0,104,104,0,0,0
교육기관,교육부,유한대학,교육부 유한대학,181,181,0,181,0,181,0,0
교육기관,교육부,을지대학교,교육부 을지대학교,59,59,0,59,0,59,0,0
교육기관,교육부,성남캠퍼스,교육부 을지대학교 성남캠퍼스,390,296,94,296,0,296,0,0
교육기관,교육부,의정부캠퍼스,교육부 을지대학교 의정부캠퍼스,239,225,14,225,0,225,0,0
교육기관,교육부,이화여자대학교,교육부 이화여자대학교,2095,2095,0,2095,1953,142,0,0
교육기관,교육부,인덕대학,교육부 인덕대학,210,203,7,203,1,202,0,0
교육기관,교육부,인제대학교,교육부 인제대학교,661,661,0,661,628,28,0,5
교육기관,교육부,인천가톨릭대학교,교육부 인천가톨릭대학교,164,164,0,164,71,93,0,0
교육기관,교육부,인천대학교,교육부 인천대학교,1128,1128,0,1128,0,1128,0,0
교육기관,교육부,인천재능대학교,교육부 인천재능대학교,351,351,0,351,0,351,0,0
교육기관,교육부,인하공업전문대학,교육부 인하공업전문대학,303,303,0,303,0,303,0,0
교육기관,교육부,인하대학교,교육부 인하대학교,860,860,0,860,856,0,4,0
교육기관,교육부,장로회신학대학교,교육부 장로회신학대학교,323,316,7,316,0,316,0,0
교육기관,교육부,장안대학,교육부 장안대학,307,307,0,307,13,294,0,0
교육기관,교육부,전남과학대학,교육부 전남과학대학,97,97,0,97,0,97,0,0
교육기관,교육부,전남대학교,교육부 전남대학교,2512,2460,52,2460,996,1464,0,0
교육기관,교육부,전남대학교병원,교육부 전남대학교병원,806,714,92,714,560,154,0,0
교육기관,교육부,전북과학대학교,교육부 전북과학대학교,92,92,0,92,92,0,0,0
교육기관,교육부,전북대학교,교육부 전북대학교,2939,2848,91,2848,662,2186,0,0
교육기관,교육부,전북대학교병원,교육부 전북대학교병원,1056,839,217,839,542,148,0,149
교육기관,교육부,전주교육대학교,교육부 전주교육대학교,154,154,0,154,60,60,20,14
교육기관,교육부,전주기전대학,교육부 전주기전대학,127,127,0,127,86,41,0,0
교육기관,교육부,전주대학교,교육부 전주대학교,1097,1089,8,1089,0,1089,0,0
교육기관,교육부,전주비전대학,교육부 전주비전대학,249,249,0,249,126,123,0,0
교육기관,교육부,제주관광대학교,교육부 제주관광대학교,282,282,0,282,0,282,0,0
교육기관,교육부,제주국제대학교,교육부 제주국제대학교,55,55,0,55,55,0,0,0
교육기관,교육부,제주대학교,교육부 제주대학교,556,556,0,556,20,464,72,0
교육기관,교육부,제주대학교병원,교육부 제주대학교병원,401,371,30,371,0,371,0,0
교육기관,교육부,조선간호대학,교육부 조선간호대학,64,64,0,64,13,51,0,0
교육기관,교육부,조선대학교,교육부 조선대학교,971,941,30,941,549,335,0,57
교육기관,교육부,조선이공대학교,교육부 조선이공대학교,147,147,0,147,0,147,0,0
교육기관,교육부,중부대학교,교육부 중부대학교,411,411,0,411,411,0,0,0
교육기관,교육부,중앙대학교,교육부 중앙대학교,1888,1862,26,1862,0,1862,0,0
교육기관,교육부,중앙승가대학교,교육부 중앙승가대학교,52,52,0,52,14,37,0,1
교육기관,교육부,중원대학교,교육부 중원대학교,464,464,0,464,445,19,0,0
교육기관,교육부,진주교육대학교,교육부 진주교육대학교,225,225,0,225,117,108,0,0
교육기관,교육부,진주보건대학,교육부 진주보건대학,86,86,0,86,0,86,0,0
교육기관,교육부,차의과학대학교,교육부 차의과학대학교,227,223,4,223,151,72,0,0
교육기관,교육부,창신대학교,교육부 창신대학교,315,315,0,315,0,315,0,0
교육기관,교육부,창원대학교,교육부 창원대학교,801,138,663,138,15,101,0,22
교육기관,교육부,창원문성대학교,교육부 창원문성대학교,182,182,0,182,0,182,0,0
교육기관,교육부,청암대학교,교육부 청암대학교,135,135,0,135,0,135,0,0
교육기관,교육부,청운대학교,교육부 청운대학교,259,259,0,259,8,251,0,0
교육기관,교육부,청주교육대학교,교육부 청주교육대학교,150,150,0,150,150,0,0,0
교육기관,교육부,청주대학교,교육부 청주대학교,425,415,10,415,411,4,0,0
교육기관,교육부,초당대학교,교육부 초당대학교,135,135,0,135,0,135,0,0
교육기관,교육부,총신대학교,교육부 총신대학교,371,370,1,370,73,294,0,3
교육기관,교육부,추계예술대학교,교육부 추계예술대학교,146,146,0,146,146,0,0,0
교육기관,교육부,춘천교육대학교,교육부 춘천교육대학교,198,195,3,195,0,195,0,0
교육기관,교육부,춘천교육대학교부설초등학교,교육부 춘천교육대학교 춘천교육대학교부설초등학교,21,21,0,21,0,21,0,0
교육기관,교육부,춘해보건대학,교육부 춘해보건대학,232,232,0,232,0,232,0,0
교육기관,교육부,충남대학교,교육부 충남대학교,2448,2425,23,2425,2272,153,0,0
교육기관,교육부,충남대학교병원,교육부 충남대학교병원,880,559,321,559,280,156,0,123
교육기관,교육부,충북대학교,교육부 충북대학교,1316,1316,0,1316,615,701,0,0
교육기관,교육부,충북대학교병원,교육부 충북대학교병원,622,499,123,499,92,318,0,89
교육기관,교육부,충북보건과학대학교,교육부 충북보건과학대학교,129,129,0,129,29,100,0,0
교육기관,교육부,충청대학,교육부 충청대학,364,361,3,361,290,71,0,0
교육기관,교육부,칼빈대학교,교육부 칼빈대학교,32,32,0,32,21,11,0,0
교육기관,교육부,크리스찬치유상담대학원대학교,교육부 크리스찬치유상담대학원대학교,16,16,0,16,4,7,5,0
교육기관,교육부,평택대학교,교육부 평택대학교,375,375,0,375,0,375,0,0
교육기관,교육부,포항공과대학교,교육부 포항공과대학교,972,766,206,766,67,693,6,0
교육기관,교육부,포항대학교,교육부 포항대학교,248,246,2,246,0,246,0,0
교육기관,교육부,한경국립대학교,교육부 한경국립대학교,511,511,0,511,62,449,0,0
교육기관,교육부,한국공학대학교,교육부 한국공학대학교,737,737,0,737,0,737,0,0
교육기관,교육부,한국관광대학,교육부 한국관광대학,143,143,0,143,143,0,0,0
교육기관,교육부,한국교원대학교,교육부 한국교원대학교,436,436,0,436,380,34,0,22
교육기관,교육부,한국교통대학교,교육부 한국교통대학교,749,749,0,749,749,0,0,0
교육기관,교육부,한국방송통신대학교,교육부 한국방송통신대학교,842,842,0,842,24,814,4,0
교육기관,교육부,한국복지사이버대학,교육부 한국복지사이버대학,22,9,13,9,9,0,0,0
교육기관,교육부,한국상담대학원대학교,교육부 한국상담대학원대학교,9,9,0,9,6,3,0,0
교육기관,교육부,한국성서대학교,교육부 한국성서대학교,95,95,0,95,0,95,0,0
교육기관,교육부,한국승강기대학,교육부 한국승강기대학,133,133,0,133,0,133,0,0
교육기관,교육부,한국열린사이버대학교,교육부 한국열린사이버대학교,17,17,0,17,0,17,0,0
교육기관,교육부,한국영상대학교,교육부 한국영상대학교,220,220,0,220,0,216,0,4
교육기관,교육부,한국외국어대학교,교육부 한국외국어대학교,1752,1750,2,1750,12,1738,0,0
교육기관,교육부,한국체육대학교,교육부 한국체육대학교,274,274,0,274,0,274,0,0
교육기관,교육부,한국침례신학대학교,교육부 한국침례신학대학교,343,343,0,343,0,343,0,0
교육기관,교육부,한국항공대학교,교육부 한국항공대학교,272,257,15,257,0,257,0,0
교육기관,교육부,한국해양대학교,교육부 한국해양대학교,778,480,298,480,157,158,82,83
교육기관,교육부,한남대학교,교육부 한남대학교,554,554,0,554,0,554,0,0
교육기관,교육부,한동대학교,교육부 한동대학교,609,609,0,609,0,609,0,0
교육기관,교육부,한라대학교,교육부 한라대학교,289,287,2,287,211,76,0,0
교육기관,교육부,한림국제대학원대학교,교육부 한림국제대학원대학교,11,11,0,11,0,5,6,0
교육기관,교육부,한림대학교,교육부 한림대학교,690,633,57,633,36,584,13,0
교육기관,교육부,한림성심대학교,교육부 한림성심대학교,288,288,0,288,277,7,4,0
교육기관,교육부,한반도국제대학원대학교,교육부 한반도국제대학원대학교,4,2,2,2,1,1,0,0
교육기관,교육부,한밭대학교,교육부 한밭대학교,502,502,0,502,95,407,0,0
교육기관,교육부,한서대학교,교육부 한서대학교,632,630,2,630,16,607,0,7
교육기관,교육부,한성대학교,교육부 한성대학교,607,605,2,605,48,557,0,0
교육기관,교육부,한세대학교,교육부 한세대학교,316,316,0,316,0,316,0,0
교육기관,교육부,한신대학교,교육부 한신대학교,307,307,0,307,61,246,0,0
교육기관,교육부,한양대학교,교육부 한양대학교,4179,3991,188,3991,359,3317,315,0
교육기관,교육부,한양사이버대학교,교육부 한양사이버대학교,67,67,0,67,0,67,0,0
교육기관,교육부,한양여자대학,교육부 한양여자대학,354,350,4,350,85,265,0,0
교육기관,교육부,한영대학,교육부 한영대학,62,62,0,62,0,62,0,0
교육기관,교육부,합동신학대학원대학교,교육부 합동신학대학원대학교,26,26,0,26,26,0,0,0
교육기관,교육부,협성대학교,교육부 협성대학교,254,254,0,254,0,254,0,0
교육기관,교육부,혜전대학교,교육부 혜전대학교,149,127,22,127,83,44,0,0
교육기관,교육부,호남신학대학교,교육부 호남신학대학교,51,51,0,51,25,26,0,0
교육기관,교육부,호산대학교,교육부 호산대학교,131,131,0,131,51,77,3,0
교육기관,교육부,호서대학교,교육부 호서대학교,930,930,0,930,0,930,0,0
교육기관,교육부,호원대학교,교육부 호원대학교,512,512,0,512,512,0,0,0
교육기관,교육부,홍익대학교,교육부 홍익대학교,1460,1460,0,1460,22,1438,0,0
교육기관,교육부,화신사이버대학교,교육부 화신사이버대학교,17,17,0,17,0,17,0,0
교육기관,교육부,서울특별시교육청,교육부 서울특별시교육청,24,6,18,6,3,3,0,0
교육기관,교육부,가락고등학교,교육부 서울특별시교육청 가락고등학교,33,0,33,0,0,0,0,0
교육기관,교육부,가재울고등학교,교육부 서울특별시교육청 가재울고등학교,57,57,0,57,19,38,0,0
교육기관,교육부,강남도서관,교육부 서울특별시교육청 강남도서관,12,12,0,12,12,0,0,0
교육기관,교육부,강동고등학교,교육부 서울특별시교육청 강동고등학교,36,36,0,36,0,36,0,0
교육기관,교육부,강동도서관,교육부 서울특별시교육청 강동도서관,25,25,0,25,17,6,0,2
교육기관,교육부,강서도서관,교육부 서울특별시교육청 강서도서관,29,29,0,29,0,29,0,0
교육기관,교육부,강일고등학교,교육부 서울특별시교육청 강일고등학교,61,61,0,61,20,41,0,0
교육기관,교육부,개포고등학교,교육부 서울특별시교육청 개포고등학교,35,35,0,35,0,35,0,0
교육기관,교육부,개포도서관,교육부 서울특별시교육청 개포도서관,25,25,0,25,0,25,0,0
교육기관,교육부,건국대학교사범대학부속고등학교,교육부 서울특별시교육청 건국대학교사범대학부속고등학교,85,85,0,85,85,0,0,0
교육기관,교육부,경기고등학교,교육부 서울특별시교육청 경기고등학교,68,68,0,68,53,15,0,0
교육기관,교육부,경기기계공업고등학교,교육부 서울특별시교육청 경기기계공업고등학교,52,52,0,52,0,52,0,0
교육기관,교육부,경기상업고등학교,교육부 서울특별시교육청 경기상업고등학교,41,41,0,41,0,41,0,0
교육기관,교육부,경기여자고등학교,교육부 서울특별시교육청 경기여자고등학교,38,37,1,37,0,37,0,0
교육기관,교육부,경동고등학교,교육부 서울특별시교육청 경동고등학교,82,82,0,82,0,82,0,0
교육기관,교육부,경문고등학교,교육부 서울특별시교육청 경문고등학교,32,32,0,32,1,31,0,0
교육기관,교육부,경복고등학교,교육부 서울특별시교육청 경복고등학교,74,74,0,74,0,74,0,0
교육기관,교육부,경성고등학교,교육부 서울특별시교육청 경성고등학교,42,42,0,42,42,0,0,0
교육기관,교육부,경일고등학교,교육부 서울특별시교육청 경일고등학교,40,39,1,39,0,39,0,0
교육기관,교육부,경희고등학교,교육부 서울특별시교육청 경희고등학교,29,29,0,29,7,22,0,0
교육기관,교육부,계성고등학교,교육부 서울특별시교육청 계성고등학교,77,77,0,77,0,77,0,0
교육기관,교육부,고덕평생학습관,교육부 서울특별시교육청 고덕평생학습관,31,31,0,31,0,31,0,0
교육기관,교육부,고명외식고등학교,교육부 서울특별시교육청 고명외식고등학교,31,31,0,31,0,31,0,0
교육기관,교육부,고척고등학교,교육부 서울특별시교육청 고척고등학교,44,44,0,44,44,0,0,0
교육기관,교육부,고척도서관,교육부 서울특별시교육청 고척도서관,31,31,0,31,7,24,0,0
교육기관,교육부,관악고등학교,교육부 서울특별시교육청 관악고등학교,64,64,0,64,29,35,0,0
교육기관,교육부,광남고등학교,교육부 서울특별시교육청 광남고등학교,29,29,0,29,10,19,0,0
교육기관,교육부,광문고등학교,교육부 서울특별시교육청 광문고등학교,79,79,0,79,0,79,0,0
교육기관,교육부,광성고등학교,교육부 서울특별시교육청 광성고등학교,49,47,2,47,9,38,0,0
교육기관,교육부,광성하늘빛학교,교육부 서울특별시교육청 광성하늘빛학교,16,16,0,16,8,8,0,0
교육기관,교육부,광신고등학교,교육부 서울특별시교육청 광신고등학교,30,30,0,30,30,0,0,0
교육기관,교육부,광신방송예술고등학교,교육부 서울특별시교육청 광신방송예술고등학교,17,16,1,16,16,0,0,0
교육기관,교육부,광운전자공업고등학교,교육부 서울특별시교육청 광운전자공업고등학교,60,58,2,58,30,28,0,0
교육기관,교육부,구로고등학교,교육부 서울특별시교육청 구로고등학교,41,41,0,41,26,15,0,0
교육기관,교육부,구로도서관,교육부 서울특별시교육청 구로도서관,27,27,0,27,27,0,0,0
교육기관,교육부,구암고등학교,교육부 서울특별시교육청 구암고등학교,47,47,0,47,9,38,0,0
교육기관,교육부,구일고등학교,교육부 서울특별시교육청 구일고등학교,31,31,0,31,31,0,0,0
교육기관,교육부,국립대학법인서울대학교사범대학부설고등학교,교육부 서울특별시교육청 국립대학법인서울대학교사범대학부설고등학교,55,55,0,55,0,55,0,0
교육기관,교육부,금천고등학교,교육부 서울특별시교육청 금천고등학교,66,66,0,66,15,51,0,0
교육기관,교육부,금천문화예술정보학교,교육부 서울특별시교육청 금천문화예술정보학교,26,26,0,26,0,26,0,0
교육기관,교육부,금호고등학교,교육부 서울특별시교육청 금호고등학교,50,50,0,50,0,50,0,0
교육기관,교육부,남강고등학교,교육부 서울특별시교육청 남강고등학교,88,88,0,88,21,67,0,0
교육기관,교육부,남산도서관,교육부 서울특별시교육청 남산도서관,44,44,0,44,0,44,0,0
교육기관,교육부,노원고등학교,교육부 서울특별시교육청 노원고등학교,50,50,0,50,25,25,0,0
교육기관,교육부,노원평생학습관,교육부 서울특별시교육청 노원평생학습관,21,21,0,21,0,21,0,0
교육기관,교육부,누리학교,교육부 서울특별시교육청 누리학교,10,5,5,5,1,2,1,1
교육기관,교육부,누원고등학교,교육부 서울특별시교육청 누원고등학교,52,52,0,52,13,39,0,0
교육기관,교육부,다니엘학교,교육부 서울특별시교육청 다니엘학교,36,36,0,36,36,0,0,0
교육기관,교육부,단국대학교부속소프트웨어고등학교,교육부 서울특별시교육청 단국대학교부속소프트웨어고등학교,47,47,0,47,13,34,0,0
교육기관,교육부,당곡고등학교,교육부 서울특별시교육청 당곡고등학교,59,59,0,59,9,50,0,0
교육기관,교육부,대경상업고등학교,교육부 서울특별시교육청 대경상업고등학교,31,31,0,31,7,24,0,0
교육기관,교육부,대광고등학교,교육부 서울특별시교육청 대광고등학교,25,25,0,25,19,6,0,0
교육기관,교육부,대동세무고등학교,교육부 서울특별시교육청 대동세무고등학교,17,17,0,17,17,0,0,0
교육기관,교육부,대성고등학교,교육부 서울특별시교육청 대성고등학교,61,61,0,61,41,20,0,0
교육기관,교육부,대신고등학교,교육부 서울특별시교육청 대신고등학교,75,75,0,75,0,75,0,0
교육기관,교육부,대영고등학교,교육부 서울특별시교육청 대영고등학교,45,44,1,44,0,44,0,0
교육기관,교육부,대원고등학교,교육부 서울특별시교육청 대원고등학교,24,24,0,24,18,6,0,0
교육기관,교육부,대원여자고등학교,교육부 서울특별시교육청 대원여자고등학교,47,47,0,47,47,0,0,0
교육기관,교육부,대원외국어고등학교,교육부 서울특별시교육청 대원외국어고등학교,74,74,0,74,64,10,0,0
교육기관,교육부,대일외국어고등학교,교육부 서울특별시교육청 대일외국어고등학교,100,100,0,100,100,0,0,0
교육기관,교육부,대진디자인고등학교,교육부 서울특별시교육청 대진디자인고등학교,32,32,0,32,0,32,0,0
교육기관,교육부,대진여자고등학교,교육부 서울특별시교육청 대진여자고등학교,37,37,0,37,17,20,0,0
교육기관,교육부,덕성여자고등학교,교육부 서울특별시교육청 덕성여자고등학교,16,16,0,16,7,7,1,1
교육기관,교육부,덕수고등학교,교육부 서울특별시교육청 덕수고등학교,50,49,1,49,9,40,0,0
교육기관,교육부,덕수고등학교(일반고),교육부 서울특별시교육청 덕수고등학교(일반고),63,63,0,63,0,63,0,0
교육기관,교육부,덕일전자공업고등학교,교육부 서울특별시교육청 덕일전자공업고등학교,34,34,0,34,34,0,0,0
교육기관,교육부,도봉고등학교,교육부 서울특별시교육청 도봉고등학교,30,30,0,30,0,30,0,0
교육기관,교육부,도봉도서관,교육부 서울특별시교육청 도봉도서관,18,18,0,18,4,11,3,0
교육기관,교육부,도선고등학교,교육부 서울특별시교육청 도선고등학교,49,49,0,49,0,49,0,0
교육기관,교육부,독산고등학교,교육부 서울특별시교육청 독산고등학교,53,53,0,53,40,13,0,0
교육기관,교육부,동구마케팅고등학교,교육부 서울특별시교육청 동구마케팅고등학교,14,14,0,14,0,14,0,0
교육기관,교육부,동국대학교사범대학부속여자고등학교,교육부 서울특별시교육청 동국대학교사범대학부속여자고등학교,30,30,0,30,0,30,0,0
교육기관,교육부,동대문도서관,교육부 서울특별시교육청 동대문도서관,19,19,0,19,19,0,0,0
교육기관,교육부,동명생활경영고등학교,교육부 서울특별시교육청 동명생활경영고등학교,14,14,0,14,1,13,0,0
교육기관,교육부,동명여자고등학교,교육부 서울특별시교육청 동명여자고등학교,41,41,0,41,41,0,0,0
교육기관,교육부,동성고등학교,교육부 서울특별시교육청 동성고등학교,66,66,0,66,66,0,0,0
교육기관,교육부,동일여자고등학교,교육부 서울특별시교육청 동일여자고등학교,80,80,0,80,41,39,0,0
교육기관,교육부,동작고등학교,교육부 서울특별시교육청 동작고등학교,43,43,0,43,43,0,0,0
교육기관,교육부,동작도서관,교육부 서울특별시교육청 동작도서관,42,42,0,42,36,6,0,0
교육기관,교육부,둔촌고등학교,교육부 서울특별시교육청 둔촌고등학교,71,71,0,71,71,0,0,0
교육기관,교육부,리라아트고등학교,교육부 서울특별시교육청 리라아트고등학교,31,31,0,31,0,31,0,0
교육기관,교육부,마포평생학습관,교육부 서울특별시교육청 마포평생학습관,32,32,0,32,0,32,0,0
교육기관,교육부,면목고등학교,교육부 서울특별시교육청 면목고등학교,66,66,0,66,12,54,0,0
교육기관,교육부,명일여자고등학교,교육부 서울특별시교육청 명일여자고등학교,20,12,8,12,12,0,0,0
교육기관,교육부,명지고등학교,교육부 서울특별시교육청 명지고등학교,43,43,0,43,0,43,0,0
교육기관,교육부,문정고등학교,교육부 서울특별시교육청 문정고등학교,62,61,1,61,61,0,0,0
교육기관,교육부,문현고등학교,교육부 서울특별시교육청 문현고등학교,86,86,0,86,20,66,0,0
교육기관,교육부,미래산업과학고등학교,교육부 서울특별시교육청 미래산업과학고등학교,27,27,0,27,7,20,0,0
교육기관,교육부,미림여자고등학교,교육부 서울특별시교육청 미림여자고등학교,24,24,0,24,24,0,0,0
교육기관,교육부,미림여자정보과학고등학교,교육부 서울특별시교육청 미림여자정보과학고등학교,34,34,0,34,34,0,0,0
교육기관,교육부,밀알학교,교육부 서울특별시교육청 밀알학교,69,69,0,69,17,52,0,0
교육기관,교육부,방산고등학교,교육부 서울특별시교육청 방산고등학교,30,30,0,30,21,9,0,0
교육기관,교육부,배명고등학교,교육부 서울특별시교육청 배명고등학교,141,141,0,141,0,141,0,0
교육기관,교육부,배문고등학교,교육부 서울특별시교육청 배문고등학교,32,32,0,32,0,32,0,0
교육기관,교육부,배재고등학교,교육부 서울특별시교육청 배재고등학교,160,158,2,158,2,156,0,0
교육기관,교육부,배화여자고등학교,교육부 서울특별시교육청 배화여자고등학교,63,63,0,63,63,0,0,0
교육기관,교육부,보성고등학교,교육부 서울특별시교육청 보성고등학교,52,52,0,52,31,21,0,0
교육기관,교육부,보성여자고등학교,교육부 서울특별시교육청 보성여자고등학교,25,25,0,25,25,0,0,0
교육기관,교육부,보인고등학교,교육부 서울특별시교육청 보인고등학교,96,96,0,96,96,0,0,0
교육기관,교육부,불암고등학교,교육부 서울특별시교육청 불암고등학교,50,50,0,50,50,0,0,0
교육기관,교육부,삼각산고등학교,교육부 서울특별시교육청 삼각산고등학교,65,65,0,65,20,45,0,0
교육기관,교육부,상계고등학교,교육부 서울특별시교육청 상계고등학교,58,58,0,58,19,39,0,0
교육기관,교육부,상명고등학교,교육부 서울특별시교육청 상명고등학교,64,64,0,64,0,64,0,0
교육기관,교육부,상명대학교사범대학부속여자고등학교,교육부 서울특별시교육청 상명대학교사범대학부속여자고등학교,23,23,0,23,23,0,0,0
교육기관,교육부,상문고등학교,교육부 서울특별시교육청 상문고등학교,40,22,18,22,0,22,0,0
교육기관,교육부,상암고등학교,교육부 서울특별시교육청 상암고등학교,48,48,0,48,3,45,0,0
교육기관,교육부,상일미디어고등학교,교육부 서울특별시교육청 상일미디어고등학교,29,29,0,29,16,13,0,0
교육기관,교육부,상일여자고등학교,교육부 서울특별시교육청 상일여자고등학교,23,23,0,23,19,2,1,1
교육기관,교육부,서대문도서관,교육부 서울특별시교육청 서대문도서관,16,16,0,16,6,10,0,0
교육기관,교육부,서라벌고등학교,교육부 서울특별시교육청 서라벌고등학교,38,38,0,38,11,27,0,0
교육기관,교육부,서문여자고등학교,교육부 서울특별시교육청 서문여자고등학교,17,17,0,17,0,17,0,0
교육기관,교육부,서울경운학교,교육부 서울특별시교육청 서울경운학교,8,8,0,8,8,0,0,0
교육기관,교육부,서울고등학교,교육부 서울특별시교육청 서울고등학교,87,87,0,87,14,73,0,0
교육기관,교육부,서울공업고등학교,교육부 서울특별시교육청 서울공업고등학교,110,55,55,55,7,39,9,0
교육기관,교육부,서울과학고등학교,교육부 서울특별시교육청 서울과학고등학교,79,23,56,23,0,23,0,0
교육기관,교육부,서울관광고등학교,교육부 서울특별시교육청 서울관광고등학교,25,25,0,25,11,14,0,0
교육기관,교육부,서울광진학교,교육부 서울특별시교육청 서울광진학교,46,9,37,9,0,9,0,0
교육기관,교육부,서울국제고등학교,교육부 서울특별시교육청 서울국제고등학교,65,65,0,65,0,65,0,0
교육기관,교육부,서울나래학교,교육부 서울특별시교육청 서울나래학교,84,84,0,84,22,62,0,0
교육기관,교육부,서울다솜관광고등학교,교육부 서울특별시교육청 서울다솜관광고등학교,32,32,0,32,0,32,0,0
교육기관,교육부,서울다원학교,교육부 서울특별시교육청 서울다원학교,35,35,0,35,0,35,0,0
교육기관,교육부,서울도솔학교,교육부 서울특별시교육청 서울도솔학교,28,28,0,28,2,26,0,0
교육기관,교육부,서울동산고등학교,교육부 서울특별시교육청 서울동산고등학교,50,50,0,50,24,26,0,0
교육기관,교육부,서울동천학교,교육부 서울특별시교육청 서울동천학교,34,34,0,34,0,34,0,0
교육기관,교육부,서울디자인고등학교,교육부 서울특별시교육청 서울디자인고등학교,45,43,2,43,10,31,1,1
교육기관,교육부,서울디지텍고등학교,교육부 서울특별시교육청 서울디지텍고등학교,26,26,0,26,26,0,0,0
교육기관,교육부,서울로봇고등학교,교육부 서울특별시교육청 서울로봇고등학교,90,90,0,90,88,2,0,0
교육기관,교육부,서울매그넷고등학교,교육부 서울특별시교육청 서울매그넷고등학교,47,47,0,47,15,32,0,0
교육기관,교육부,서울맹학교,교육부 서울특별시교육청 서울맹학교,74,74,0,74,0,74,0,0
교육기관,교육부,서울문화고등학교,교육부 서울특별시교육청 서울문화고등학교,37,37,0,37,18,19,0,0
교육기관,교육부,서울미술고등학교,교육부 서울특별시교육청 서울미술고등학교,23,23,0,23,0,23,0,0
교육기관,교육부,서울방송고등학교,교육부 서울특별시교육청 서울방송고등학교,42,42,0,42,26,16,0,0
교육기관,교육부,서울산업정보학교,교육부 서울특별시교육청 서울산업정보학교,36,36,0,36,36,0,0,0
교육기관,교육부,서울삼성학교,교육부 서울특별시교육청 서울삼성학교,20,20,0,20,4,16,0,0
교육기관,교육부,서울새롬학교,교육부 서울특별시교육청 서울새롬학교,16,16,0,16,16,0,0,0
교육기관,교육부,서울세종고등학교,교육부 서울특별시교육청 서울세종고등학교,51,51,0,51,0,51,0,0
교육기관,교육부,서울아이티고등학교,교육부 서울특별시교육청 서울아이티고등학교,39,38,1,38,0,38,0,0
교육기관,교육부,서울애화학교,교육부 서울특별시교육청 서울애화학교,9,9,0,9,3,6,0,0
교육기관,교육부,서울여자고등학교,교육부 서울특별시교육청 서울여자고등학교,36,36,0,36,0,36,0,0
교육기관,교육부,서울여자상업고등학교,교육부 서울특별시교육청 서울여자상업고등학교,33,33,0,33,33,0,0,0
교육기관,교육부,서울영등포초등학교병설유치원,교육부 서울특별시교육청 서울영등포초등학교병설유치원,1,1,0,1,1,0,0,0
교육기관,교육부,서울예술고등학교,교육부 서울특별시교육청 서울예술고등학교,85,85,0,85,13,72,0,0
교육기관,교육부,서울외국어고등학교,교육부 서울특별시교육청 서울외국어고등학교,32,32,0,32,0,32,0,0
교육기관,교육부,서울의료보건고등학교,교육부 서울특별시교육청 서울의료보건고등학교,13,13,0,13,6,7,0,0
교육기관,교육부,서울전자고등학교,교육부 서울특별시교육청 서울전자고등학교,39,39,0,39,5,34,0,0
교육기관,교육부,서울정문학교,교육부 서울특별시교육청 서울정문학교,22,22,0,22,20,2,0,0
교육기관,교육부,서울정민학교,교육부 서울특별시교육청 서울정민학교,29,29,0,29,0,29,0,0
교육기관,교육부,서울정애학교,교육부 서울특별시교육청 서울정애학교,24,24,0,24,0,24,0,0
교육기관,교육부,서울정인학교,교육부 서울특별시교육청 서울정인학교,14,14,0,14,14,0,0,0
교육기관,교육부,서울정진학교,교육부 서울특별시교육청 서울정진학교,19,19,0,19,0,19,0,0
교육기관,교육부,서울컨벤션고등학교,교육부 서울특별시교육청 서울컨벤션고등학교,45,45,0,45,10,35,0,0
교육기관,교육부,서울특별시강남서초교육지원청,교육부 서울특별시교육청 서울특별시강남서초교육지원청,20,20,0,20,0,20,0,0
교육기관,교육부,개원중학교,교육부 서울특별시교육청 서울특별시강남서초교육지원청 개원중학교,46,46,0,46,30,11,3,2
교육기관,교육부,계성초등학교,교육부 서울특별시교육청 서울특별시강남서초교육지원청 계성초등학교,107,107,0,107,4,103,0,0
교육기관,교육부,구룡유치원,교육부 서울특별시교육청 서울특별시강남서초교육지원청 구룡유치원,16,16,0,16,0,16,0,0
교육기관,교육부,구룡중학교,교육부 서울특별시교육청 서울특별시강남서초교육지원청 구룡중학교,43,43,0,43,0,43,0,0
교육기관,교육부,남부유치원,교육부 서울특별시교육청 서울특별시강남서초교육지원청 남부유치원,8,1,7,1,0,1,0,0
교육기관,교육부,내곡중학교,교육부 서울특별시교육청 서울특별시강남서초교육지원청 내곡중학교,41,41,0,41,41,0,0,0
교육기관,교육부,대명중학교,교육부 서울특별시교육청 서울특별시강남서초교육지원청 대명중학교,40,40,0,40,23,17,0,0
교육기관,교육부,대왕중학교,교육부 서울특별시교육청 서울특별시강남서초교육지원청 대왕중학교,30,30,0,30,26,4,0,0
교육기관,교육부,대청중학교,교육부 서울특별시교육청 서울특별시강남서초교육지원청 대청중학교,75,75,0,75,0,75,0,0
교육기관,교육부,도곡중학교,교육부 서울특별시교육청 서울특별시강남서초교육지원청 도곡중학교,48,48,0,48,14,34,0,0
교육기관,교육부,돌샘유치원,교육부 서울특별시교육청 서울특별시강남서초교육지원청 돌샘유치원,16,16,0,16,7,7,1,1
교육기관,교육부,동화유치원,교육부 서울특별시교육청 서울특별시강남서초교육지원청 동화유치원,6,6,0,6,1,5,0,0
교육기관,교육부,반디유치원,교육부 서울특별시교육청 서울특별시강남서초교육지원청 반디유치원,14,14,0,14,0,14,0,0
교육기관,교육부,반포자이유치원,교육부 서울특별시교육청 서울특별시강남서초교육지원청 반포자이유치원,17,17,0,17,0,17,0,0
교육기관,교육부,반포중학교,교육부 서울특별시교육청 서울특별시강남서초교육지원청 반포중학교,81,81,0,81,0,81,0,0
교육기관,교육부,방배중학교,교육부 서울특별시교육청 서울특별시강남서초교육지원청 방배중학교,33,33,0,33,2,27,4,0
교육기관,교육부,봉은중학교,교육부 서울특별시교육청 서울특별시강남서초교육지원청 봉은중학교,30,30,0,30,11,19,0,0
교육기관,교육부,서문여자중학교,교육부 서울특별시교육청 서울특별시강남서초교육지원청 서문여자중학교,36,36,0,36,29,7,0,0
교육기관,교육부,서운중학교,교육부 서울특별시교육청 서울특별시강남서초교육지원청 서운중학교,51,51,0,51,0,51,0,0
교육기관,교육부,서울개일초등학교,교육부 서울특별시교육청 서울특별시강남서초교육지원청 서울개일초등학교,19,19,0,19,0,19,0,0
교육기관,교육부,서울교육대학교부설초등학교,교육부 서울특별시교육청 서울특별시강남서초교육지원청 서울교육대학교부설초등학교,36,36,0,36,36,0,0,0
교육기관,교육부,서울구룡초등학교,교육부 서울특별시교육청 서울특별시강남서초교육지원청 서울구룡초등학교,30,30,0,30,30,0,0,0
교육기관,교육부,서울논현초등학교,교육부 서울특별시교육청 서울특별시강남서초교육지원청 서울논현초등학교,26,26,0,26,26,0,0,0
교육기관,교육부,서울논현초등학교병설유치원,교육부 서울특별시교육청 서울특별시강남서초교육지원청 서울논현초등학교병설유치원,9,0,9,0,0,0,0,0
교육기관,교육부,서울대곡초등학교,교육부 서울특별시교육청 서울특별시강남서초교육지원청 서울대곡초등학교,28,28,0,28,28,0,0,0
교육기관,교육부,서울대모초등학교,교육부 서울특별시교육청 서울특별시강남서초교육지원청 서울대모초등학교,25,25,0,25,0,25,0,0
교육기관,교육부,서울대왕초등학교,교육부 서울특별시교육청 서울특별시강남서초교육지원청 서울대왕초등학교,21,21,0,21,0,21,0,0
교육기관,교육부,서울대진초등학교,교육부 서울특별시교육청 서울특별시강남서초교육지원청 서울대진초등학교,25,25,0,25,25,0,0,0
교육기관,교육부,서울대청초등학교,교육부 서울특별시교육청 서울특별시강남서초교육지원청 서울대청초등학교,20,20,0,20,0,20,0,0
교육기관,교육부,서울대치초등학교,교육부 서울특별시교육청 서울특별시강남서초교육지원청 서울대치초등학교,20,20,0,20,10,10,0,0
교육기관,교육부,서울대현초등학교,교육부 서울특별시교육청 서울특별시강남서초교육지원청 서울대현초등학교,33,33,0,33,0,33,0,0
교육기관,교육부,서울대현초등학교병설유치원,교육부 서울특별시교육청 서울특별시강남서초교육지원청 서울대현초등학교병설유치원,33,33,0,33,0,33,0,0
교육기관,교육부,서울도곡초등학교,교육부 서울특별시교육청 서울특별시강남서초교육지원청 서울도곡초등학교,72,72,0,72,0,72,0,0
교육기관,교육부,서울도성초등학교,교육부 서울특별시교육청 서울특별시강남서초교육지원청 서울도성초등학교,23,23,0,23,0,23,0,0
교육기관,교육부,서울반원초등학교,교육부 서울특별시교육청 서울특별시강남서초교육지원청 서울반원초등학교,18,18,0,18,0,18,0,0
교육기관,교육부,서울방배초등학교,교육부 서울특별시교육청 서울특별시강남서초교육지원청 서울방배초등학교,24,24,0,24,6,18,0,0
교육기관,교육부,서울방배초등학교병설유치원,교육부 서울특별시교육청 서울특별시강남서초교육지원청 서울방배초등학교병설유치원,9,9,0,9,3,6,0,0
교육기관,교육부,서울방일초등학교,교육부 서울특별시교육청 서울특별시강남서초교육지원청 서울방일초등학교,23,23,0,23,0,23,0,0
교육기관,교육부,서울봉은초등학교,교육부 서울특별시교육청 서울특별시강남서초교육지원청 서울봉은초등학교,23,23,0,23,13,10,0,0
교육기관,교육부,서울삼릉초등학교,교육부 서울특별시교육청 서울특별시강남서초교육지원청 서울삼릉초등학교,14,14,0,14,14,0,0,0
교육기관,교육부,서울서래초등학교,교육부 서울특별시교육청 서울특별시강남서초교육지원청 서울서래초등학교,38,38,0,38,38,0,0,0
교육기관,교육부,서울서래초등학교병설유치원,교육부 서울특별시교육청 서울특별시강남서초교육지원청 서울서래초등학교병설유치원,4,4,0,4,1,1,2,0
교육기관,교육부,서울서이초등학교,교육부 서울특별시교육청 서울특별시강남서초교육지원청 서울서이초등학교,18,18,0,18,16,2,0,0
교육기관,교육부,서울서일초등학교,교육부 서울특별시교육청 서울특별시강남서초교육지원청 서울서일초등학교,20,20,0,20,20,0,0,0
교육기관,교육부,서울서초초등학교,교육부 서울특별시교육청 서울특별시강남서초교육지원청 서울서초초등학교,7,7,0,7,7,0,0,0
교육기관,교육부,서울세명유치원,교육부 서울특별시교육청 서울특별시강남서초교육지원청 서울세명유치원,13,6,7,6,2,4,0,0
교육기관,교육부,서울수서초등학교,교육부 서울특별시교육청 서울특별시강남서초교육지원청 서울수서초등학교,20,20,0,20,15,5,0,0
교육기관,교육부,서울신구유치원,교육부 서울특별시교육청 서울특별시강남서초교육지원청 서울신구유치원,5,5,0,5,0,5,0,0
교육기관,교육부,서울신구초등학교,교육부 서울특별시교육청 서울특별시강남서초교육지원청 서울신구초등학교,26,26,0,26,0,26,0,0
교육기관,교육부,서울신동초등학교,교육부 서울특별시교육청 서울특별시강남서초교육지원청 서울신동초등학교,22,22,0,22,10,12,0,0
교육기관,교육부,서울신중초등학교,교육부 서울특별시교육청 서울특별시강남서초교육지원청 서울신중초등학교,20,20,0,20,20,0,0,0
교육기관,교육부,서울압구정초등학교,교육부 서울특별시교육청 서울특별시강남서초교육지원청 서울압구정초등학교,47,47,0,47,0,47,0,0
교육기관,교육부,서울양재유치원,교육부 서울특별시교육청 서울특별시강남서초교육지원청 서울양재유치원,16,0,16,0,0,0,0,0
교육기관,교육부,서울양재초등학교,교육부 서울특별시교육청 서울특별시강남서초교육지원청 서울양재초등학교,31,31,0,31,25,6,0,0
교육기관,교육부,서울양전초등학교,교육부 서울특별시교육청 서울특별시강남서초교육지원청 서울양전초등학교,20,20,0,20,0,20,0,0
교육기관,교육부,서울어진유치원,교육부 서울특별시교육청 서울특별시강남서초교육지원청 서울어진유치원,25,6,19,6,0,6,0,0
교육기관,교육부,서울언남초등학교,교육부 서울특별시교육청 서울특별시강남서초교육지원청 서울언남초등학교,37,37,0,37,4,33,0,0
교육기관,교육부,서울언남초등학교병설유치원,교육부 서울특별시교육청 서울특별시강남서초교육지원청 서울언남초등학교병설유치원,12,12,0,12,0,12,0,0
교육기관,교육부,서울언북초등학교,교육부 서울특별시교육청 서울특별시강남서초교육지원청 서울언북초등학교,30,30,0,30,0,30,0,0
교육기관,교육부,서울언주초등학교,교육부 서울특별시교육청 서울특별시강남서초교육지원청 서울언주초등학교,33,33,0,33,31,2,0,0
교육기관,교육부,서울언주초등학교병설유치원,교육부 서울특별시교육청 서울특별시강남서초교육지원청 서울언주초등학교병설유치원,9,2,7,2,0,2,0,0
교육기관,교육부,서울역삼초등학교,교육부 서울특별시교육청 서울특별시강남서초교육지원청 서울역삼초등학교,39,39,0,39,16,23,0,0
교육기관,교육부,서울영희초등학교,교육부 서울특별시교육청 서울특별시강남서초교육지원청 서울영희초등학교,28,28,0,28,19,7,2,0
교육기관,교육부,서울영희초등학교병설유치원,교육부 서울특별시교육청 서울특별시강남서초교육지원청 서울영희초등학교병설유치원,16,9,7,9,2,7,0,0
교육기관,교육부,서울왕북초등학교,교육부 서울특별시교육청 서울특별시강남서초교육지원청 서울왕북초등학교,22,22,0,22,15,7,0,0
교육기관,교육부,서울우면초등학교,교육부 서울특별시교육청 서울특별시강남서초교육지원청 서울우면초등학교,25,25,0,25,25,0,0,0
교육기관,교육부,서울우솔초등학교,교육부 서울특별시교육청 서울특별시강남서초교육지원청 서울우솔초등학교,35,35,0,35,35,0,0,0
교육기관,교육부,서울우암초등학교,교육부 서울특별시교육청 서울특별시강남서초교육지원청 서울우암초등학교,33,33,0,33,0,33,0,0
교육기관,교육부,서울우암초등학교병설유치원,교육부 서울특별시교육청 서울특별시강남서초교육지원청 서울우암초등학교병설유치원,4,4,0,4,2,2,0,0
교육기관,교육부,서울원명초등학교,교육부 서울특별시교육청 서울특별시강남서초교육지원청 서울원명초등학교,20,20,0,20,0,20,0,0
교육기관,교육부,서울원명초등학교병설유치원,교육부 서울특별시교육청 서울특별시강남서초교육지원청 서울원명초등학교병설유치원,8,8,0,8,8,0,0,0
교육기관,교육부,서울원촌초등학교,교육부 서울특별시교육청 서울특별시강남서초교육지원청 서울원촌초등학교,29,29,0,29,26,3,0,0
교육기관,교육부,서울율현초등학교,교육부 서울특별시교육청 서울특별시강남서초교육지원청 서울율현초등학교,40,38,2,38,38,0,0,0
교육기관,교육부,서울은곡유치원,교육부 서울특별시교육청 서울특별시강남서초교육지원청 서울은곡유치원,22,4,18,4,0,4,0,0
교육기관,교육부,서울이수초등학교,교육부 서울특별시교육청 서울특별시강남서초교육지원청 서울이수초등학교,13,13,0,13,7,6,0,0
교육기관,교육부,서울일원초등학교,교육부 서울특별시교육청 서울특별시강남서초교육지원청 서울일원초등학교,14,14,0,14,0,14,0,0
교육기관,교육부,서울자곡초등학교,교육부 서울특별시교육청 서울특별시강남서초교육지원청 서울자곡초등학교,25,25,0,25,25,0,0,0
교육기관,교육부,서울잠원초등학교,교육부 서울특별시교육청 서울특별시강남서초교육지원청 서울잠원초등학교,24,24,0,24,0,24,0,0
교육기관,교육부,서울청계숲유치원,교육부 서울특별시교육청 서울특별시강남서초교육지원청 서울청계숲유치원,31,31,0,31,0,31,0,0
교육기관,교육부,서울청담초등학교,교육부 서울특별시교육청 서울특별시강남서초교육지원청 서울청담초등학교,33,33,0,33,12,21,0,0
교육기관,교육부,서울포이초등학교,교육부 서울특별시교육청 서울특별시강남서초교육지원청 서울포이초등학교,34,34,0,34,0,34,0,0
교육기관,교육부,서울학동초등학교병설유치원,교육부 서울특별시교육청 서울특별시강남서초교육지원청 서울학동초등학교병설유치원,12,12,0,12,7,5,0,0
교육기관,교육부,서일중학교,교육부 서울특별시교육청 서울특별시강남서초교육지원청 서일중학교,66,66,0,66,66,0,0,0
교육기관,교육부,서초유치원,교육부 서울특별시교육청 서울특별시강남서초교육지원청 서초유치원,16,16,0,16,0,16,0,0
교육기관,교육부,서초중학교,교육부 서울특별시교육청 서울특별시강남서초교육지원청 서초중학교,64,64,0,64,0,64,0,0
교육기관,교육부,석문유치원,교육부 서울특별시교육청 서울특별시강남서초교육지원청 석문유치원,13,3,10,3,0,3,0,0
교육기관,교육부,선경유치원,교육부 서울특별시교육청 서울특별시강남서초교육지원청 선경유치원,8,2,6,2,0,2,0,0
교육기관,교육부,세곡중학교,교육부 서울특별시교육청 서울특별시강남서초교육지원청 세곡중학교,55,55,0,55,41,14,0,0
교육기관,교육부,세화여자중학교,교육부 서울특별시교육청 서울특별시강남서초교육지원청 세화여자중학교,32,32,0,32,32,0,0,0
교육기관,교육부,소망유치원,교육부 서울특별시교육청 서울특별시강남서초교육지원청 소망유치원,0,0,0,0,0,0,0,0
교육기관,교육부,수서중학교,교육부 서울특별시교육청 서울특별시강남서초교육지원청 수서중학교,25,13,12,13,2,9,1,1
교육기관,교육부,신구중학교,교육부 서울특별시교육청 서울특별시강남서초교육지원청 신구중학교,41,41,0,41,41,0,0,0
교육기관,교육부,신동중학교,교육부 서울특별시교육청 서울특별시강남서초교육지원청 신동중학교,64,22,42,22,10,10,1,1
교육기관,교육부,신반포중학교,교육부 서울특별시교육청 서울특별시강남서초교육지원청 신반포중학교,65,65,0,65,32,33,0,0
교육기관,교육부,신아유치원,교육부 서울특별시교육청 서울특별시강남서초교육지원청 신아유치원,13,13,0,13,0,13,0,0
교육기관,교육부,언남중학교,교육부 서울특별시교육청 서울특별시강남서초교육지원청 언남중학교,48,48,0,48,48,0,0,0
교육기관,교육부,언북중학교,교육부 서울특별시교육청 서울특별시강남서초교육지원청 언북중학교,51,51,0,51,0,51,0,0
교육기관,교육부,언주중학교,교육부 서울특별시교육청 서울특별시강남서초교육지원청 언주중학교,93,93,0,93,53,40,0,0
교육기관,교육부,역삼중학교,교육부 서울특별시교육청 서울특별시강남서초교육지원청 역삼중학교,40,40,0,40,29,11,0,0
교육기관,교육부,영동제일유치원,교육부 서울특별시교육청 서울특별시강남서초교육지원청 영동제일유치원,7,6,1,6,1,5,0,0
교육기관,교육부,영생유치원,교육부 서울특별시교육청 서울특별시강남서초교육지원청 영생유치원,10,10,0,10,10,0,0,0
교육기관,교육부,오즈의마법사유치원,교육부 서울특별시교육청 서울특별시강남서초교육지원청 오즈의마법사유치원,20,0,20,0,0,0,0,0
교육기관,교육부,우정유치원,교육부 서울특별시교육청 서울특별시강남서초교육지원청 우정유치원,18,18,0,18,2,16,0,0
교육기관,교육부,원촌중학교,교육부 서울특별시교육청 서울특별시강남서초교육지원청 원촌중학교,46,46,0,46,0,46,0,0
교육기관,교육부,은성중학교,교육부 서울특별시교육청 서울특별시강남서초교육지원청 은성중학교,26,26,0,26,0,19,7,0
교육기관,교육부,이수중학교,교육부 서울특별시교육청 서울특별시강남서초교육지원청 이수중학교,37,37,0,37,0,37,0,0
교육기관,교육부,이화유치원,교육부 서울특별시교육청 서울특별시강남서초교육지원청 이화유치원,16,6,10,6,2,2,1,1
교육기관,교육부,중동중학교,교육부 서울특별시교육청 서울특별시강남서초교육지원청 중동중학교,50,49,1,49,41,5,3,0
교육기관,교육부,진선여자중학교,교육부 서울특별시교육청 서울특별시강남서초교육지원청 진선여자중학교,40,40,0,40,0,40,0,0
교육기관,교육부,청담몬테소리유치원,교육부 서울특별시교육청 서울특별시강남서초교육지원청 청담몬테소리유치원,41,6,35,6,2,2,1,1
교육기관,교육부,청담중학교,교육부 서울특별시교육청 서울특별시강남서초교육지원청 청담중학교,71,71,0,71,71,0,0,0
교육기관,교육부,초원유치원,교육부 서울특별시교육청 서울특별시강남서초교육지원청 초원유치원,10,0,10,0,0,0,0,0
교육기관,교육부,하나유치원,교육부 서울특별시교육청 서울특별시강남서초교육지원청 하나유치원,16,2,14,2,1,1,0,0
교육기관,교육부,한신유치원,교육부 서울특별시교육청 서울특별시강남서초교육지원청 한신유치원,11,11,0,11,11,0,0,0
교육기관,교육부,서울특별시강동송파교육지원청,교육부 서울특별시교육청 서울특별시강동송파교육지원청,13,13,0,13,0,13,0,0
교육기관,교육부,가락중학교,교육부 서울특별시교육청 서울특별시강동송파교육지원청 가락중학교,91,91,0,91,81,10,0,0
교육기관,교육부,가람유치원,교육부 서울특별시교육청 서울특별시강동송파교육지원청 가람유치원,13,13,0,13,13,0,0,0
교육기관,교육부,가원중학교,교육부 서울특별시교육청 서울특별시강동송파교육지원청 가원중학교,40,40,0,40,24,16,0,0
교육기관,교육부,강동중학교,교육부 서울특별시교육청 서울특별시강동송파교육지원청 강동중학교,59,59,0,59,45,14,0,0
교육기관,교육부,강명중학교,교육부 서울특별시교육청 서울특별시강동송파교육지원청 강명중학교,47,47,0,47,9,38,0,0
교육기관,교육부,강빛중학교,교육부 서울특별시교육청 서울특별시강동송파교육지원청 강빛중학교,119,116,3,116,0,116,0,0
교육기관,교육부,강일중학교,교육부 서울특별시교육청 서울특별시강동송파교육지원청 강일중학교,51,51,0,51,51,0,0,0
교육기관,교육부,거원중학교,교육부 서울특별시교육청 서울특별시강동송파교육지원청 거원중학교,56,56,0,56,0,56,0,0
교육기관,교육부,고덕유치원,교육부 서울특별시교육청 서울특별시강동송파교육지원청 고덕유치원,10,10,0,10,0,10,0,0
교육기관,교육부,구강사금강유치원,교육부 서울특별시교육청 서울특별시강동송파교육지원청 구강사금강유치원,16,16,0,16,0,16,0,0
교육기관,교육부,녹원유치원,교육부 서울특별시교육청 서울특별시강동송파교육지원청 녹원유치원,11,10,1,10,10,0,0,0
교육기관,교육부,동북중학교,교육부 서울특별시교육청 서울특별시강동송파교육지원청 동북중학교,33,33,0,33,33,0,0,0
교육기관,교육부,둔촌유치원,교육부 서울특별시교육청 서울특별시강동송파교육지원청 둔촌유치원,11,11,0,11,1,9,1,0
교육기관,교육부,둔촌중학교,교육부 서울특별시교육청 서울특별시강동송파교육지원청 둔촌중학교,46,46,0,46,40,6,0,0
교육기관,교육부,란키즈유치원,교육부 서울특별시교육청 서울특별시강동송파교육지원청 란키즈유치원,12,1,11,1,1,0,0,0
교육기관,교육부,리아유치원,교육부 서울특별시교육청 서울특별시강동송파교육지원청 리아유치원,23,23,0,23,7,16,0,0
교육기관,교육부,명일중학교,교육부 서울특별시교육청 서울특별시강동송파교육지원청 명일중학교,56,56,0,56,0,56,0,0
교육기관,교육부,문정중학교,교육부 서울특별시교육청 서울특별시강동송파교육지원청 문정중학교,46,46,0,46,46,0,0,0
교육기관,교육부,문현중학교,교육부 서울특별시교육청 서울특별시강동송파교육지원청 문현중학교,40,40,0,40,13,27,0,0
교육기관,교육부,반석유치원,교육부 서울특별시교육청 서울특별시강동송파교육지원청 반석유치원,13,2,11,2,1,1,0,0
교육기관,교육부,방산중학교,교육부 서울특별시교육청 서울특별시강동송파교육지원청 방산중학교,46,46,0,46,0,46,0,0
교육기관,교육부,방이중학교,교육부 서울특별시교육청 서울특별시강동송파교육지원청 방이중학교,49,49,0,49,44,5,0,0
교육기관,교육부,배명중학교,교육부 서울특별시교육청 서울특별시강동송파교육지원청 배명중학교,39,39,0,39,0,39,0,0
교육기관,교육부,배재중학교,교육부 서울특별시교육청 서울특별시강동송파교육지원청 배재중학교,28,28,0,28,4,24,0,0
교육기관,교육부,보성중학교,교육부 서울특별시교육청 서울특별시강동송파교육지원청 보성중학교,26,26,0,26,18,8,0,0
교육기관,교육부,보인중학교,교육부 서울특별시교육청 서울특별시강동송파교육지원청 보인중학교,27,27,0,27,27,0,0,0
교육기관,교육부,삼성유치원,교육부 서울특별시교육청 서울특별시강동송파교육지원청 삼성유치원,21,2,19,2,2,0,0,0
교육기관,교육부,상일중학교,교육부 서울특별시교육청 서울특별시강동송파교육지원청 상일중학교,21,20,1,20,4,16,0,0
교육기관,교육부,서울가동초등학교,교육부 서울특별시교육청 서울특별시강동송파교육지원청 서울가동초등학교,17,17,0,17,12,5,0,0
교육기관,교육부,서울가락초등학교,교육부 서울특별시교육청 서울특별시강동송파교육지원청 서울가락초등학교,33,33,0,33,0,33,0,0
교육기관,교육부,서울가원초등학교,교육부 서울특별시교육청 서울특별시강동송파교육지원청 서울가원초등학교,16,16,0,16,0,16,0,0
교육기관,교육부,서울가주초등학교,교육부 서울특별시교육청 서울특별시강동송파교육지원청 서울가주초등학교,16,16,0,16,16,0,0,0
교육기관,교육부,서울강덕초등학교,교육부 서울특별시교육청 서울특별시강동송파교육지원청 서울강덕초등학교,28,28,0,28,4,22,2,0
교육기관,교육부,서울강덕초등학교병설유치원,교육부 서울특별시교육청 서울특별시강동송파교육지원청 서울강덕초등학교병설유치원,12,12,0,12,5,7,0,0
교육기관,교육부,서울강동초등학교,교육부 서울특별시교육청 서울특별시강동송파교육지원청 서울강동초등학교,18,18,0,18,8,10,0,0
교육기관,교육부,서울강명초등학교,교육부 서울특별시교육청 서울특별시강동송파교육지원청 서울강명초등학교,27,27,0,27,1,26,0,0
교육기관,교육부,서울강빛초등학교,교육부 서울특별시교육청 서울특별시강동송파교육지원청 서울강빛초등학교,119,119,0,119,119,0,0,0
교육기관,교육부,서울강빛초등학교병설유치원,교육부 서울특별시교육청 서울특별시강동송파교육지원청 서울강빛초등학교병설유치원,22,0,22,0,0,0,0,0
교육기관,교육부,서울강솔유치원,교육부 서울특별시교육청 서울특별시강동송파교육지원청 서울강솔유치원,10,0,10,0,0,0,0,0
교육기관,교육부,서울강솔초등학교,교육부 서울특별시교육청 서울특별시강동송파교육지원청 서울강솔초등학교,25,25,0,25,20,5,0,0
교육기관,교육부,서울강일초등학교,교육부 서울특별시교육청 서울특별시강동송파교육지원청 서울강일초등학교,25,25,0,25,0,25,0,0
교육기관,교육부,서울개롱초등학교,교육부 서울특별시교육청 서울특별시강동송파교육지원청 서울개롱초등학교,17,17,0,17,17,0,0,0
교육기관,교육부,서울거여초등학교,교육부 서울특별시교육청 서울특별시강동송파교육지원청 서울거여초등학교,31,31,0,31,31,0,0,0
교육기관,교육부,서울거여초등학교병설유치원,교육부 서울특별시교육청 서울특별시강동송파교육지원청 서울거여초등학교병설유치원,4,4,0,4,0,4,0,0
교육기관,교육부,서울거원초등학교,교육부 서울특별시교육청 서울특별시강동송파교육지원청 서울거원초등학교,21,21,0,21,21,0,0,0
교육기관,교육부,서울거원초등학교병설유치원,교육부 서울특별시교육청 서울특별시강동송파교육지원청 서울거원초등학교병설유치원,6,6,0,6,4,2,0,0
교육기관,교육부,서울고덕초등학교,교육부 서울특별시교육청 서울특별시강동송파교육지원청 서울고덕초등학교,18,18,0,18,18,0,0,0
교육기관,교육부,서울고명초등학교병설유치원,교육부 서울특별시교육청 서울특별시강동송파교육지원청 서울고명초등학교병설유치원,4,4,0,4,4,0,0,0
교육기관,교육부,서울고일초등학교,교육부 서울특별시교육청 서울특별시강동송파교육지원청 서울고일초등학교,47,47,0,47,47,0,0,0
교육기관,교육부,서울고일초등학교병설유치원,교육부 서울특별시교육청 서울특별시강동송파교육지원청 서울고일초등학교병설유치원,7,7,0,7,0,7,0,0
교육기관,교육부,서울고현초등학교,교육부 서울특별시교육청 서울특별시강동송파교육지원청 서울고현초등학교,55,55,0,55,0,55,0,0
교육기관,교육부,서울길동초등학교,교육부 서울특별시교육청 서울특별시강동송파교육지원청 서울길동초등학교,26,26,0,26,7,16,2,1
교육기관,교육부,서울길동초등학교병설유치원,교육부 서울특별시교육청 서울특별시강동송파교육지원청 서울길동초등학교병설유치원,7,7,0,7,0,7,0,0
교육기관,교육부,서울남천초등학교,교육부 서울특별시교육청 서울특별시강동송파교육지원청 서울남천초등학교,18,18,0,18,8,10,0,0
교육기관,교육부,서울대명초등학교,교육부 서울특별시교육청 서울특별시강동송파교육지원청 서울대명초등학교,22,22,0,22,19,3,0,0
교육기관,교육부,서울마천초등학교,교육부 서울특별시교육청 서울특별시강동송파교육지원청 서울마천초등학교,13,13,0,13,0,13,0,0
교육기관,교육부,서울명덕초등학교,교육부 서울특별시교육청 서울특별시강동송파교육지원청 서울명덕초등학교,19,19,0,19,19,0,0,0
교육기관,교육부,서울명일유치원,교육부 서울특별시교육청 서울특별시강동송파교육지원청 서울명일유치원,9,0,9,0,0,0,0,0
교육기관,교육부,서울명일초등학교,교육부 서울특별시교육청 서울특별시강동송파교육지원청 서울명일초등학교,16,16,0,16,4,12,0,0
교육기관,교육부,서울묘곡초등학교,교육부 서울특별시교육청 서울특별시강동송파교육지원청 서울묘곡초등학교,30,30,0,30,5,25,0,0
교육기관,교육부,서울문덕초등학교,교육부 서울특별시교육청 서울특별시강동송파교육지원청 서울문덕초등학교,16,16,0,16,0,16,0,0
교육기관,교육부,서울문정초등학교,교육부 서울특별시교육청 서울특별시강동송파교육지원청 서울문정초등학교,16,16,0,16,0,16,0,0
교육기관,교육부,서울문현초등학교,교육부 서울특별시교육청 서울특별시강동송파교육지원청 서울문현초등학교,31,31,0,31,30,1,0,0
교육기관,교육부,서울방산초등학교,교육부 서울특별시교육청 서울특별시강동송파교육지원청 서울방산초등학교,32,32,0,32,32,0,0,0
교육기관,교육부,서울방이초등학교,교육부 서울특별시교육청 서울특별시강동송파교육지원청 서울방이초등학교,22,22,0,22,19,3,0,0
교육기관,교육부,서울방이초등학교병설유치원,교육부 서울특별시교육청 서울특별시강동송파교육지원청 서울방이초등학교병설유치원,5,0,5,0,0,0,0,0
교육기관,교육부,서울버들초등학교,교육부 서울특별시교육청 서울특별시강동송파교육지원청 서울버들초등학교,16,16,0,16,10,6,0,0
교육기관,교육부,서울삼전초등학교,교육부 서울특별시교육청 서울특별시강동송파교육지원청 서울삼전초등학교,16,16,0,16,14,2,0,0
교육기관,교육부,서울상일초등학교,교육부 서울특별시교육청 서울특별시강동송파교육지원청 서울상일초등학교,14,14,0,14,12,2,0,0
교육기관,교육부,서울석촌초등학교,교육부 서울특별시교육청 서울특별시강동송파교육지원청 서울석촌초등학교,22,22,0,22,21,1,0,0
교육기관,교육부,서울선린초등학교,교육부 서울특별시교육청 서울특별시강동송파교육지원청 서울선린초등학교,19,19,0,19,19,0,0,0
교육기관,교육부,서울선린초등학교병설유치원,교육부 서울특별시교육청 서울특별시강동송파교육지원청 서울선린초등학교병설유치원,4,0,4,0,0,0,0,0
교육기관,교육부,서울선사초등학교,교육부 서울특별시교육청 서울특별시강동송파교육지원청 서울선사초등학교,21,21,0,21,0,21,0,0
교육기관,교육부,서울성내초등학교,교육부 서울특별시교육청 서울특별시강동송파교육지원청 서울성내초등학교,19,19,0,19,16,3,0,0
교육기관,교육부,서울성일초등학교,교육부 서울특별시교육청 서울특별시강동송파교육지원청 서울성일초등학교,28,28,0,28,8,20,0,0
교육기관,교육부,서울세륜초등학교,교육부 서울특별시교육청 서울특별시강동송파교육지원청 서울세륜초등학교,27,27,0,27,12,13,1,1
교육기관,교육부,서울세륜초등학교병설유치원,교육부 서울특별시교육청 서울특별시강동송파교육지원청 서울세륜초등학교병설유치원,5,5,0,5,2,3,0,0
교육기관,교육부,서울솔가람유치원,교육부 서울특별시교육청 서울특별시강동송파교육지원청 서울솔가람유치원,20,20,0,20,0,20,0,0
교육기관,교육부,서울솔방울유치원,교육부 서울특별시교육청 서울특별시강동송파교육지원청 서울솔방울유치원,20,0,20,0,0,0,0,0
교육기관,교육부,서울송례초등학교,교육부 서울특별시교육청 서울특별시강동송파교육지원청 서울송례초등학교,24,24,0,24,4,20,0,0
교육기관,교육부,서울송전초등학교,교육부 서울특별시교육청 서울특별시강동송파교육지원청 서울송전초등학교,20,20,0,20,20,0,0,0
교육기관,교육부,서울송전초등학교병설유치원,교육부 서울특별시교육청 서울특별시강동송파교육지원청 서울송전초등학교병설유치원,4,1,3,1,1,0,0,0
교육기관,교육부,서울송파위례유치원,교육부 서울특별시교육청 서울특별시강동송파교육지원청 서울송파위례유치원,5,5,0,5,5,0,0,0
교육기관,교육부,서울송파초등학교,교육부 서울특별시교육청 서울특별시강동송파교육지원청 서울송파초등학교,22,22,0,22,2,20,0,0
교육기관,교육부,서울신가초등학교,교육부 서울특별시교육청 서울특별시강동송파교육지원청 서울신가초등학교,22,14,8,14,7,6,0,1
교육기관,교육부,서울신명초등학교,교육부 서울특별시교육청 서울특별시강동송파교육지원청 서울신명초등학교,16,16,0,16,15,1,0,0
교육기관,교육부,서울신암초등학교,교육부 서울특별시교육청 서울특별시강동송파교육지원청 서울신암초등학교,16,16,0,16,16,0,0,0
교육기관,교육부,서울신천초등학교,교육부 서울특별시교육청 서울특별시강동송파교육지원청 서울신천초등학교,12,12,0,12,12,0,0,0
교육기관,교육부,서울아주초등학교,교육부 서울특별시교육청 서울특별시강동송파교육지원청 서울아주초등학교,18,18,0,18,18,0,0,0
교육기관,교육부,서울아주초등학교병설유치원,교육부 서울특별시교육청 서울특별시강동송파교육지원청 서울아주초등학교병설유치원,2,0,2,0,0,0,0,0
교육기관,교육부,서울영풍초등학교,교육부 서울특별시교육청 서울특별시강동송파교육지원청 서울영풍초등학교,17,17,0,17,0,17,0,0
교육기관,교육부,서울영풍초등학교병설유치원,교육부 서울특별시교육청 서울특별시강동송파교육지원청 서울영풍초등학교병설유치원,7,7,0,7,1,6,0,0
교육기관,교육부,서울오금초등학교,교육부 서울특별시교육청 서울특별시강동송파교육지원청 서울오금초등학교,22,22,0,22,9,13,0,0
교육기관,교육부,서울오륜초등학교,교육부 서울특별시교육청 서울특별시강동송파교육지원청 서울오륜초등학교,14,14,0,14,12,2,0,0
교육기관,교육부,서울위례별유치원,교육부 서울특별시교육청 서울특별시강동송파교육지원청 서울위례별유치원,16,16,0,16,0,16,0,0
교육기관,교육부,서울위례별초등학교,교육부 서울특별시교육청 서울특별시강동송파교육지원청 서울위례별초등학교,31,31,0,31,0,31,0,0
교육기관,교육부,서울위례솔초등학교,교육부 서울특별시교육청 서울특별시강동송파교육지원청 서울위례솔초등학교,47,47,0,47,47,0,0,0
교육기관,교육부,서울잠동초등학교,교육부 서울특별시교육청 서울특별시강동송파교육지원청 서울잠동초등학교,9,2,7,2,2,0,0,0
교육기관,교육부,서울잠신초등학교,교육부 서울특별시교육청 서울특별시강동송파교육지원청 서울잠신초등학교,36,36,0,36,0,36,0,0
교육기관,교육부,서울잠실초등학교,교육부 서울특별시교육청 서울특별시강동송파교육지원청 서울잠실초등학교,13,13,0,13,13,0,0,0
교육기관,교육부,서울잠일초등학교병설유치원,교육부 서울특별시교육청 서울특별시강동송파교육지원청 서울잠일초등학교병설유치원,9,9,0,9,3,6,0,0
교육기관,교육부,서울잠전초등학교,교육부 서울특별시교육청 서울특별시강동송파교육지원청 서울잠전초등학교,18,18,0,18,0,18,0,0
교육기관,교육부,서울잠현초등학교,교육부 서울특별시교육청 서울특별시강동송파교육지원청 서울잠현초등학교,23,23,0,23,0,22,0,1
교육기관,교육부,서울중대초등학교,교육부 서울특별시교육청 서울특별시강동송파교육지원청 서울중대초등학교,18,18,0,18,18,0,0,0
교육기관,교육부,서울천동초등학교,교육부 서울특별시교육청 서울특별시강동송파교육지원청 서울천동초등학교,31,31,0,31,0,31,0,0
교육기관,교육부,서울토성초등학교,교육부 서울특별시교육청 서울특별시강동송파교육지원청 서울토성초등학교,21,21,0,21,15,6,0,0
교육기관,교육부,서울평화초등학교,교육부 서울특별시교육청 서울특별시강동송파교육지원청 서울평화초등학교,18,18,0,18,18,0,0,0
교육기관,교육부,서울평화초등학교병설유치원,교육부 서울특별시교육청 서울특별시강동송파교육지원청 서울평화초등학교병설유치원,3,3,0,3,2,1,0,0
교육기관,교육부,서울풍납초등학교,교육부 서울특별시교육청 서울특별시강동송파교육지원청 서울풍납초등학교,25,25,0,25,0,25,0,0
교육기관,교육부,서울풍성초등학교,교육부 서울특별시교육청 서울특별시강동송파교육지원청 서울풍성초등학교,15,15,0,15,3,11,1,0
교육기관,교육부,서울한산초등학교,교육부 서울특별시교육청 서울특별시강동송파교육지원청 서울한산초등학교,25,25,0,25,8,17,0,0
교육기관,교육부,서울해누리초등학교,교육부 서울특별시교육청 서울특별시강동송파교육지원청 서울해누리초등학교,11,11,0,11,3,3,2,3
교육기관,교육부,석촌유치원,교육부 서울특별시교육청 서울특별시강동송파교육지원청 석촌유치원,24,0,24,0,0,0,0,0
교육기관,교육부,석촌중학교,교육부 서울특별시교육청 서울특별시강동송파교육지원청 석촌중학교,25,8,17,8,4,4,0,0
교육기관,교육부,선아유치원,교육부 서울특별시교육청 서울특별시강동송파교육지원청 선아유치원,11,11,0,11,3,8,0,0
교육기관,교육부,성내중학교,교육부 서울특별시교육청 서울특별시강동송파교육지원청 성내중학교,28,28,0,28,0,28,0,0
교육기관,교육부,성보나유치원,교육부 서울특별시교육청 서울특별시강동송파교육지원청 성보나유치원,10,5,5,5,2,2,1,0
교육기관,교육부,세륜중학교,교육부 서울특별시교육청 서울특별시강동송파교육지원청 세륜중학교,65,65,0,65,64,1,0,0
교육기관,교육부,송례중학교,교육부 서울특별시교육청 서울특별시강동송파교육지원청 송례중학교,67,67,0,67,67,0,0,0
교육기관,교육부,수정유치원,교육부 서울특별시교육청 서울특별시강동송파교육지원청 수정유치원,16,16,0,16,14,0,2,0
교육기관,교육부,신명중학교,교육부 서울특별시교육청 서울특별시강동송파교육지원청 신명중학교,52,52,0,52,52,0,0,0
교육기관,교육부,신암중학교,교육부 서울특별시교육청 서울특별시강동송파교육지원청 신암중학교,61,61,0,61,42,19,0,0
교육기관,교육부,신천중학교,교육부 서울특별시교육청 서울특별시강동송파교육지원청 신천중학교,55,55,0,55,45,10,0,0
교육기관,교육부,아이코리아부속새세대유치원,교육부 서울특별시교육청 서울특별시강동송파교육지원청 아이코리아부속새세대유치원,24,0,24,0,0,0,0,0
교육기관,교육부,아주중학교,교육부 서울특별시교육청 서울특별시강동송파교육지원청 아주중학교,51,51,0,51,14,37,0,0
교육기관,교육부,영파여자중학교,교육부 서울특별시교육청 서울특별시강동송파교육지원청 영파여자중학교,10,10,0,10,1,9,0,0
교육기관,교육부,예은유치원,교육부 서울특별시교육청 서울특별시강동송파교육지원청 예은유치원,13,13,0,13,13,0,0,0
교육기관,교육부,오금중학교,교육부 서울특별시교육청 서울특별시강동송파교육지원청 오금중학교,43,43,0,43,5,31,5,2
교육기관,교육부,오륜중학교,교육부 서울특별시교육청 서울특별시강동송파교육지원청 오륜중학교,32,32,0,32,0,32,0,0
교육기관,교육부,오주중학교,교육부 서울특별시교육청 서울특별시강동송파교육지원청 오주중학교,56,56,0,56,0,56,0,0
교육기관,교육부,올림픽유치원,교육부 서울특별시교육청 서울특별시강동송파교육지원청 올림픽유치원,24,8,16,8,0,8,0,0
교육기관,교육부,위례솔중학교,교육부 서울특별시교육청 서울특별시강동송파교육지원청 위례솔중학교,53,53,0,53,34,19,0,0
교육기관,교육부,의명유치원,교육부 서울특별시교육청 서울특별시강동송파교육지원청 의명유치원,4,4,0,4,0,4,0,0
교육기관,교육부,일신여자중학교,교육부 서울특별시교육청 서울특별시강동송파교육지원청 일신여자중학교,23,23,0,23,19,4,0,0
교육기관,교육부,잠신중학교,교육부 서울특별시교육청 서울특별시강동송파교육지원청 잠신중학교,81,80,1,80,48,32,0,0
교육기관,교육부,잠실중학교,교육부 서울특별시교육청 서울특별시강동송파교육지원청 잠실중학교,68,68,0,68,52,16,0,0
교육기관,교육부,장미유치원,교육부 서울특별시교육청 서울특별시강동송파교육지원청 장미유치원,9,1,8,1,1,0,0,0
교육기관,교육부,정신여자중학교,교육부 서울특별시교육청 서울특별시강동송파교육지원청 정신여자중학교,37,37,0,37,5,32,0,0
교육기관,교육부,준현유치원,교육부 서울특별시교육청 서울특별시강동송파교육지원청 준현유치원,16,16,0,16,1,15,0,0
교육기관,교육부,천일중학교,교육부 서울특별시교육청 서울특별시강동송파교육지원청 천일중학교,26,26,0,26,20,4,1,1
교육기관,교육부,천호유치원,교육부 서울특별시교육청 서울특별시강동송파교육지원청 천호유치원,16,16,0,16,2,14,0,0
교육기관,교육부,천호중학교,교육부 서울특별시교육청 서울특별시강동송파교육지원청 천호중학교,66,66,0,66,36,28,1,1
교육기관,교육부,풍납중학교,교육부 서울특별시교육청 서울특별시강동송파교육지원청 풍납중학교,35,35,0,35,35,0,0,0
교육기관,교육부,풍성중학교,교육부 서울특별시교육청 서울특별시강동송파교육지원청 풍성중학교,52,0,52,0,0,0,0,0
교육기관,교육부,한산중학교,교육부 서울특별시교육청 서울특별시강동송파교육지원청 한산중학교,55,55,0,55,55,0,0,0
교육기관,교육부,한영중고등학교병설한영유치원,교육부 서울특별시교육청 서울특별시강동송파교육지원청 한영중고등학교병설한영유치원,25,25,0,25,16,9,0,0
교육기관,교육부,한영중학교,교육부 서울특별시교육청 서울특별시강동송파교육지원청 한영중학교,30,29,1,29,8,21,0,0
교육기관,교육부,해누리중학교,교육부 서울특별시교육청 서울특별시강동송파교육지원청 해누리중학교,31,31,0,31,1,30,0,0
교육기관,교육부,현대유치원,교육부 서울특별시교육청 서울특별시강동송파교육지원청 현대유치원,16,4,12,4,1,1,1,1
교육기관,교육부,서울특별시강서양천교육지원청,교육부 서울특별시교육청 서울특별시강서양천교육지원청,6,6,0,6,0,6,0,0
교육기관,교육부,경성유치원,교육부 서울특별시교육청 서울특별시강서양천교육지원청 경성유치원,15,15,0,15,0,15,0,0
교육기관,교육부,광영유치원,교육부 서울특별시교육청 서울특별시강서양천교육지원청 광영유치원,3,3,0,3,1,2,0,0
교육기관,교육부,등대유치원,교육부 서울특별시교육청 서울특별시강서양천교육지원청 등대유치원,4,4,0,4,0,4,0,0
교육기관,교육부,등촌제일유치원,교육부 서울특별시교육청 서울특별시강서양천교육지원청 등촌제일유치원,9,9,0,9,8,1,0,0
교육기관,교육부,등현유치원,교육부 서울특별시교육청 서울특별시강서양천교육지원청 등현유치원,15,1,14,1,0,1,0,0
교육기관,교육부,목성유치원,교육부 서울특별시교육청 서울특별시강서양천교육지원청 목성유치원,24,3,21,3,0,3,0,0
교육기관,교육부,미도유치원,교육부 서울특별시교육청 서울특별시강서양천교육지원청 미도유치원,8,0,8,0,0,0,0,0
교육기관,교육부,보라유치원,교육부 서울특별시교육청 서울특별시강서양천교육지원청 보라유치원,15,15,0,15,0,15,0,0
교육기관,교육부,서울가곡초등학교,교육부 서울특별시교육청 서울특별시강서양천교육지원청 서울가곡초등학교,19,19,0,19,13,6,0,0
교육기관,교육부,서울가양초등학교,교육부 서울특별시교육청 서울특별시강서양천교육지원청 서울가양초등학교,20,20,0,20,0,20,0,0
교육기관,교육부,서울갈산초등학교,교육부 서울특별시교육청 서울특별시강서양천교육지원청 서울갈산초등학교,12,12,0,12,0,12,0,0
교육기관,교육부,서울강서초등학교,교육부 서울특별시교육청 서울특별시강서양천교육지원청 서울강서초등학교,23,23,0,23,0,23,0,0
교육기관,교육부,서울강신초등학교,교육부 서울특별시교육청 서울특별시강서양천교육지원청 서울강신초등학교,23,23,0,23,23,0,0,0
교육기관,교육부,서울강신초등학교병설유치원,교육부 서울특별시교육청 서울특별시강서양천교육지원청 서울강신초등학교병설유치원,8,8,0,8,0,8,0,0
교육기관,교육부,서울강월초등학교,교육부 서울특별시교육청 서울특별시강서양천교육지원청 서울강월초등학교,19,19,0,19,19,0,0,0
교육기관,교육부,서울강월초등학교병설유치원,교육부 서울특별시교육청 서울특별시강서양천교육지원청 서울강월초등학교병설유치원,4,0,4,0,0,0,0,0
교육기관,교육부,서울개화초등학교,교육부 서울특별시교육청 서울특별시강서양천교육지원청 서울개화초등학교,14,14,0,14,14,0,0,0
교육기관,교육부,서울개화초등학교병설유치원,교육부 서울특별시교육청 서울특별시강서양천교육지원청 서울개화초등학교병설유치원,2,2,0,2,2,0,0,0
교육기관,교육부,서울경인유치원,교육부 서울특별시교육청 서울특별시강서양천교육지원청 서울경인유치원,15,15,0,15,9,6,0,0
교육기관,교육부,서울경인초등학교,교육부 서울특별시교육청 서울특별시강서양천교육지원청 서울경인초등학교,16,16,0,16,0,16,0,0
교육기관,교육부,서울계남초등학교,교육부 서울특별시교육청 서울특별시강서양천교육지원청 서울계남초등학교,18,18,0,18,0,18,0,0
교육기관,교육부,서울공진초등학교,교육부 서울특별시교육청 서울특별시강서양천교육지원청 서울공진초등학교,36,36,0,36,0,36,0,0
교육기관,교육부,서울공항초등학교,교육부 서울특별시교육청 서울특별시강서양천교육지원청 서울공항초등학교,28,28,0,28,19,9,0,0
교육기관,교육부,서울공항초등학교병설유치원,교육부 서울특별시교육청 서울특별시강서양천교육지원청 서울공항초등학교병설유치원,10,10,0,10,5,5,0,0
교육기관,교육부,서울남명초등학교,교육부 서울특별시교육청 서울특별시강서양천교육지원청 서울남명초등학교,14,14,0,14,14,0,0,0
교육기관,교육부,서울내발산초등학교,교육부 서울특별시교육청 서울특별시강서양천교육지원청 서울내발산초등학교,10,10,0,10,0,10,0,0
교육기관,교육부,서울내발산초등학교병설유치원,교육부 서울특별시교육청 서울특별시강서양천교육지원청 서울내발산초등학교병설유치원,4,4,0,4,0,4,0,0
교육기관,교육부,서울등마초등학교,교육부 서울특별시교육청 서울특별시강서양천교육지원청 서울등마초등학교,18,18,0,18,18,0,0,0
교육기관,교육부,서울등명초등학교,교육부 서울특별시교육청 서울특별시강서양천교육지원청 서울등명초등학교,13,13,0,13,13,0,0,0
교육기관,교육부,서울등명초등학교병설유치원,교육부 서울특별시교육청 서울특별시강서양천교육지원청 서울등명초등학교병설유치원,9,9,0,9,9,0,0,0
교육기관,교육부,서울등서초등학교,교육부 서울특별시교육청 서울특별시강서양천교육지원청 서울등서초등학교,20,20,0,20,20,0,0,0
교육기관,교육부,서울등양초등학교,교육부 서울특별시교육청 서울특별시강서양천교육지원청 서울등양초등학교,16,16,0,16,0,15,1,0
교육기관,교육부,서울등원초등학교,교육부 서울특별시교육청 서울특별시강서양천교육지원청 서울등원초등학교,16,16,0,16,8,7,1,0
교육기관,교육부,서울등촌초등학교,교육부 서울특별시교육청 서울특별시강서양천교육지원청 서울등촌초등학교,29,29,0,29,3,26,0,0
교육기관,교육부,서울등현초등학교,교육부 서울특별시교육청 서울특별시강서양천교육지원청 서울등현초등학교,15,15,0,15,15,0,0,0
교육기관,교육부,서울마곡유치원,교육부 서울특별시교육청 서울특별시강서양천교육지원청 서울마곡유치원,22,22,0,22,6,16,0,0
교육기관,교육부,서울목동초등학교,교육부 서울특별시교육청 서울특별시강서양천교육지원청 서울목동초등학교,11,11,0,11,11,0,0,0
교육기관,교육부,서울목운초등학교,교육부 서울특별시교육청 서울특별시강서양천교육지원청 서울목운초등학교,32,32,0,32,17,15,0,0
교육기관,교육부,서울목원초등학교,교육부 서울특별시교육청 서울특별시강서양천교육지원청 서울목원초등학교,13,13,0,13,9,4,0,0
교육기관,교육부,서울방화초등학교,교육부 서울특별시교육청 서울특별시강서양천교육지원청 서울방화초등학교,20,20,0,20,16,4,0,0
교육기관,교육부,서울백석초등학교,교육부 서울특별시교육청 서울특별시강서양천교육지원청 서울백석초등학교,15,15,0,15,15,0,0,0
교육기관,교육부,서울삼정초등학교,교육부 서울특별시교육청 서울특별시강서양천교육지원청 서울삼정초등학교,18,18,0,18,16,2,0,0
교육기관,교육부,서울서정초등학교,교육부 서울특별시교육청 서울특별시강서양천교육지원청 서울서정초등학교,17,17,0,17,0,17,0,0
교육기관,교육부,서울서정초등학교병설유치원,교육부 서울특별시교육청 서울특별시강서양천교육지원청 서울서정초등학교병설유치원,10,2,8,2,1,1,0,0
교육기관,교육부,서울송화초등학교,교육부 서울특별시교육청 서울특별시강서양천교육지원청 서울송화초등학교,11,11,0,11,11,0,0,0
교육기관,교육부,서울수명초등학교,교육부 서울특별시교육청 서울특별시강서양천교육지원청 서울수명초등학교,50,50,0,50,0,50,0,0
교육기관,교육부,서울신강초등학교,교육부 서울특별시교육청 서울특별시강서양천교육지원청 서울신강초등학교,14,14,0,14,0,14,0,0
교육기관,교육부,서울신곡초등학교,교육부 서울특별시교육청 서울특별시강서양천교육지원청 서울신곡초등학교,21,21,0,21,18,3,0,0
교육기관,교육부,서울신곡초등학교병설유치원,교육부 서울특별시교육청 서울특별시강서양천교육지원청 서울신곡초등학교병설유치원,6,6,0,6,0,6,0,0
교육기관,교육부,서울신기초등학교,교육부 서울특별시교육청 서울특별시강서양천교육지원청 서울신기초등학교,21,21,0,21,15,6,0,0
교육기관,교육부,서울신남초등학교,교육부 서울특별시교육청 서울특별시강서양천교육지원청 서울신남초등학교,16,16,0,16,11,5,0,0
교육기관,교육부,서울신목초등학교,교육부 서울특별시교육청 서울특별시강서양천교육지원청 서울신목초등학교,20,20,0,20,20,0,0,0
교육기관,교육부,서울신원초등학교,교육부 서울특별시교육청 서울특별시강서양천교육지원청 서울신원초등학교,24,24,0,24,24,0,0,0
교육기관,교육부,서울신월초등학교,교육부 서울특별시교육청 서울특별시강서양천교육지원청 서울신월초등학교,33,33,0,33,33,0,0,0
교육기관,교육부,서울신은초등학교,교육부 서울특별시교육청 서울특별시강서양천교육지원청 서울신은초등학교,16,16,0,16,16,0,0,0
교육기관,교육부,서울신정유치원,교육부 서울특별시교육청 서울특별시강서양천교육지원청 서울신정유치원,32,32,0,32,16,16,0,0
교육기관,교육부,서울양강초등학교,교육부 서울특별시교육청 서울특별시강서양천교육지원청 서울양강초등학교,22,22,0,22,0,22,0,0
교육기관,교육부,서울양동초등학교,교육부 서울특별시교육청 서울특별시강서양천교육지원청 서울양동초등학교,26,26,0,26,26,0,0,0
교육기관,교육부,서울양동초등학교병설유치원,교육부 서울특별시교육청 서울특별시강서양천교육지원청 서울양동초등학교병설유치원,10,0,10,0,0,0,0,0
교육기관,교육부,서울양명초등학교,교육부 서울특별시교육청 서울특별시강서양천교육지원청 서울양명초등학교,31,31,0,31,0,31,0,0
교육기관,교육부,서울양목초등학교,교육부 서울특별시교육청 서울특별시강서양천교육지원청 서울양목초등학교,41,41,0,41,41,0,0,0
교육기관,교육부,서울양원초등학교,교육부 서울특별시교육청 서울특별시강서양천교육지원청 서울양원초등학교,16,16,0,16,12,2,2,0
교육기관,교육부,서울양천초등학교,교육부 서울특별시교육청 서울특별시강서양천교육지원청 서울양천초등학교,21,21,0,21,16,5,0,0
교육기관,교육부,서울양화초등학교,교육부 서울특별시교육청 서울특별시강서양천교육지원청 서울양화초등학교,16,16,0,16,16,0,0,0
교육기관,교육부,서울양화초등학교병설유치원,교육부 서울특별시교육청 서울특별시강서양천교육지원청 서울양화초등학교병설유치원,8,8,0,8,2,6,0,0
교육기관,교육부,서울염경초등학교,교육부 서울특별시교육청 서울특별시강서양천교육지원청 서울염경초등학교,20,20,0,20,0,20,0,0
교육기관,교육부,서울염경초등학교병설유치원,교육부 서울특별시교육청 서울특별시강서양천교육지원청 서울염경초등학교병설유치원,4,4,0,4,0,4,0,0
교육기관,교육부,서울염동초등학교,교육부 서울특별시교육청 서울특별시강서양천교육지원청 서울염동초등학교,11,11,0,11,5,6,0,0
교육기관,교육부,서울염창초등학교,교육부 서울특별시교육청 서울특별시강서양천교육지원청 서울염창초등학교,11,11,0,11,7,4,0,0
교육기관,교육부,서울영도초등학교,교육부 서울특별시교육청 서울특별시강서양천교육지원청 서울영도초등학교,28,28,0,28,28,0,0,0
교육기관,교육부,서울우장초등학교,교육부 서울특별시교육청 서울특별시강서양천교육지원청 서울우장초등학교,35,35,0,35,20,15,0,0
교육기관,교육부,서울월정초등학교,교육부 서울특별시교육청 서울특별시강서양천교육지원청 서울월정초등학교,19,19,0,19,19,0,0,0
교육기관,교육부,서울월정초등학교병설유치원,교육부 서울특별시교육청 서울특별시강서양천교육지원청 서울월정초등학교병설유치원,7,7,0,7,0,7,0,0
교육기관,교육부,서울월촌초등학교,교육부 서울특별시교육청 서울특별시강서양천교육지원청 서울월촌초등학교,18,18,0,18,0,18,0,0
교육기관,교육부,서울월촌초등학교병설유치원,교육부 서울특별시교육청 서울특별시강서양천교육지원청 서울월촌초등학교병설유치원,4,1,3,1,1,0,0,0
교육기관,교육부,서울은정초등학교,교육부 서울특별시교육청 서울특별시강서양천교육지원청 서울은정초등학교,17,17,0,17,14,3,0,0
교육기관,교육부,서울장수초등학교,교육부 서울특별시교육청 서울특별시강서양천교육지원청 서울장수초등학교,17,17,0,17,17,0,0,0
교육기관,교육부,서울정곡초등학교,교육부 서울특별시교육청 서울특별시강서양천교육지원청 서울정곡초등학교,16,16,0,16,16,0,0,0
교육기관,교육부,서울정곡초등학교병설유치원,교육부 서울특별시교육청 서울특별시강서양천교육지원청 서울정곡초등학교병설유치원,5,5,0,5,2,3,0,0
교육기관,교육부,서울정목초등학교,교육부 서울특별시교육청 서울특별시강서양천교육지원청 서울정목초등학교,27,27,0,27,27,0,0,0
교육기관,교육부,서울지향초등학교,교육부 서울특별시교육청 서울특별시강서양천교육지원청 서울지향초등학교,20,20,0,20,15,5,0,0
교육기관,교육부,서울치현초등학교,교육부 서울특별시교육청 서울특별시강서양천교육지원청 서울치현초등학교,23,23,0,23,23,0,0,0
교육기관,교육부,서울탑산초등학교,교육부 서울특별시교육청 서울특별시강서양천교육지원청 서울탑산초등학교,17,17,0,17,3,14,0,0
교육기관,교육부,서울화곡초등학교,교육부 서울특별시교육청 서울특별시강서양천교육지원청 서울화곡초등학교,22,22,0,22,9,12,0,1
교육기관,교육부,선미유치원,교육부 서울특별시교육청 서울특별시강서양천교육지원청 선미유치원,14,0,14,0,0,0,0,0
교육기관,교육부,신영유치원,교육부 서울특별시교육청 서울특별시강서양천교육지원청 신영유치원,16,2,14,2,2,0,0,0
교육기관,교육부,아람유치원,교육부 서울특별시교육청 서울특별시강서양천교육지원청 아람유치원,9,2,7,2,1,1,0,0
교육기관,교육부,염창중학교,교육부 서울특별시교육청 서울특별시강서양천교육지원청 염창중학교,31,31,0,31,9,22,0,0
교육기관,교육부,우현유치원,교육부 서울특별시교육청 서울특별시강서양천교육지원청 우현유치원,20,20,0,20,0,20,0,0
교육기관,교육부,유니유치원,교육부 서울특별시교육청 서울특별시강서양천교육지원청 유니유치원,16,2,14,2,1,1,0,0
교육기관,교육부,장미유치원,교육부 서울특별시교육청 서울특별시강서양천교육지원청 장미유치원,4,4,0,4,1,2,1,0
교육기관,교육부,튼튼유치원,교육부 서울특별시교육청 서울특별시강서양천교육지원청 튼튼유치원,29,0,29,0,0,0,0,0
교육기관,교육부,한나유치원,교육부 서울특별시교육청 서울특별시강서양천교육지원청 한나유치원,14,0,14,0,0,0,0,0
교육기관,교육부,해리유치원,교육부 서울특별시교육청 서울특별시강서양천교육지원청 해리유치원,18,12,6,12,0,12,0,0
교육기관,교육부,해림유치원,교육부 서울특별시교육청 서울특별시강서양천교육지원청 해림유치원,27,4,23,4,0,4,0,0
교육기관,교육부,홍신유치원,교육부 서울특별시교육청 서울특별시강서양천교육지원청 홍신유치원,32,32,0,32,4,28,0,0
교육기관,교육부,서울특별시교육시설관리사업소,교육부 서울특별시교육청 서울특별시교육시설관리사업소,9,9,0,9,0,9,0,0
교육기관,교육부,서울특별시교육연구정보원,교육부 서울특별시교육청 서울특별시교육연구정보원,44,25,19,25,4,21,0,0
교육기관,교육부,서울특별시교육청과학전시관,교육부 서울특별시교육청 서울특별시교육청과학전시관,65,65,0,65,0,65,0,0
교육기관,교육부,서울특별시교육청교육연수원,교육부 서울특별시교육청 서울특별시교육청교육연수원,62,62,0,62,0,62,0,0
교육기관,교육부,서울특별시남부교육지원청,교육부 서울특별시교육청 서울특별시남부교육지원청,32,32,0,32,0,32,0,0
교육기관,교육부,가산중학교,교육부 서울특별시교육청 서울특별시남부교육지원청 가산중학교,34,34,0,34,24,10,0,0
교육기관,교육부,개봉중학교,교육부 서울특별시교육청 서울특별시남부교육지원청 개봉중학교,17,17,0,17,17,0,0,0
교육기관,교육부,개웅중학교,교육부 서울특별시교육청 서울특별시남부교육지원청 개웅중학교,42,42,0,42,0,42,0,0
교육기관,교육부,경인중학교,교육부 서울특별시교육청 서울특별시남부교육지원청 경인중학교,46,46,0,46,18,28,0,0
교육기관,교육부,고척중학교,교육부 서울특별시교육청 서울특별시남부교육지원청 고척중학교,40,40,0,40,18,22,0,0
교육기관,교육부,구로중학교,교육부 서울특별시교육청 서울특별시남부교육지원청 구로중학교,33,33,0,33,33,0,0,0
교육기관,교육부,구일중학교,교육부 서울특별시교육청 서울특별시남부교육지원청 구일중학교,8,8,0,8,8,0,0,0
교육기관,교육부,꿀벌유치원,교육부 서울특별시교육청 서울특별시남부교육지원청 꿀벌유치원,13,1,12,1,1,0,0,0
교육기관,교육부,난곡중학교,교육부 서울특별시교육청 서울특별시남부교육지원청 난곡중학교,35,35,0,35,0,35,0,0
교육기관,교육부,당산서중학교,교육부 서울특별시교육청 서울특별시남부교육지원청 당산서중학교,42,42,0,42,0,42,0,0
교육기관,교육부,당산중학교,교육부 서울특별시교육청 서울특별시남부교육지원청 당산중학교,26,26,0,26,26,0,0,0
교육기관,교육부,대림중학교,교육부 서울특별시교육청 서울특별시남부교육지원청 대림중학교,50,50,0,50,20,30,0,0
교육기관,교육부,대영중학교,교육부 서울특별시교육청 서울특별시남부교육지원청 대영중학교,44,44,0,44,0,44,0,0
교육기관,교육부,돈보스꼬유치원,교육부 서울특별시교육청 서울특별시남부교육지원청 돈보스꼬유치원,50,5,45,5,1,2,1,1
교육기관,교육부,동광초등학교,교육부 서울특별시교육청 서울특별시남부교육지원청 동광초등학교,45,45,0,45,45,0,0,0
교육기관,교육부,동산유치원,교육부 서울특별시교육청 서울특별시남부교육지원청 동산유치원,17,17,0,17,6,11,0,0
교육기관,교육부,동천유치원,교육부 서울특별시교육청 서울특별시남부교육지원청 동천유치원,16,3,13,3,0,3,0,0
교육기관,교육부,명신유치원,교육부 서울특별시교육청 서울특별시남부교육지원청 명신유치원,15,3,12,3,1,1,0,1
교육기관,교육부,문래중학교,교육부 서울특별시교육청 서울특별시남부교육지원청 문래중학교,30,30,0,30,8,22,0,0
교육기관,교육부,문일중학교,교육부 서울특별시교육청 서울특별시남부교육지원청 문일중학교,21,19,2,19,13,4,1,1
교육기관,교육부,미림유치원,교육부 서울특별시교육청 서울특별시남부교육지원청 미림유치원,9,2,7,2,0,1,1,0
교육기관,교육부,살레시오성미유치원,교육부 서울특별시교육청 서울특별시남부교육지원청 살레시오성미유치원,32,28,4,28,6,20,1,1
교육기관,교육부,서울가산초등학교,교육부 서울특별시교육청 서울특별시남부교육지원청 서울가산초등학교,14,14,0,14,14,0,0,0
교육기관,교육부,서울개명초등학교,교육부 서울특별시교육청 서울특별시남부교육지원청 서울개명초등학교,15,15,0,15,4,11,0,0
교육기관,교육부,서울개봉초등학교,교육부 서울특별시교육청 서울특별시남부교육지원청 서울개봉초등학교,32,32,0,32,32,0,0,0
교육기관,교육부,서울개봉초등학교병설유치원,교육부 서울특별시교육청 서울특별시남부교육지원청 서울개봉초등학교병설유치원,4,4,0,4,1,3,0,0
교육기관,교육부,서울개웅초등학교,교육부 서울특별시교육청 서울특별시남부교육지원청 서울개웅초등학교,16,16,0,16,16,0,0,0
교육기관,교육부,서울고산초등학교,교육부 서울특별시교육청 서울특별시남부교육지원청 서울고산초등학교,13,13,0,13,13,0,0,0
교육기관,교육부,서울고산초등학교병설유치원,교육부 서울특별시교육청 서울특별시남부교육지원청 서울고산초등학교병설유치원,4,0,4,0,0,0,0,0
교육기관,교육부,서울고원초등학교,교육부 서울특별시교육청 서울특별시남부교육지원청 서울고원초등학교,9,9,0,9,8,1,0,0
교육기관,교육부,서울고척초등학교,교육부 서울특별시교육청 서울특별시남부교육지원청 서울고척초등학교,28,28,0,28,0,28,0,0
교육기관,교육부,서울구로남초등학교,교육부 서울특별시교육청 서울특별시남부교육지원청 서울구로남초등학교,34,34,0,34,34,0,0,0
교육기관,교육부,서울구로초등학교,교육부 서울특별시교육청 서울특별시남부교육지원청 서울구로초등학교,22,22,0,22,22,0,0,0
교육기관,교육부,서울구일초등학교,교육부 서울특별시교육청 서울특별시남부교육지원청 서울구일초등학교,20,20,0,20,14,6,0,0
교육기관,교육부,서울금나래초등학교,교육부 서울특별시교육청 서울특별시남부교육지원청 서울금나래초등학교,39,39,0,39,24,15,0,0
교육기관,교육부,서울금나래초등학교병설유치원,교육부 서울특별시교육청 서울특별시남부교육지원청 서울금나래초등학교병설유치원,16,16,0,16,2,14,0,0
교육기관,교육부,서울금동초등학교,교육부 서울특별시교육청 서울특별시남부교육지원청 서울금동초등학교,24,24,0,24,0,24,0,0
교육기관,교육부,서울금산초등학교,교육부 서울특별시교육청 서울특별시남부교육지원청 서울금산초등학교,14,14,0,14,9,5,0,0
교육기관,교육부,서울금천초등학교,교육부 서울특별시교육청 서울특별시남부교육지원청 서울금천초등학교,17,17,0,17,13,4,0,0
교육기관,교육부,서울당산초등학교,교육부 서울특별시교육청 서울특별시남부교육지원청 서울당산초등학교,17,17,0,17,6,11,0,0
교육기관,교육부,서울당서초등학교,교육부 서울특별시교육청 서울특별시남부교육지원청 서울당서초등학교,14,14,0,14,0,14,0,0
교육기관,교육부,서울당중초등학교,교육부 서울특별시교육청 서울특별시남부교육지원청 서울당중초등학교,30,30,0,30,27,3,0,0
교육기관,교육부,서울당중초등학교병설유치원,교육부 서울특별시교육청 서울특별시남부교육지원청 서울당중초등학교병설유치원,7,6,1,6,4,2,0,0
교육기관,교육부,서울대길초등학교,교육부 서울특별시교육청 서울특별시남부교육지원청 서울대길초등학교,39,39,0,39,39,0,0,0
교육기관,교육부,서울대길초등학교병설유치원,교육부 서울특별시교육청 서울특별시남부교육지원청 서울대길초등학교병설유치원,8,8,0,8,0,8,0,0
교육기관,교육부,서울대동초등학교,교육부 서울특별시교육청 서울특별시남부교육지원청 서울대동초등학교,19,19,0,19,19,0,0,0
교육기관,교육부,서울대동초등학교병설유치원,교육부 서울특별시교육청 서울특별시남부교육지원청 서울대동초등학교병설유치원,4,4,0,4,4,0,0,0
교육기관,교육부,서울대방초등학교,교육부 서울특별시교육청 서울특별시남부교육지원청 서울대방초등학교,47,47,0,47,0,47,0,0
교육기관,교육부,서울대영초등학교,교육부 서울특별시교육청 서울특별시남부교육지원청 서울대영초등학교,34,34,0,34,10,24,0,0
교육기관,교육부,서울덕의초등학교,교육부 서울특별시교육청 서울특별시남부교육지원청 서울덕의초등학교,16,16,0,16,16,0,0,0
교육기관,교육부,서울도림초등학교,교육부 서울특별시교육청 서울특별시남부교육지원청 서울도림초등학교,37,37,0,37,0,37,0,0
교육기관,교육부,서울도신초등학교,교육부 서울특별시교육청 서울특별시남부교육지원청 서울도신초등학교,20,18,2,18,15,1,1,1
교육기관,교육부,서울독산초등학교,교육부 서울특별시교육청 서울특별시남부교육지원청 서울독산초등학교,16,16,0,16,0,16,0,0
교육기관,교육부,서울동구로초등학교,교육부 서울특별시교육청 서울특별시남부교육지원청 서울동구로초등학교,18,18,0,18,0,18,0,0
교육기관,교육부,서울두산초등학교,교육부 서울특별시교육청 서울특별시남부교육지원청 서울두산초등학교,17,17,0,17,17,0,0,0
교육기관,교육부,서울두산초등학교병설유치원,교육부 서울특별시교육청 서울특별시남부교육지원청 서울두산초등학교병설유치원,6,6,0,6,6,0,0,0
교육기관,교육부,서울매봉초등학교,교육부 서울특별시교육청 서울특별시남부교육지원청 서울매봉초등학교,13,13,0,13,13,0,0,0
교육기관,교육부,서울매봉초등학교병설유치원,교육부 서울특별시교육청 서울특별시남부교육지원청 서울매봉초등학교병설유치원,6,2,4,2,2,0,0,0
교육기관,교육부,서울문교초등학교,교육부 서울특별시교육청 서울특별시남부교육지원청 서울문교초등학교,26,26,0,26,0,26,0,0
교육기관,교육부,서울문교초등학교병설유치원,교육부 서울특별시교육청 서울특별시남부교육지원청 서울문교초등학교병설유치원,9,9,0,9,4,5,0,0
교육기관,교육부,서울문래초등학교,교육부 서울특별시교육청 서울특별시남부교육지원청 서울문래초등학교,22,22,0,22,0,22,0,0
교육기관,교육부,서울문백초등학교,교육부 서울특별시교육청 서울특별시남부교육지원청 서울문백초등학교,19,19,0,19,19,0,0,0
교육기관,교육부,서울문성초등학교,교육부 서울특별시교육청 서울특별시남부교육지원청 서울문성초등학교,29,29,0,29,26,3,0,0
교육기관,교육부,서울미래초등학교,교육부 서울특별시교육청 서울특별시남부교육지원청 서울미래초등학교,16,16,0,16,0,16,0,0
교육기관,교육부,서울백산초등학교,교육부 서울특별시교육청 서울특별시남부교육지원청 서울백산초등학교,28,28,0,28,28,0,0,0
교육기관,교육부,서울백산초등학교병설유치원,교육부 서울특별시교육청 서울특별시남부교육지원청 서울백산초등학교병설유치원,9,9,0,9,7,2,0,0
교육기관,교육부,서울선유초등학교,교육부 서울특별시교육청 서울특별시남부교육지원청 서울선유초등학교,22,22,0,22,5,17,0,0
교육기관,교육부,서울세곡초등학교,교육부 서울특별시교육청 서울특별시남부교육지원청 서울세곡초등학교,16,16,0,16,16,0,0,0
교육기관,교육부,서울세곡초등학교병설유치원,교육부 서울특별시교육청 서울특별시남부교육지원청 서울세곡초등학교병설유치원,8,0,8,0,0,0,0,0
교육기관,교육부,서울시흥초등학교,교육부 서울특별시교육청 서울특별시남부교육지원청 서울시흥초등학교,20,20,0,20,20,0,0,0
교육기관,교육부,서울신구로초등학교,교육부 서울특별시교육청 서울특별시남부교육지원청 서울신구로초등학교,26,26,0,26,0,26,0,0
교육기관,교육부,서울신대림초등학교,교육부 서울특별시교육청 서울특별시남부교육지원청 서울신대림초등학교,8,8,0,8,8,0,0,0
교육기관,교육부,서울신도림초등학교,교육부 서울특별시교육청 서울특별시남부교육지원청 서울신도림초등학교,29,29,0,29,29,0,0,0
교육기관,교육부,서울신미림초등학교,교육부 서울특별시교육청 서울특별시남부교육지원청 서울신미림초등학교,14,14,0,14,14,0,0,0
교육기관,교육부,서울신미림초등학교병설유치원,교육부 서울특별시교육청 서울특별시남부교육지원청 서울신미림초등학교병설유치원,3,1,2,1,1,0,0,0
교육기관,교육부,서울신영초등학교,교육부 서울특별시교육청 서울특별시남부교육지원청 서울신영초등학교,21,21,0,21,19,2,0,0
교육기관,교육부,서울신흥초등학교,교육부 서울특별시교육청 서울특별시남부교육지원청 서울신흥초등학교,27,27,0,27,27,0,0,0
교육기관,교육부,서울안천초등학교,교육부 서울특별시교육청 서울특별시남부교육지원청 서울안천초등학교,16,16,0,16,16,0,0,0
교육기관,교육부,서울여의도초등학교,교육부 서울특별시교육청 서울특별시남부교육지원청 서울여의도초등학교,24,24,0,24,0,24,0,0
교육기관,교육부,서울영남초등학교,교육부 서울특별시교육청 서울특별시남부교육지원청 서울영남초등학교,17,17,0,17,0,17,0,0
교육기관,교육부,서울영동초등학교,교육부 서울특별시교육청 서울특별시남부교육지원청 서울영동초등학교,34,34,0,34,15,19,0,0
교육기관,교육부,서울영등포초등학교,교육부 서울특별시교육청 서울특별시남부교육지원청 서울영등포초등학교,27,27,0,27,18,9,0,0
교육기관,교육부,서울영림초등학교,교육부 서울특별시교육청 서울특별시남부교육지원청 서울영림초등학교,26,26,0,26,26,0,0,0
교육기관,교육부,서울영림초등학교병설유치원,교육부 서울특별시교육청 서울특별시남부교육지원청 서울영림초등학교병설유치원,4,4,0,4,4,0,0,0
교육기관,교육부,서울영서초등학교,교육부 서울특별시교육청 서울특별시남부교육지원청 서울영서초등학교,51,51,0,51,18,33,0,0
교육기관,교육부,서울영신초등학교,교육부 서울특별시교육청 서울특별시남부교육지원청 서울영신초등학교,35,35,0,35,0,35,0,0
교육기관,교육부,서울영원초등학교,교육부 서울특별시교육청 서울특별시남부교육지원청 서울영원초등학교,15,15,0,15,15,0,0,0
교육기관,교육부,서울영일초등학교,교육부 서울특별시교육청 서울특별시남부교육지원청 서울영일초등학교,21,21,0,21,11,10,0,0
교육기관,교육부,서울영중초등학교,교육부 서울특별시교육청 서울특별시남부교육지원청 서울영중초등학교,18,18,0,18,18,0,0,0
교육기관,교육부,서울영중초등학교병설유치원,교육부 서울특별시교육청 서울특별시남부교육지원청 서울영중초등학교병설유치원,9,9,0,9,2,7,0,0
교육기관,교육부,서울오류남초등학교,교육부 서울특별시교육청 서울특별시남부교육지원청 서울오류남초등학교,18,18,0,18,0,18,0,0
교육기관,교육부,서울오류남초등학교병설유치원,교육부 서울특별시교육청 서울특별시남부교육지원청 서울오류남초등학교병설유치원,5,5,0,5,3,2,0,0
교육기관,교육부,서울오류초등학교,교육부 서울특별시교육청 서울특별시남부교육지원청 서울오류초등학교,21,21,0,21,21,0,0,0
교육기관,교육부,서울오정초등학교,교육부 서울특별시교육청 서울특별시남부교육지원청 서울오정초등학교,23,23,0,23,18,5,0,0
교육기관,교육부,서울온수초등학교,교육부 서울특별시교육청 서울특별시남부교육지원청 서울온수초등학교,28,28,0,28,8,20,0,0
교육기관,교육부,서울우신초등학교,교육부 서울특별시교육청 서울특별시남부교육지원청 서울우신초등학교,30,30,0,30,30,0,0,0
교육기관,교육부,서울우신초등학교병설유치원,교육부 서울특별시교육청 서울특별시남부교육지원청 서울우신초등학교병설유치원,18,18,0,18,18,0,0,0
교육기관,교육부,서울윤중초등학교,교육부 서울특별시교육청 서울특별시남부교육지원청 서울윤중초등학교,26,26,0,26,26,0,0,0
교육기관,교육부,서울정심초등학교,교육부 서울특별시교육청 서울특별시남부교육지원청 서울정심초등학교,32,32,0,32,0,32,0,0
교육기관,교육부,서울정심초등학교병설유치원,교육부 서울특별시교육청 서울특별시남부교육지원청 서울정심초등학교병설유치원,13,9,4,9,0,9,0,0
교육기관,교육부,서울천왕초등학교,교육부 서울특별시교육청 서울특별시남부교육지원청 서울천왕초등학교,24,24,0,24,24,0,0,0
교육기관,교육부,서울탑동초등학교,교육부 서울특별시교육청 서울특별시남부교육지원청 서울탑동초등학교,20,12,8,12,12,0,0,0
교육기관,교육부,서울하늘숲유치원,교육부 서울특별시교육청 서울특별시남부교육지원청 서울하늘숲유치원,31,31,0,31,31,0,0,0
교육기관,교육부,서울하늘숲초등학교,교육부 서울특별시교육청 서울특별시남부교육지원청 서울하늘숲초등학교,26,26,0,26,9,17,0,0
교육기관,교육부,서울항동초등학교,교육부 서울특별시교육청 서울특별시남부교육지원청 서울항동초등학교,29,29,0,29,0,29,0,0
교육기관,교육부,선유중학교,교육부 서울특별시교육청 서울특별시남부교육지원청 선유중학교,39,39,0,39,16,23,0,0
교육기관,교육부,성모유치원,교육부 서울특별시교육청 서울특별시남부교육지원청 성모유치원,5,5,0,5,2,3,0,0
교육기관,교육부,성지유치원,교육부 서울특별시교육청 서울특별시남부교육지원청 성지유치원,3,3,0,3,2,1,0,0
교육기관,교육부,세일중학교,교육부 서울특별시교육청 서울특별시남부교육지원청 세일중학교,41,41,0,41,16,25,0,0
교육기관,교육부,시내유치원,교육부 서울특별시교육청 서울특별시남부교육지원청 시내유치원,12,12,0,12,0,12,0,0
교육기관,교육부,시흥중학교,교육부 서울특별시교육청 서울특별시남부교육지원청 시흥중학교,43,43,0,43,43,0,0,0
교육기관,교육부,신길중학교,교육부 서울특별시교육청 서울특별시남부교육지원청 신길중학교,54,54,0,54,0,54,0,0
교육기관,교육부,신도림중학교,교육부 서울특별시교육청 서울특별시남부교육지원청 신도림중학교,36,36,0,36,15,21,0,0
교육기관,교육부,신라유치원,교육부 서울특별시교육청 서울특별시남부교육지원청 신라유치원,6,2,4,2,1,0,1,0
교육기관,교육부,안천중학교,교육부 서울특별시교육청 서울특별시남부교육지원청 안천중학교,47,47,0,47,47,0,0,0
교육기관,교육부,양화중학교,교육부 서울특별시교육청 서울특별시남부교육지원청 양화중학교,45,45,0,45,25,20,0,0
교육기관,교육부,여의도유치원,교육부 서울특별시교육청 서울특별시남부교육지원청 여의도유치원,13,2,11,2,1,1,0,0
교육기관,교육부,여의도중학교,교육부 서울특별시교육청 서울특별시남부교육지원청 여의도중학교,94,94,0,94,40,54,0,0
교육기관,교육부,영림중학교,교육부 서울특별시교육청 서울특별시남부교육지원청 영림중학교,33,33,0,33,8,25,0,0
교육기관,교육부,영서중학교,교육부 서울특별시교육청 서울특별시남부교육지원청 영서중학교,23,23,0,23,0,23,0,0
교육기관,교육부,영원중학교,교육부 서울특별시교육청 서울특별시남부교육지원청 영원중학교,29,29,0,29,29,0,0,0
교육기관,교육부,영은유치원,교육부 서울특별시교육청 서울특별시남부교육지원청 영은유치원,8,1,7,1,0,1,0,0
교육기관,교육부,예림유치원,교육부 서울특별시교육청 서울특별시남부교육지원청 예림유치원,14,14,0,14,0,14,0,0
교육기관,교육부,예쁨유치원,교육부 서울특별시교육청 서울특별시남부교육지원청 예쁨유치원,10,10,0,10,7,3,0,0
교육기관,교육부,오남중학교,교육부 서울특별시교육청 서울특별시남부교육지원청 오남중학교,23,23,0,23,23,0,0,0
교육기관,교육부,오류중학교,교육부 서울특별시교육청 서울특별시남부교육지원청 오류중학교,46,46,0,46,46,0,0,0
교육기관,교육부,우신중학교,교육부 서울특별시교육청 서울특별시남부교육지원청 우신중학교,60,60,0,60,0,60,0,0
교육기관,교육부,윤중중학교,교육부 서울특별시교육청 서울특별시남부교육지원청 윤중중학교,32,32,0,32,21,11,0,0
교육기관,교육부,정훈유치원,교육부 서울특별시교육청 서울특별시남부교육지원청 정훈유치원,14,14,0,14,2,12,0,0
교육기관,교육부,천왕중학교,교육부 서울특별시교육청 서울특별시남부교육지원청 천왕중학교,36,35,1,35,0,35,0,0
교육기관,교육부,청은유치원,교육부 서울특별시교육청 서울특별시남부교육지원청 청은유치원,10,10,0,10,7,3,0,0
교육기관,교육부,침례유치원,교육부 서울특별시교육청 서울특별시남부교육지원청 침례유치원,35,9,26,9,7,2,0,0
교육기관,교육부,평화유치원,교육부 서울특별시교육청 서울특별시남부교육지원청 평화유치원,13,13,0,13,3,8,1,1
교육기관,교육부,푸른동산유치원,교육부 서울특별시교육청 서울특별시남부교육지원청 푸른동산유치원,23,2,21,2,0,2,0,0
교육기관,교육부,한신혜원유치원,교육부 서울특별시교육청 서울특별시남부교육지원청 한신혜원유치원,19,19,0,19,10,7,1,1
교육기관,교육부,항동중학교,교육부 서울특별시교육청 서울특별시남부교육지원청 항동중학교,52,51,1,51,46,5,0,0
교육기관,교육부,서울특별시동부교육지원청,교육부 서울특별시교육청 서울특별시동부교육지원청,13,13,0,13,0,13,0,0
교육기관,교육부,경희여자중학교,교육부 서울특별시교육청 서울특별시동부교육지원청 경희여자중학교,23,23,0,23,23,0,0,0
교육기관,교육부,경희중학교,교육부 서울특별시교육청 서울특별시동부교육지원청 경희중학교,23,23,0,23,0,23,0,0
교육기관,교육부,대광중학교,교육부 서울특별시교육청 서울특별시동부교육지원청 대광중학교,20,20,0,20,0,20,0,0
교육기관,교육부,동국대학교사범대학부속중학교,교육부 서울특별시교육청 서울특별시동부교육지원청 동국대학교사범대학부속중학교,45,43,2,43,5,38,0,0
교육기관,교육부,동대문중학교,교육부 서울특별시교육청 서울특별시동부교육지원청 동대문중학교,32,32,0,32,32,0,0,0
교육기관,교육부,동원중학교,교육부 서울특별시교육청 서울특별시동부교육지원청 동원중학교,45,45,0,45,43,2,0,0
교육기관,교육부,면목중학교,교육부 서울특별시교육청 서울특별시동부교육지원청 면목중학교,54,54,0,54,0,54,0,0
교육기관,교육부,봉화중학교,교육부 서울특별시교육청 서울특별시동부교육지원청 봉화중학교,57,57,0,57,57,0,0,0
교육기관,교육부,상봉중학교,교육부 서울특별시교육청 서울특별시동부교육지원청 상봉중학교,33,33,0,33,2,31,0,0
교육기관,교육부,서울봉화초등학교,교육부 서울특별시교육청 서울특별시동부교육지원청 서울봉화초등학교,16,16,0,16,0,16,0,0
교육기관,교육부,성일중학교,교육부 서울특별시교육청 서울특별시동부교육지원청 성일중학교,64,64,0,64,64,0,0,0
교육기관,교육부,숭인중학교,교육부 서울특별시교육청 서울특별시동부교육지원청 숭인중학교,34,34,0,34,24,10,0,0
교육기관,교육부,신현중학교,교육부 서울특별시교육청 서울특별시동부교육지원청 신현중학교,37,37,0,37,0,37,0,0
교육기관,교육부,영란여자중학교,교육부 서울특별시교육청 서울특별시동부교육지원청 영란여자중학교,15,15,0,15,0,15,0,0
교육기관,교육부,용마중학교,교육부 서울특별시교육청 서울특별시동부교육지원청 용마중학교,28,28,0,28,28,0,0,0
교육기관,교육부,원묵중학교,교육부 서울특별시교육청 서울특별시동부교육지원청 원묵중학교,62,62,0,62,51,11,0,0
교육기관,교육부,장안중학교,교육부 서울특별시교육청 서울특별시동부교육지원청 장안중학교,53,53,0,53,30,23,0,0
교육기관,교육부,장평중학교,교육부 서울특별시교육청 서울특별시동부교육지원청 장평중학교,36,36,0,36,27,9,0,0
교육기관,교육부,전농중학교,교육부 서울특별시교육청 서울특별시동부교육지원청 전농중학교,31,31,0,31,0,31,0,0
교육기관,교육부,전일중학교,교육부 서울특별시교육청 서울특별시동부교육지원청 전일중학교,28,28,0,28,0,28,0,0
교육기관,교육부,정화여자중학교,교육부 서울특별시교육청 서울특별시동부교육지원청 정화여자중학교,18,7,11,7,7,0,0,0
교육기관,교육부,중랑중학교,교육부 서울특별시교육청 서울특별시동부교육지원청 중랑중학교,74,71,3,71,62,8,1,0
교육기관,교육부,중화중학교,교육부 서울특별시교육청 서울특별시동부교육지원청 중화중학교,48,48,0,48,11,37,0,0
교육기관,교육부,청량중학교,교육부 서울특별시교육청 서울특별시동부교육지원청 청량중학교,36,36,0,36,18,18,0,0
교육기관,교육부,태릉중학교,교육부 서울특별시교육청 서울특별시동부교육지원청 태릉중학교,32,32,0,32,13,19,0,0
교육기관,교육부,혜원여자중학교,교육부 서울특별시교육청 서울특별시동부교육지원청 혜원여자중학교,13,13,0,13,1,12,0,0
교육기관,교육부,휘경여자중학교,교육부 서울특별시교육청 서울특별시동부교육지원청 휘경여자중학교,24,24,0,24,16,8,0,0
교육기관,교육부,휘경중학교,교육부 서울특별시교육청 서울특별시동부교육지원청 휘경중학교,40,40,0,40,0,40,0,0
교육기관,교육부,서울특별시동작관악교육지원청,교육부 서울특별시교육청 서울특별시동작관악교육지원청,6,6,0,6,0,6,0,0
교육기관,교육부,강남유치원,교육부 서울특별시교육청 서울특별시동작관악교육지원청 강남유치원,4,0,4,0,0,0,0,0
교육기관,교육부,강현중학교,교육부 서울특별시교육청 서울특별시동작관악교육지원청 강현중학교,30,30,0,30,0,30,0,0
교육기관,교육부,관악중학교,교육부 서울특별시교육청 서울특별시동작관악교육지원청 관악중학교,32,32,0,32,0,32,0,0
교육기관,교육부,구암중학교,교육부 서울특별시교육청 서울특별시동작관악교육지원청 구암중학교,81,81,0,81,81,0,0,0
교육기관,교육부,국사봉중학교,교육부 서울특별시교육청 서울특별시동작관악교육지원청 국사봉중학교,21,21,0,21,14,7,0,0
교육기관,교육부,난우중학교,교육부 서울특별시교육청 서울특별시동작관악교육지원청 난우중학교,44,44,0,44,14,30,0,0
교육기관,교육부,남강중학교,교육부 서울특별시교육청 서울특별시동작관악교육지원청 남강중학교,17,14,3,14,11,3,0,0
교육기관,교육부,남성중학교,교육부 서울특별시교육청 서울특별시동작관악교육지원청 남성중학교,33,33,0,33,16,17,0,0
교육기관,교육부,노량진교회유치원,교육부 서울특별시교육청 서울특별시동작관악교육지원청 노량진교회유치원,10,10,0,10,0,10,0,0
교육기관,교육부,당곡중학교,교육부 서울특별시교육청 서울특별시동작관악교육지원청 당곡중학교,45,45,0,45,45,0,0,0
교육기관,교육부,대방중학교,교육부 서울특별시교육청 서울특별시동작관악교육지원청 대방중학교,39,39,0,39,0,39,0,0
교육기관,교육부,동양중학교,교육부 서울특별시교육청 서울특별시동작관악교육지원청 동양중학교,16,14,2,14,3,11,0,0
교육기관,교육부,동작중학교,교육부 서울특별시교육청 서울특별시동작관악교육지원청 동작중학교,34,33,1,33,20,13,0,0
교육기관,교육부,명성유치원,교육부 서울특별시교육청 서울특별시동작관악교육지원청 명성유치원,9,2,7,2,0,2,0,0
교육기관,교육부,명수유치원,교육부 서울특별시교육청 서울특별시동작관악교육지원청 명수유치원,11,5,6,5,2,3,0,0
교육기관,교육부,문창중학교,교육부 서울특별시교육청 서울특별시동작관악교육지원청 문창중학교,30,30,0,30,0,30,0,0
교육기관,교육부,벧엘유치원,교육부 서울특별시교육청 서울특별시동작관악교육지원청 벧엘유치원,25,7,18,7,1,4,1,1
교육기관,교육부,봉림중학교,교육부 서울특별시교육청 서울특별시동작관악교육지원청 봉림중학교,42,42,0,42,0,42,0,0
교육기관,교육부,봉원중학교,교육부 서울특별시교육청 서울특별시동작관악교육지원청 봉원중학교,50,50,0,50,37,13,0,0
교육기관,교육부,사당중학교,교육부 서울특별시교육청 서울특별시동작관악교육지원청 사당중학교,23,23,0,23,1,22,0,0
교육기관,교육부,삼성중학교,교육부 서울특별시교육청 서울특별시동작관악교육지원청 삼성중학교,44,43,1,43,31,8,3,1
교육기관,교육부,상도중학교,교육부 서울특별시교육청 서울특별시동작관악교육지원청 상도중학교,30,30,0,30,0,30,0,0
교육기관,교육부,상아유치원,교육부 서울특별시교육청 서울특별시동작관악교육지원청 상아유치원,2,2,0,2,1,1,0,0
교육기관,교육부,상현중학교,교육부 서울특별시교육청 서울특별시동작관악교육지원청 상현중학교,35,35,0,35,21,14,0,0
교육기관,교육부,새소슬유치원,교육부 서울특별시교육청 서울특별시동작관악교육지원청 새소슬유치원,12,1,11,1,1,0,0,0
교육기관,교육부,샛별유치원,교육부 서울특별시교육청 서울특별시동작관악교육지원청 샛별유치원,31,3,28,3,2,0,1,0
교육기관,교육부,서울강남초등학교,교육부 서울특별시교육청 서울특별시동작관악교육지원청 서울강남초등학교,13,13,0,13,13,0,0,0
교육기관,교육부,서울강남초등학교병설유치원,교육부 서울특별시교육청 서울특별시동작관악교육지원청 서울강남초등학교병설유치원,4,4,0,4,0,4,0,0
교육기관,교육부,서울관악초등학교,교육부 서울특별시교육청 서울특별시동작관악교육지원청 서울관악초등학교,31,31,0,31,0,31,0,0
교육기관,교육부,서울관악초등학교병설유치원,교육부 서울특별시교육청 서울특별시동작관악교육지원청 서울관악초등학교병설유치원,1,1,0,1,1,0,0,0
교육기관,교육부,서울구암유치원,교육부 서울특별시교육청 서울특별시동작관악교육지원청 서울구암유치원,16,16,0,16,0,16,0,0
교육기관,교육부,서울구암초등학교,교육부 서울특별시교육청 서울특별시동작관악교육지원청 서울구암초등학교,18,18,0,18,14,4,0,0
교육기관,교육부,서울난곡초등학교,교육부 서울특별시교육청 서울특별시동작관악교육지원청 서울난곡초등학교,33,33,0,33,4,29,0,0
교육기관,교육부,서울난우초등학교,교육부 서울특별시교육청 서울특별시동작관악교육지원청 서울난우초등학교,10,10,0,10,0,10,0,0
교육기관,교육부,서울난향초등학교,교육부 서울특별시교육청 서울특별시동작관악교육지원청 서울난향초등학교,26,26,0,26,0,26,0,0
교육기관,교육부,서울남부초등학교,교육부 서울특별시교육청 서울특별시동작관악교육지원청 서울남부초등학교,33,33,0,33,33,0,0,0
교육기관,교육부,서울남사초등학교,교육부 서울특별시교육청 서울특별시동작관악교육지원청 서울남사초등학교,27,27,0,27,0,27,0,0
교육기관,교육부,서울남성초등학교,교육부 서울특별시교육청 서울특별시동작관악교육지원청 서울남성초등학교,31,31,0,31,14,17,0,0
교육기관,교육부,서울남현유치원,교육부 서울특별시교육청 서울특별시동작관악교육지원청 서울남현유치원,21,21,0,21,4,17,0,0
교육기관,교육부,서울노량진초등학교,교육부 서울특별시교육청 서울특별시동작관악교육지원청 서울노량진초등학교,18,14,4,14,0,14,0,0
교육기관,교육부,서울당곡초등학교,교육부 서울특별시교육청 서울특별시동작관악교육지원청 서울당곡초등학교,24,24,0,24,0,24,0,0
교육기관,교육부,서울당곡초등학교병설유치원,교육부 서울특별시교육청 서울특별시동작관악교육지원청 서울당곡초등학교병설유치원,8,8,0,8,0,8,0,0
교육기관,교육부,서울대림초등학교,교육부 서울특별시교육청 서울특별시동작관악교육지원청 서울대림초등학교,40,40,0,40,40,0,0,0
교육기관,교육부,서울동작초등학교,교육부 서울특별시교육청 서울특별시동작관악교육지원청 서울동작초등학교,40,40,0,40,0,40,0,0
교육기관,교육부,서울문창초등학교,교육부 서울특별시교육청 서울특별시동작관악교육지원청 서울문창초등학교,23,23,0,23,0,23,0,0
교육기관,교육부,서울미성초등학교,교육부 서울특별시교육청 서울특별시동작관악교육지원청 서울미성초등학교,15,15,0,15,15,0,0,0
교육기관,교육부,서울보라매초등학교,교육부 서울특별시교육청 서울특별시동작관악교육지원청 서울보라매초등학교,17,17,0,17,0,17,0,0
교육기관,교육부,서울본동초등학교,교육부 서울특별시교육청 서울특별시동작관악교육지원청 서울본동초등학교,10,10,0,10,10,0,0,0
교육기관,교육부,서울봉천초등학교,교육부 서울특별시교육청 서울특별시동작관악교육지원청 서울봉천초등학교,33,33,0,33,33,0,0,0
교육기관,교육부,서울봉현초등학교,교육부 서울특별시교육청 서울특별시동작관악교육지원청 서울봉현초등학교,22,22,0,22,22,0,0,0
교육기관,교육부,서울사당초등학교,교육부 서울특별시교육청 서울특별시동작관악교육지원청 서울사당초등학교,29,29,0,29,0,29,0,0
교육기관,교육부,서울삼성초등학교,교육부 서울특별시교육청 서울특별시동작관악교육지원청 서울삼성초등학교,31,31,0,31,28,3,0,0
교육기관,교육부,서울삼성초등학교병설유치원,교육부 서울특별시교육청 서울특별시동작관악교육지원청 서울삼성초등학교병설유치원,15,15,0,15,6,9,0,0
교육기관,교육부,서울삼일초등학교,교육부 서울특별시교육청 서울특별시동작관악교육지원청 서울삼일초등학교,13,13,0,13,13,0,0,0
교육기관,교육부,서울상도유치원,교육부 서울특별시교육청 서울특별시동작관악교육지원청 서울상도유치원,37,7,30,7,7,0,0,0
교육기관,교육부,서울상도초등학교,교육부 서울특별시교육청 서울특별시동작관악교육지원청 서울상도초등학교,38,38,0,38,19,19,0,0
교육기관,교육부,서울상현초등학교,교육부 서울특별시교육청 서울특별시동작관악교육지원청 서울상현초등학교,28,28,0,28,28,0,0,0
교육기관,교육부,서울신길초등학교,교육부 서울특별시교육청 서울특별시동작관악교육지원청 서울신길초등학교,34,34,0,34,0,34,0,0
교육기관,교육부,서울신남성초등학교,교육부 서울특별시교육청 서울특별시동작관악교육지원청 서울신남성초등학교,20,20,0,20,20,0,0,0
교육기관,교육부,서울신남성초등학교병설유치원,교육부 서울특별시교육청 서울특별시동작관악교육지원청 서울신남성초등학교병설유치원,20,20,0,20,20,0,0,0
교육기관,교육부,서울신봉초등학교,교육부 서울특별시교육청 서울특별시동작관악교육지원청 서울신봉초등학교,26,26,0,26,26,0,0,0
교육기관,교육부,서울신성초등학교,교육부 서울특별시교육청 서울특별시동작관악교육지원청 서울신성초등학교,28,28,0,28,28,0,0,0
교육기관,교육부,서울신우유치원,교육부 서울특별시교육청 서울특별시동작관악교육지원청 서울신우유치원,15,1,14,1,0,1,0,0
교육기관,교육부,서울신우초등학교,교육부 서울특별시교육청 서울특별시동작관악교육지원청 서울신우초등학교,27,27,0,27,25,2,0,0
교육기관,교육부,서울영본초등학교,교육부 서울특별시교육청 서울특별시동작관악교육지원청 서울영본초등학교,9,9,0,9,9,0,0,0
교육기관,교육부,서울영화초등학교,교육부 서울특별시교육청 서울특별시동작관악교육지원청 서울영화초등학교,35,35,0,35,21,14,0,0
교육기관,교육부,서울원당초등학교,교육부 서울특별시교육청 서울특별시동작관악교육지원청 서울원당초등학교,25,25,0,25,0,25,0,0
교육기관,교육부,서울원당초등학교병설유치원,교육부 서울특별시교육청 서울특별시동작관악교육지원청 서울원당초등학교병설유치원,7,0,7,0,0,0,0,0
교육기관,교육부,서울원신초등학교,교육부 서울특별시교육청 서울특별시동작관악교육지원청 서울원신초등학교,29,29,0,29,7,22,0,0
교육기관,교육부,서울은로초등학교,교육부 서울특별시교육청 서울특별시동작관악교육지원청 서울은로초등학교,36,36,0,36,0,36,0,0
교육기관,교육부,서울인헌초등학교,교육부 서울특별시교육청 서울특별시동작관악교육지원청 서울인헌초등학교,14,14,0,14,14,0,0,0
교육기관,교육부,서울조원초등학교,교육부 서울특별시교육청 서울특별시동작관악교육지원청 서울조원초등학교,29,29,0,29,6,23,0,0
교육기관,교육부,서울청룡초등학교,교육부 서울특별시교육청 서울특별시동작관악교육지원청 서울청룡초등학교,29,29,0,29,0,29,0,0
교육기관,교육부,서울청림유치원,교육부 서울특별시교육청 서울특별시동작관악교육지원청 서울청림유치원,25,25,0,25,17,8,0,0
교육기관,교육부,서울행림초등학교,교육부 서울특별시교육청 서울특별시동작관악교육지원청 서울행림초등학교,26,26,0,26,0,26,0,0
교육기관,교육부,서울흑석초등학교,교육부 서울특별시교육청 서울특별시동작관악교육지원청 서울흑석초등학교,21,21,0,21,0,21,0,0
교육기관,교육부,소슬유치원,교육부 서울특별시교육청 서울특별시동작관악교육지원청 소슬유치원,26,2,24,2,0,2,0,0
교육기관,교육부,송림유치원,교육부 서울특별시교육청 서울특별시동작관악교육지원청 송림유치원,18,18,0,18,0,18,0,0
교육기관,교육부,숭의여자중학교,교육부 서울특별시교육청 서울특별시동작관악교육지원청 숭의여자중학교,23,23,0,23,2,21,0,0
교육기관,교육부,승혜유치원,교육부 서울특별시교육청 서울특별시동작관악교육지원청 승혜유치원,16,0,16,0,0,0,0,0
교육기관,교육부,신관중학교,교육부 서울특별시교육청 서울특별시동작관악교육지원청 신관중학교,30,30,0,30,0,30,0,0
교육기관,교육부,신림중학교,교육부 서울특별시교육청 서울특별시동작관악교육지원청 신림중학교,52,52,0,52,52,0,0,0
교육기관,교육부,양문유치원,교육부 서울특별시교육청 서울특별시동작관악교육지원청 양문유치원,16,16,0,16,16,0,0,0
교육기관,교육부,영등포중학교,교육부 서울특별시교육청 서울특별시동작관악교육지원청 영등포중학교,39,39,0,39,19,20,0,0
교육기관,교육부,요요유치원,교육부 서울특별시교육청 서울특별시동작관악교육지원청 요요유치원,21,21,0,21,1,19,1,0
교육기관,교육부,은아유치원,교육부 서울특별시교육청 서울특별시동작관악교육지원청 은아유치원,38,3,35,3,3,0,0,0
교육기관,교육부,인헌중학교,교육부 서울특별시교육청 서울특별시동작관악교육지원청 인헌중학교,34,34,0,34,0,34,0,0
교육기관,교육부,장승중학교,교육부 서울특별시교육청 서울특별시동작관악교육지원청 장승중학교,27,27,0,27,0,27,0,0
교육기관,교육부,중앙대부속유치원,교육부 서울특별시교육청 서울특별시동작관악교육지원청 중앙대부속유치원,47,6,41,6,6,0,0,0
교육기관,교육부,한별유치원,교육부 서울특별시교육청 서울특별시동작관악교육지원청 한별유치원,15,15,0,15,0,15,0,0
교육기관,교육부,행복한숲유치원,교육부 서울특별시교육청 서울특별시동작관악교육지원청 행복한숲유치원,16,1,15,1,1,0,0,0
교육기관,교육부,현대유치원,교육부 서울특별시교육청 서울특별시동작관악교육지원청 현대유치원,16,7,9,7,3,2,1,1
교육기관,교육부,서울특별시북부교육지원청,교육부 서울특별시교육청 서울특별시북부교육지원청,29,29,0,29,0,29,0,0
교육기관,교육부,공릉중학교,교육부 서울특별시교육청 서울특별시북부교육지원청 공릉중학교,32,32,0,32,0,32,0,0
교육기관,교육부,광운중학교,교육부 서울특별시교육청 서울특별시북부교육지원청 광운중학교,17,17,0,17,11,6,0,0
교육기관,교육부,꿈터유치원,교육부 서울특별시교육청 서울특별시북부교육지원청 꿈터유치원,9,9,0,9,7,0,0,2
교육기관,교육부,노곡중학교,교육부 서울특별시교육청 서울특별시북부교육지원청 노곡중학교,16,16,0,16,0,16,0,0
교육기관,교육부,노원삼육유치원,교육부 서울특별시교육청 서울특별시북부교육지원청 노원삼육유치원,22,5,17,5,1,2,1,1
교육기관,교육부,노원중학교,교육부 서울특별시교육청 서울특별시북부교육지원청 노원중학교,39,39,0,39,27,12,0,0
교육기관,교육부,노일중학교,교육부 서울특별시교육청 서울특별시북부교육지원청 노일중학교,47,47,0,47,0,47,0,0
교육기관,교육부,녹천중학교,교육부 서울특별시교육청 서울특별시북부교육지원청 녹천중학교,24,24,0,24,18,2,4,0
교육기관,교육부,다연유치원,교육부 서울특별시교육청 서울특별시북부교육지원청 다연유치원,8,0,8,0,0,0,0,0
교육기관,교육부,덕성여자대학교부속유치원,교육부 서울특별시교육청 서울특별시북부교육지원청 덕성여자대학교부속유치원,21,21,0,21,0,21,0,0
교육기관,교육부,도봉중학교,교육부 서울특별시교육청 서울특별시북부교육지원청 도봉중학교,36,35,1,35,34,1,0,0
교육기관,교육부,동북초등학교,교육부 서울특별시교육청 서울특별시북부교육지원청 동북초등학교,47,47,0,47,0,47,0,0
교육기관,교육부,동화나라유치원,교육부 서울특별시교육청 서울특별시북부교육지원청 동화나라유치원,15,14,1,14,1,12,0,1
교육기관,교육부,두솔유치원,교육부 서울특별시교육청 서울특별시북부교육지원청 두솔유치원,8,8,0,8,0,8,0,0
교육기관,교육부,무지개유치원,교육부 서울특별시교육청 서울특별시북부교육지원청 무지개유치원,16,16,0,16,0,16,0,0
교육기관,교육부,방학중학교,교육부 서울특별시교육청 서울특별시북부교육지원청 방학중학교,32,32,0,32,0,32,0,0
교육기관,교육부,백운중학교,교육부 서울특별시교육청 서울특별시북부교육지원청 백운중학교,31,31,0,31,31,0,0,0
교육기관,교육부,보나유치원,교육부 서울특별시교육청 서울특별시북부교육지원청 보나유치원,15,15,0,15,13,2,0,0
교육기관,교육부,보배유치원,교육부 서울특별시교육청 서울특별시북부교육지원청 보배유치원,9,9,0,9,2,7,0,0
교육기관,교육부,북서울중학교,교육부 서울특별시교육청 서울특별시북부교육지원청 북서울중학교,43,43,0,43,0,43,0,0
교육기관,교육부,사랑유치원,교육부 서울특별시교육청 서울특별시북부교육지원청 사랑유치원,24,24,0,24,0,24,0,0
교육기관,교육부,삼풍유치원,교육부 서울특별시교육청 서울특별시북부교육지원청 삼풍유치원,31,6,25,6,6,0,0,0
교육기관,교육부,상경중학교,교육부 서울특별시교육청 서울특별시북부교육지원청 상경중학교,18,16,2,16,11,5,0,0
교육기관,교육부,상계제일중학교,교육부 서울특별시교육청 서울특별시북부교육지원청 상계제일중학교,36,36,0,36,12,24,0,0
교육기관,교육부,상계중학교,교육부 서울특별시교육청 서울특별시북부교육지원청 상계중학교,16,15,1,15,13,2,0,0
교육기관,교육부,상명중학교,교육부 서울특별시교육청 서울특별시북부교육지원청 상명중학교,41,41,0,41,38,3,0,0
교육기관,교육부,상명초등학교,교육부 서울특별시교육청 서울특별시북부교육지원청 상명초등학교,62,62,0,62,9,51,0,2
교육기관,교육부,상원유치원,교육부 서울특별시교육청 서울특별시북부교육지원청 상원유치원,21,21,0,21,21,0,0,0
교육기관,교육부,상원중학교,교육부 서울특별시교육청 서울특별시북부교육지원청 상원중학교,30,30,0,30,3,27,0,0
교육기관,교육부,서울가인초등학교,교육부 서울특별시교육청 서울특별시북부교육지원청 서울가인초등학교,23,23,0,23,0,23,0,0
교육기관,교육부,서울가인초등학교병설유치원,교육부 서울특별시교육청 서울특별시북부교육지원청 서울가인초등학교병설유치원,9,0,9,0,0,0,0,0
교육기관,교육부,서울계상초등학교,교육부 서울특별시교육청 서울특별시북부교육지원청 서울계상초등학교,16,16,0,16,16,0,0,0
교육기관,교육부,서울계상초등학교병설유치원,교육부 서울특별시교육청 서울특별시북부교육지원청 서울계상초등학교병설유치원,4,4,0,4,4,0,0,0
교육기관,교육부,서울공릉초등학교,교육부 서울특별시교육청 서울특별시북부교육지원청 서울공릉초등학교,17,17,0,17,17,0,0,0
교육기관,교육부,서울노원초등학교,교육부 서울특별시교육청 서울특별시북부교육지원청 서울노원초등학교,17,17,0,17,17,0,0,0
교육기관,교육부,서울노일유치원,교육부 서울특별시교육청 서울특별시북부교육지원청 서울노일유치원,9,9,0,9,0,9,0,0
교육기관,교육부,서울노일초등학교,교육부 서울특별시교육청 서울특별시북부교육지원청 서울노일초등학교,13,13,0,13,13,0,0,0
교육기관,교육부,서울녹천초등학교,교육부 서울특별시교육청 서울특별시북부교육지원청 서울녹천초등학교,10,10,0,10,7,3,0,0
교육기관,교육부,서울누원초등학교,교육부 서울특별시교육청 서울특별시북부교육지원청 서울누원초등학교,13,13,0,13,0,13,0,0
교육기관,교육부,서울당현초등학교,교육부 서울특별시교육청 서울특별시북부교육지원청 서울당현초등학교,19,19,0,19,15,4,0,0
교육기관,교육부,서울당현초등학교병설유치원,교육부 서울특별시교육청 서울특별시북부교육지원청 서울당현초등학교병설유치원,6,6,0,6,0,6,0,0
교육기관,교육부,서울덕암초등학교,교육부 서울특별시교육청 서울특별시북부교육지원청 서울덕암초등학교,23,23,0,23,0,23,0,0
교육기관,교육부,서울도봉초등학교,교육부 서울특별시교육청 서울특별시북부교육지원청 서울도봉초등학교,14,14,0,14,0,14,0,0
교육기관,교육부,서울동일초등학교,교육부 서울특별시교육청 서울특별시북부교육지원청 서울동일초등학교,25,25,0,25,24,1,0,0
교육기관,교육부,서울마들유치원,교육부 서울특별시교육청 서울특별시북부교육지원청 서울마들유치원,15,7,8,7,3,4,0,0
교육기관,교육부,서울방학유치원,교육부 서울특별시교육청 서울특별시북부교육지원청 서울방학유치원,14,14,0,14,14,0,0,0
교육기관,교육부,서울방학초등학교,교육부 서울특별시교육청 서울특별시북부교육지원청 서울방학초등학교,26,26,0,26,26,0,0,0
교육기관,교육부,서울상경초등학교,교육부 서울특별시교육청 서울특별시북부교육지원청 서울상경초등학교,23,23,0,23,10,13,0,0
교육기관,교육부,서울상경초등학교병설유치원,교육부 서울특별시교육청 서울특별시북부교육지원청 서울상경초등학교병설유치원,7,7,0,7,0,7,0,0
교육기관,교육부,서울상계초등학교,교육부 서울특별시교육청 서울특별시북부교육지원청 서울상계초등학교,22,22,0,22,13,9,0,0
교육기관,교육부,서울상계초등학교병설유치원,교육부 서울특별시교육청 서울특별시북부교육지원청 서울상계초등학교병설유치원,5,0,5,0,0,0,0,0
교육기관,교육부,서울상곡초등학교,교육부 서울특별시교육청 서울특별시북부교육지원청 서울상곡초등학교,18,18,0,18,18,0,0,0
교육기관,교육부,서울상수초등학교,교육부 서울특별시교육청 서울특별시북부교육지원청 서울상수초등학교,21,21,0,21,21,0,0,0
교육기관,교육부,서울상원초등학교,교육부 서울특별시교육청 서울특별시북부교육지원청 서울상원초등학교,24,24,0,24,12,12,0,0
교육기관,교육부,서울상월초등학교,교육부 서울특별시교육청 서울특별시북부교육지원청 서울상월초등학교,16,16,0,16,12,2,2,0
교육기관,교육부,서울상천초등학교,교육부 서울특별시교육청 서울특별시북부교육지원청 서울상천초등학교,12,12,0,12,11,1,0,0
교육기관,교육부,서울수락산유치원,교육부 서울특별시교육청 서울특별시북부교육지원청 서울수락산유치원,8,8,0,8,0,8,0,0
교육기관,교육부,서울수락초등학교,교육부 서울특별시교육청 서울특별시북부교육지원청 서울수락초등학교,25,25,0,25,23,2,0,0
교육기관,교육부,서울수락초등학교병설유치원,교육부 서울특별시교육청 서울특별시북부교육지원청 서울수락초등학교병설유치원,7,7,0,7,0,7,0,0
교육기관,교육부,서울수암초등학교,교육부 서울특별시교육청 서울특별시북부교육지원청 서울수암초등학교,37,37,0,37,19,14,0,4
교육기관,교육부,서울수암초등학교병설유치원,교육부 서울특별시교육청 서울특별시북부교육지원청 서울수암초등학교병설유치원,3,2,1,2,0,2,0,0
교육기관,교육부,서울숭미초등학교,교육부 서울특별시교육청 서울특별시북부교육지원청 서울숭미초등학교,24,24,0,24,23,1,0,0
교육기관,교육부,서울숭미초등학교병설유치원,교육부 서울특별시교육청 서울특별시북부교육지원청 서울숭미초등학교병설유치원,5,5,0,5,2,3,0,0
교육기관,교육부,서울신계초등학교,교육부 서울특별시교육청 서울특별시북부교육지원청 서울신계초등학교,16,16,0,16,0,16,0,0
교육기관,교육부,서울신방학초등학교,교육부 서울특별시교육청 서울특별시북부교육지원청 서울신방학초등학교,20,20,0,20,16,4,0,0
교육기관,교육부,서울신상계초등학교,교육부 서울특별시교육청 서울특별시북부교육지원청 서울신상계초등학교,25,25,0,25,0,25,0,0
교육기관,교육부,서울신상계초등학교병설유치원,교육부 서울특별시교육청 서울특별시북부교육지원청 서울신상계초등학교병설유치원,8,0,8,0,0,0,0,0
교육기관,교육부,서울신창초등학교,교육부 서울특별시교육청 서울특별시북부교육지원청 서울신창초등학교,21,21,0,21,16,5,0,0
교육기관,교육부,서울신창초등학교병설유치원,교육부 서울특별시교육청 서울특별시북부교육지원청 서울신창초등학교병설유치원,7,7,0,7,1,6,0,0
교육기관,교육부,서울신학초등학교,교육부 서울특별시교육청 서울특별시북부교육지원청 서울신학초등학교,13,13,0,13,5,2,1,5
교육기관,교육부,서울신학초등학교병설유치원,교육부 서울특별시교육청 서울특별시북부교육지원청 서울신학초등학교병설유치원,8,8,0,8,4,4,0,0
교육기관,교육부,서울신화초등학교,교육부 서울특별시교육청 서울특별시북부교육지원청 서울신화초등학교,13,13,0,13,0,13,0,0
교육기관,교육부,서울쌍문초등학교,교육부 서울특별시교육청 서울특별시북부교육지원청 서울쌍문초등학교,23,23,0,23,0,23,0,0
교육기관,교육부,서울쌍문초등학교병설유치원,교육부 서울특별시교육청 서울특별시북부교육지원청 서울쌍문초등학교병설유치원,6,4,2,4,4,0,0,0
교육기관,교육부,서울여자대학교부속유치원,교육부 서울특별시교육청 서울특별시북부교육지원청 서울여자대학교부속유치원,16,16,0,16,2,14,0,0
교육기관,교육부,서울연지유치원,교육부 서울특별시교육청 서울특별시북부교육지원청 서울연지유치원,16,8,8,8,4,4,0,0
교육기관,교육부,서울연지초등학교,교육부 서울특별시교육청 서울특별시북부교육지원청 서울연지초등학교,19,19,0,19,0,19,0,0
교육기관,교육부,서울연촌초등학교,교육부 서울특별시교육청 서울특별시북부교육지원청 서울연촌초등학교,38,36,2,36,0,36,0,0
교육기관,교육부,서울연촌초등학교병설유치원,교육부 서울특별시교육청 서울특별시북부교육지원청 서울연촌초등학교병설유치원,5,5,0,5,0,5,0,0
교육기관,교육부,서울오봉초등학교,교육부 서울특별시교육청 서울특별시북부교육지원청 서울오봉초등학교,19,19,0,19,3,16,0,0
교육기관,교육부,서울오봉초등학교병설유치원,교육부 서울특별시교육청 서울특별시북부교육지원청 서울오봉초등학교병설유치원,0,0,0,0,0,0,0,0
교육기관,교육부,서울용동초등학교,교육부 서울특별시교육청 서울특별시북부교육지원청 서울용동초등학교,19,19,0,19,0,19,0,0
교육기관,교육부,서울용원초등학교,교육부 서울특별시교육청 서울특별시북부교육지원청 서울용원초등학교,22,22,0,22,0,22,0,0
교육기관,교육부,서울원광초등학교,교육부 서울특별시교육청 서울특별시북부교육지원청 서울원광초등학교,23,23,0,23,0,23,0,0
교육기관,교육부,서울월계초등학교,교육부 서울특별시교육청 서울특별시북부교육지원청 서울월계초등학교,9,9,0,9,0,9,0,0
교육기관,교육부,서울을지초등학교,교육부 서울특별시교육청 서울특별시북부교육지원청 서울을지초등학교,16,16,0,16,15,1,0,0
교육기관,교육부,서울자운초등학교,교육부 서울특별시교육청 서울특별시북부교육지원청 서울자운초등학교,17,17,0,17,0,17,0,0
교육기관,교육부,서울중계초등학교,교육부 서울특별시교육청 서울특별시북부교육지원청 서울중계초등학교,27,27,0,27,0,27,0,0
교육기관,교육부,서울중원초등학교,교육부 서울특별시교육청 서울특별시북부교육지원청 서울중원초등학교,19,19,0,19,0,19,0,0
교육기관,교육부,서울중평초등학교,교육부 서울특별시교육청 서울특별시북부교육지원청 서울중평초등학교,16,16,0,16,16,0,0,0
교육기관,교육부,서울중현초등학교,교육부 서울특별시교육청 서울특별시북부교육지원청 서울중현초등학교,23,23,0,23,23,0,0,0
교육기관,교육부,서울창경초등학교,교육부 서울특별시교육청 서울특별시북부교육지원청 서울창경초등학교,15,15,0,15,0,15,0,0
교육기관,교육부,서울창도초등학교,교육부 서울특별시교육청 서울특별시북부교육지원청 서울창도초등학교,26,26,0,26,0,26,0,0
교육기관,교육부,서울창동초등학교,교육부 서울특별시교육청 서울특별시북부교육지원청 서울창동초등학교,16,16,0,16,0,16,0,0
교육기관,교육부,서울창림초등학교,교육부 서울특별시교육청 서울특별시북부교육지원청 서울창림초등학교,27,27,0,27,15,12,0,0
교육기관,교육부,서울창원초등학교,교육부 서울특별시교육청 서울특별시북부교육지원청 서울창원초등학교,16,16,0,16,16,0,0,0
교육기관,교육부,서울창일초등학교,교육부 서울특별시교육청 서울특별시북부교육지원청 서울창일초등학교,15,15,0,15,5,10,0,0
교육기관,교육부,서울청계초등학교,교육부 서울특별시교육청 서울특별시북부교육지원청 서울청계초등학교,28,28,0,28,15,13,0,0
교육기관,교육부,서울초당초등학교,교육부 서울특별시교육청 서울특별시북부교육지원청 서울초당초등학교,26,26,0,26,0,26,0,0
교육기관,교육부,서울태랑초등학교,교육부 서울특별시교육청 서울특별시북부교육지원청 서울태랑초등학교,10,10,0,10,6,4,0,0
교육기관,교육부,서울태릉초등학교,교육부 서울특별시교육청 서울특별시북부교육지원청 서울태릉초등학교,20,20,0,20,20,0,0,0
교육기관,교육부,서울한천초등학교,교육부 서울특별시교육청 서울특별시북부교육지원청 서울한천초등학교,16,16,0,16,0,16,0,0
교육기관,교육부,선덕유치원,교육부 서울특별시교육청 서울특별시북부교육지원청 선덕유치원,16,16,0,16,8,8,0,0
교육기관,교육부,선덕중학교,교육부 서울특별시교육청 서울특별시북부교육지원청 선덕중학교,41,41,0,41,41,0,0,0
교육기관,교육부,성희유치원,교육부 서울특별시교육청 서울특별시북부교육지원청 성희유치원,25,1,24,1,1,0,0,0
교육기관,교육부,수락중학교,교육부 서울특별시교육청 서울특별시북부교육지원청 수락중학교,14,12,2,12,3,6,1,2
교육기관,교육부,슬기유치원,교육부 서울특별시교육청 서울특별시북부교육지원청 슬기유치원,19,19,0,19,0,19,0,0
교육기관,교육부,신도봉중학교,교육부 서울특별시교육청 서울특별시북부교육지원청 신도봉중학교,52,52,0,52,0,52,0,0
교육기관,교육부,신방학중학교,교육부 서울특별시교육청 서울특별시북부교육지원청 신방학중학교,12,12,0,12,12,0,0,0
교육기관,교육부,신상중학교,교육부 서울특별시교육청 서울특별시북부교육지원청 신상중학교,41,41,0,41,29,12,0,0
교육기관,교육부,신창중학교,교육부 서울특별시교육청 서울특별시북부교육지원청 신창중학교,47,47,0,47,35,12,0,0
교육기관,교육부,연세유치원,교육부 서울특별시교육청 서울특별시북부교육지원청 연세유치원,26,3,23,3,2,1,0,0
교육기관,교육부,염광중학교,교육부 서울특별시교육청 서울특별시북부교육지원청 염광중학교,25,25,0,25,8,17,0,0
교육기관,교육부,예진유치원,교육부 서울특별시교육청 서울특별시북부교육지원청 예진유치원,21,2,19,2,0,2,0,0
교육기관,교육부,온곡중학교,교육부 서울특별시교육청 서울특별시북부교육지원청 온곡중학교,36,9,27,9,0,9,0,0
교육기관,교육부,온누리유치원,교육부 서울특별시교육청 서울특별시북부교육지원청 온누리유치원,7,0,7,0,0,0,0,0
교육기관,교육부,우리유치원,교육부 서울특별시교육청 서울특별시북부교육지원청 우리유치원,15,15,0,15,0,15,0,0
교육기관,교육부,원암유치원,교육부 서울특별시교육청 서울특별시북부교육지원청 원암유치원,35,2,33,2,0,1,1,0
교육기관,교육부,월계중학교,교육부 서울특별시교육청 서울특별시북부교육지원청 월계중학교,36,36,0,36,0,36,0,0
교육기관,교육부,유화유치원,교육부 서울특별시교육청 서울특별시북부교육지원청 유화유치원,20,4,16,4,4,0,0,0
교육기관,교육부,육사유치원,교육부 서울특별시교육청 서울특별시북부교육지원청 육사유치원,14,2,12,2,1,1,0,0
교육기관,교육부,재현중학교,교육부 서울특별시교육청 서울특별시북부교육지원청 재현중학교,22,22,0,22,0,22,0,0
교육기관,교육부,정의여자중학교,교육부 서울특별시교육청 서울특별시북부교육지원청 정의여자중학교,35,35,0,35,27,8,0,0
교육기관,교육부,정의유치원,교육부 서울특별시교육청 서울특별시북부교육지원청 정의유치원,16,2,14,2,1,1,0,0
교육기관,교육부,중계중학교,교육부 서울특별시교육청 서울특별시북부교육지원청 중계중학교,27,26,1,26,17,9,0,0
교육기관,교육부,중원중학교,교육부 서울특별시교육청 서울특별시북부교육지원청 중원중학교,56,56,0,56,0,56,0,0
교육기관,교육부,중평중학교,교육부 서울특별시교육청 서울특별시북부교육지원청 중평중학교,35,35,0,35,3,32,0,0
교육기관,교육부,창동중학교,교육부 서울특별시교육청 서울특별시북부교육지원청 창동중학교,55,53,2,53,0,53,0,0
교육기관,교육부,창북중학교,교육부 서울특별시교육청 서울특별시북부교육지원청 창북중학교,26,25,1,25,15,10,0,0
교육기관,교육부,창일중학교,교육부 서울특별시교육청 서울특별시북부교육지원청 창일중학교,38,38,0,38,30,8,0,0
교육기관,교육부,청아유치원,교육부 서울특별시교육청 서울특별시북부교육지원청 청아유치원,13,3,10,3,0,3,0,0
교육기관,교육부,청원유치원,교육부 서울특별시교육청 서울특별시북부교육지원청 청원유치원,13,13,0,13,2,11,0,0
교육기관,교육부,청원중학교,교육부 서울특별시교육청 서울특별시북부교육지원청 청원중학교,37,37,0,37,31,6,0,0
교육기관,교육부,키즈위즈유치원,교육부 서울특별시교육청 서울특별시북부교육지원청 키즈위즈유치원,12,0,12,0,0,0,0,0
교육기관,교육부,태강삼육초등학교,교육부 서울특별시교육청 서울특별시북부교육지원청 태강삼육초등학교,51,51,0,51,0,51,0,0
교육기관,교육부,태랑중학교,교육부 서울특별시교육청 서울특별시북부교육지원청 태랑중학교,35,35,0,35,6,29,0,0
교육기관,교육부,하계중학교,교육부 서울특별시교육청 서울특별시북부교육지원청 하계중학교,49,49,0,49,10,39,0,0
교육기관,교육부,한국삼육중학교,교육부 서울특별시교육청 서울특별시북부교육지원청 한국삼육중학교,39,39,0,39,0,39,0,0
교육기관,교육부,한별유치원,교육부 서울특별시교육청 서울특별시북부교육지원청 한별유치원,10,2,8,2,1,1,0,0
교육기관,교육부,한신초등학교,교육부 서울특별시교육청 서울특별시북부교육지원청 한신초등학교,25,25,0,25,3,22,0,0
교육기관,교육부,한양유치원,교육부 서울특별시교육청 서울특별시북부교육지원청 한양유치원,21,6,15,6,0,6,0,0
교육기관,교육부,한천중학교,교육부 서울특별시교육청 서울특별시북부교육지원청 한천중학교,39,39,0,39,18,21,0,0
교육기관,교육부,행복한유치원,교육부 서울특별시교육청 서울특별시북부교육지원청 행복한유치원,10,10,0,10,10,0,0,0
교육기관,교육부,화랑초등학교,교육부 서울특별시교육청 서울특별시북부교육지원청 화랑초등학교,16,16,0,16,0,16,0,0
교육기관,교육부,효문중학교,교육부 서울특별시교육청 서울특별시북부교육지원청 효문중학교,44,44,0,44,0,44,0,0
교육기관,교육부,서울특별시서부교육지원청,교육부 서울특별시교육청 서울특별시서부교육지원청,16,16,0,16,0,16,0,0
교육기관,교육부,가재울중학교,교육부 서울특별시교육청 서울특별시서부교육지원청 가재울중학교,45,44,1,44,44,0,0,0
교육기관,교육부,경기초등학교,교육부 서울특별시교육청 서울특별시서부교육지원청 경기초등학교,88,88,0,88,24,64,0,0
교육기관,교육부,경성중학교,교육부 서울특별시교육청 서울특별시서부교육지원청 경성중학교,20,20,0,20,2,15,3,0
교육기관,교육부,광성중학교,교육부 서울특별시교육청 서울특별시서부교육지원청 광성중학교,17,15,2,15,10,5,0,0
교육기관,교육부,구산중학교,교육부 서울특별시교육청 서울특별시서부교육지원청 구산중학교,38,38,0,38,0,38,0,0
교육기관,교육부,녹번유치원,교육부 서울특별시교육청 서울특별시서부교육지원청 녹번유치원,9,9,0,9,9,0,0,0
교육기관,교육부,다우림명문유치원,교육부 서울특별시교육청 서울특별시서부교육지원청 다우림명문유치원,16,16,0,16,0,16,0,0
교육기관,교육부,대성중학교,교육부 서울특별시교육청 서울특별시서부교육지원청 대성중학교,42,42,0,42,0,42,0,0
교육기관,교육부,대진유치원,교육부 서울특별시교육청 서울특별시서부교육지원청 대진유치원,48,9,39,9,3,4,1,1
교육기관,교육부,덕산중학교,교육부 서울특별시교육청 서울특별시서부교육지원청 덕산중학교,48,48,0,48,17,30,1,0
교육기관,교육부,동도중학교,교육부 서울특별시교육청 서울특별시서부교육지원청 동도중학교,20,20,0,20,14,4,1,1
교육기관,교육부,동명여자중학교,교육부 서울특별시교육청 서울특별시서부교육지원청 동명여자중학교,15,15,0,15,13,2,0,0
교육기관,교육부,동산유치원,교육부 서울특별시교육청 서울특별시서부교육지원청 동산유치원,20,7,13,7,7,0,0,0
교육기관,교육부,마포대진유치원,교육부 서울특별시교육청 서울특별시서부교육지원청 마포대진유치원,105,7,98,7,7,0,0,0
교육기관,교육부,명지중학교,교육부 서울특별시교육청 서울특별시서부교육지원청 명지중학교,51,51,0,51,42,9,0,0
교육기관,교육부,명지초등학교,교육부 서울특별시교육청 서울특별시서부교육지원청 명지초등학교,38,3,35,3,3,0,0,0
교육기관,교육부,바다의별유치원,교육부 서울특별시교육청 서울특별시서부교육지원청 바다의별유치원,15,1,14,1,0,1,0,0
교육기관,교육부,배영유치원,교육부 서울특별시교육청 서울특별시서부교육지원청 배영유치원,20,20,0,20,20,0,0,0
교육기관,교육부,삼성그린유치원,교육부 서울특별시교육청 서울특별시서부교육지원청 삼성그린유치원,13,13,0,13,13,0,0,0
교육기관,교육부,삼성유치원,교육부 서울특별시교육청 서울특별시서부교육지원청 삼성유치원,14,3,11,3,3,0,0,0
교육기관,교육부,상신중학교,교육부 서울특별시교육청 서울특별시서부교육지원청 상신중학교,36,36,0,36,0,36,0,0
교육기관,교육부,상암중학교,교육부 서울특별시교육청 서울특별시서부교육지원청 상암중학교,33,32,1,32,32,0,0,0
교육기관,교육부,새보람유치원,교육부 서울특별시교육청 서울특별시서부교육지원청 새보람유치원,8,8,0,8,3,5,0,0
교육기관,교육부,서연중학교,교육부 서울특별시교육청 서울특별시서부교육지원청 서연중학교,25,25,0,25,0,25,0,0
교육기관,교육부,서울가재울초등학교,교육부 서울특별시교육청 서울특별시서부교육지원청 서울가재울초등학교,41,41,0,41,0,41,0,0
교육기관,교육부,서울갈현초등학교,교육부 서울특별시교육청 서울특별시서부교육지원청 서울갈현초등학교,21,21,0,21,5,11,5,0
교육기관,교육부,서울공덕초등학교,교육부 서울특별시교육청 서울특별시서부교육지원청 서울공덕초등학교,21,21,0,21,0,21,0,0
교육기관,교육부,서울공덕초등학교병설유치원,교육부 서울특별시교육청 서울특별시서부교육지원청 서울공덕초등학교병설유치원,6,6,0,6,6,0,0,0
교육기관,교육부,서울구산초등학교,교육부 서울특별시교육청 서울특별시서부교육지원청 서울구산초등학교,26,26,0,26,6,20,0,0
교육기관,교육부,서울구현초등학교,교육부 서울특별시교육청 서울특별시서부교육지원청 서울구현초등학교,24,24,0,24,24,0,0,0
교육기관,교육부,서울금화초등학교,교육부 서울특별시교육청 서울특별시서부교육지원청 서울금화초등학교,44,44,0,44,44,0,0,0
교육기관,교육부,서울녹번초등학교,교육부 서울특별시교육청 서울특별시서부교육지원청 서울녹번초등학교,27,27,0,27,0,27,0,0
교육기관,교육부,서울대신초등학교,교육부 서울특별시교육청 서울특별시서부교육지원청 서울대신초등학교,20,20,0,20,1,19,0,0
교육기관,교육부,서울대은초등학교,교육부 서울특별시교육청 서울특별시서부교육지원청 서울대은초등학교,20,20,0,20,20,0,0,0
교육기관,교육부,서울동교초등학교,교육부 서울특별시교육청 서울특별시서부교육지원청 서울동교초등학교,15,15,0,15,0,15,0,0
교육기관,교육부,서울마포초등학교,교육부 서울특별시교육청 서울특별시서부교육지원청 서울마포초등학교,22,22,0,22,8,14,0,0
교육기관,교육부,서울망원초등학교,교육부 서울특별시교육청 서울특별시서부교육지원청 서울망원초등학교,16,16,0,16,8,8,0,0
교육기관,교육부,서울미동초등학교,교육부 서울특별시교육청 서울특별시서부교육지원청 서울미동초등학교,18,18,0,18,2,16,0,0
교육기관,교육부,서울북가좌초등학교,교육부 서울특별시교육청 서울특별시서부교육지원청 서울북가좌초등학교,35,35,0,35,35,0,0,0
교육기관,교육부,서울북성유치원,교육부 서울특별시교육청 서울특별시서부교육지원청 서울북성유치원,8,8,0,8,3,5,0,0
교육기관,교육부,서울북성초등학교,교육부 서울특별시교육청 서울특별시서부교육지원청 서울북성초등학교,15,15,0,15,15,0,0,0
교육기관,교육부,서울북한산초등학교,교육부 서울특별시교육청 서울특별시서부교육지원청 서울북한산초등학교,19,19,0,19,17,0,2,0
교육기관,교육부,서울불광초등학교,교육부 서울특별시교육청 서울특별시서부교육지원청 서울불광초등학교,29,29,0,29,29,0,0,0
교육기관,교육부,서울불광초등학교병설유치원,교육부 서울특별시교육청 서울특별시서부교육지원청 서울불광초등학교병설유치원,9,0,9,0,0,0,0,0
교육기관,교육부,서울산울림유치원,교육부 서울특별시교육청 서울특별시서부교육지원청 서울산울림유치원,20,4,16,4,4,0,0,0
교육기관,교육부,서울상암초등학교,교육부 서울특별시교육청 서울특별시서부교육지원청 서울상암초등학교,25,0,25,0,0,0,0,0
교육기관,교육부,서울상지초등학교,교육부 서울특별시교육청 서울특별시서부교육지원청 서울상지초등학교,28,28,0,28,0,28,0,0
교육기관,교육부,서울서교초등학교,교육부 서울특별시교육청 서울특별시서부교육지원청 서울서교초등학교,24,24,0,24,21,3,0,0
교육기관,교육부,서울서신초등학교,교육부 서울특별시교육청 서울특별시서부교육지원청 서울서신초등학교,20,20,0,20,13,7,0,0
교육기관,교육부,서울성서초등학교,교육부 서울특별시교육청 서울특별시서부교육지원청 서울성서초등학교,28,28,0,28,0,28,0,0
교육기관,교육부,서울성원초등학교,교육부 서울특별시교육청 서울특별시서부교육지원청 서울성원초등학교,25,25,0,25,17,8,0,0
교육기관,교육부,서울소의초등학교,교육부 서울특별시교육청 서울특별시서부교육지원청 서울소의초등학교,60,60,0,60,60,0,0,0
교육기관,교육부,서울소의초등학교병설유치원,교육부 서울특별시교육청 서울특별시서부교육지원청 서울소의초등학교병설유치원,4,0,4,0,0,0,0,0
교육기관,교육부,서울수리초등학교,교육부 서울특별시교육청 서울특별시서부교육지원청 서울수리초등학교,38,38,0,38,38,0,0,0
교육기관,교육부,서울수색초등학교,교육부 서울특별시교육청 서울특별시서부교육지원청 서울수색초등학교,17,17,0,17,9,8,0,0
교육기관,교육부,서울수색초등학교병설유치원,교육부 서울특별시교육청 서울특별시서부교육지원청 서울수색초등학교병설유치원,7,7,0,7,1,6,0,0
교육기관,교육부,서울신도초등학교,교육부 서울특별시교육청 서울특별시서부교육지원청 서울신도초등학교,30,30,0,30,0,30,0,0
교육기관,교육부,서울신도초등학교병설유치원,교육부 서울특별시교육청 서울특별시서부교육지원청 서울신도초등학교병설유치원,7,1,6,1,1,0,0,0
교육기관,교육부,서울신북초등학교,교육부 서울특별시교육청 서울특별시서부교육지원청 서울신북초등학교,22,22,0,22,22,0,0,0
교육기관,교육부,서울신사초등학교,교육부 서울특별시교육청 서울특별시서부교육지원청 서울신사초등학교,21,21,0,21,0,21,0,0
교육기관,교육부,서울어울초등학교,교육부 서울특별시교육청 서울특별시서부교육지원청 서울어울초등학교,90,17,73,17,13,4,0,0
교육기관,교육부,서울여자중학교,교육부 서울특별시교육청 서울특별시서부교육지원청 서울여자중학교,22,22,0,22,22,0,0,0
교육기관,교육부,서울역촌유치원,교육부 서울특별시교육청 서울특별시서부교육지원청 서울역촌유치원,21,21,0,21,0,21,0,0
교육기관,교육부,서울역촌초등학교,교육부 서울특별시교육청 서울특별시서부교육지원청 서울역촌초등학교,45,45,0,45,45,0,0,0
교육기관,교육부,서울연가초등학교,교육부 서울특별시교육청 서울특별시서부교육지원청 서울연가초등학교,24,24,0,24,24,0,0,0
교육기관,교육부,서울연광초등학교,교육부 서울특별시교육청 서울특별시서부교육지원청 서울연광초등학교,19,19,0,19,19,0,0,0
교육기관,교육부,서울연신초등학교,교육부 서울특별시교육청 서울특별시서부교육지원청 서울연신초등학교,32,32,0,32,18,14,0,0
교육기관,교육부,서울연은초등학교,교육부 서울특별시교육청 서울특별시서부교육지원청 서울연은초등학교,28,28,0,28,0,28,0,0
교육기관,교육부,서울연천초등학교,교육부 서울특별시교육청 서울특별시서부교육지원청 서울연천초등학교,16,16,0,16,4,12,0,0
교육기관,교육부,서울연천초등학교병설유치원,교육부 서울특별시교육청 서울특별시서부교육지원청 서울연천초등학교병설유치원,13,0,13,0,0,0,0,0
교육기관,교육부,서울연희초등학교,교육부 서울특별시교육청 서울특별시서부교육지원청 서울연희초등학교,23,23,0,23,23,0,0,0
교육기관,교육부,서울용강초등학교병설유치원,교육부 서울특별시교육청 서울특별시서부교육지원청 서울용강초등학교병설유치원,7,7,0,7,5,2,0,0
교육기관,교육부,서울은명초등학교,교육부 서울특별시교육청 서울특별시서부교육지원청 서울은명초등학교,24,24,0,24,24,0,0,0
교육기관,교육부,서울은명초등학교병설유치원,교육부 서울특별시교육청 서울특별시서부교육지원청 서울은명초등학교병설유치원,5,2,3,2,1,1,0,0
교육기관,교육부,서울은빛유치원,교육부 서울특별시교육청 서울특별시서부교육지원청 서울은빛유치원,25,4,21,4,0,4,0,0
교육기관,교육부,서울은진초등학교,교육부 서울특별시교육청 서울특별시서부교육지원청 서울은진초등학교,12,12,0,12,12,0,0,0
교육기관,교육부,서울은평초등학교,교육부 서울특별시교육청 서울특별시서부교육지원청 서울은평초등학교,15,15,0,15,0,15,0,0
교육기관,교육부,서울은평초등학교병설유치원,교육부 서울특별시교육청 서울특별시서부교육지원청 서울은평초등학교병설유치원,4,4,0,4,0,4,0,0
교육기관,교육부,서울응암초등학교,교육부 서울특별시교육청 서울특별시서부교육지원청 서울응암초등학교,26,26,0,26,0,26,0,0
교육기관,교육부,서울인왕초등학교,교육부 서울특별시교육청 서울특별시서부교육지원청 서울인왕초등학교,21,21,0,21,21,0,0,0
교육기관,교육부,서울중동초등학교병설유치원,교육부 서울특별시교육청 서울특별시서부교육지원청 서울중동초등학교병설유치원,2,2,0,2,2,0,0,0
교육기관,교육부,서울증산초등학교,교육부 서울특별시교육청 서울특별시서부교육지원청 서울증산초등학교,23,23,0,23,20,3,0,0
교육기관,교육부,서울진관유치원,교육부 서울특별시교육청 서울특별시서부교육지원청 서울진관유치원,29,29,0,29,0,29,0,0
교육기관,교육부,서울진관초등학교,교육부 서울특별시교육청 서울특별시서부교육지원청 서울진관초등학교,27,27,0,27,0,27,0,0
교육기관,교육부,서울창서초등학교,교육부 서울특별시교육청 서울특별시서부교육지원청 서울창서초등학교,24,24,0,24,0,24,0,0
교육기관,교육부,서울창천초등학교,교육부 서울특별시교육청 서울특별시서부교육지원청 서울창천초등학교,22,22,0,22,12,10,0,0
교육기관,교육부,서울하늘초등학교,교육부 서울특별시교육청 서울특별시서부교육지원청 서울하늘초등학교,30,30,0,30,0,30,0,0
교육기관,교육부,서울한서초등학교,교육부 서울특별시교육청 서울특별시서부교육지원청 서울한서초등학교,27,18,9,18,4,14,0,0
교육기관,교육부,서울홍연초등학교,교육부 서울특별시교육청 서울특별시서부교육지원청 서울홍연초등학교,21,21,0,21,0,21,0,0
교육기관,교육부,서울홍은초등학교,교육부 서울특별시교육청 서울특별시서부교육지원청 서울홍은초등학교,23,23,0,23,22,1,0,0
교육기관,교육부,서울홍제초등학교,교육부 서울특별시교육청 서울특별시서부교육지원청 서울홍제초등학교,31,31,0,31,0,31,0,0
교육기관,교육부,서울홍제초등학교병설유치원,교육부 서울특별시교육청 서울특별시서부교육지원청 서울홍제초등학교병설유치원,8,1,7,1,1,0,0,0
교육기관,교육부,선일초등학교,교육부 서울특별시교육청 서울특별시서부교육지원청 선일초등학교,32,32,0,32,0,32,0,0
교육기관,교육부,선정중학교,교육부 서울특별시교육청 서울특별시서부교육지원청 선정중학교,38,38,0,38,0,38,0,0
교육기관,교육부,성결유치원,교육부 서울특별시교육청 서울특별시서부교육지원청 성결유치원,13,13,0,13,0,13,0,0
교육기관,교육부,성균관유치원,교육부 서울특별시교육청 서울특별시서부교육지원청 성균관유치원,23,23,0,23,2,21,0,0
교육기관,교육부,성사중학교,교육부 서울특별시교육청 서울특별시서부교육지원청 성사중학교,38,38,0,38,0,38,0,0
교육기관,교육부,성산중학교,교육부 서울특별시교육청 서울특별시서부교육지원청 성산중학교,32,32,0,32,30,2,0,0
교육기관,교육부,성서중학교,교육부 서울특별시교육청 서울특별시서부교육지원청 성서중학교,27,27,0,27,25,2,0,0
교육기관,교육부,숭문중학교,교육부 서울특별시교육청 서울특별시서부교육지원청 숭문중학교,20,20,0,20,11,9,0,0
교육기관,교육부,숭실중학교,교육부 서울특별시교육청 서울특별시서부교육지원청 숭실중학교,24,24,0,24,12,12,0,0
교육기관,교육부,숲유치원,교육부 서울특별시교육청 서울특별시서부교육지원청 숲유치원,26,6,20,6,2,2,1,1
교육기관,교육부,신도중학교,교육부 서울특별시교육청 서울특별시서부교육지원청 신도중학교,62,62,0,62,47,15,0,0
교육기관,교육부,신수중학교,교육부 서울특별시교육청 서울특별시서부교육지원청 신수중학교,32,7,25,7,0,7,0,0
교육기관,교육부,신연중학교,교육부 서울특별시교육청 서울특별시서부교육지원청 신연중학교,45,45,0,45,45,0,0,0
교육기관,교육부,신촌유치원,교육부 서울특별시교육청 서울특별시서부교육지원청 신촌유치원,32,4,28,4,1,3,0,0
교육기관,교육부,신현유치원,교육부 서울특별시교육청 서울특별시서부교육지원청 신현유치원,4,4,0,4,0,4,0,0
교육기관,교육부,아현중학교,교육부 서울특별시교육청 서울특별시서부교육지원청 아현중학교,35,35,0,35,3,32,0,0
교육기관,교육부,연서중학교,교육부 서울특별시교육청 서울특별시서부교육지원청 연서중학교,37,5,32,5,0,5,0,0
교육기관,교육부,연신중학교,교육부 서울특별시교육청 서울특별시서부교육지원청 연신중학교,65,65,0,65,65,0,0,0
교육기관,교육부,연유치원,교육부 서울특별시교육청 서울특별시서부교육지원청 연유치원,12,12,0,12,0,12,0,0
교육기관,교육부,연천중학교,교육부 서울특별시교육청 서울특별시서부교육지원청 연천중학교,31,31,0,31,0,31,0,0
교육기관,교육부,연희중학교,교육부 서울특별시교육청 서울특별시서부교육지원청 연희중학교,56,56,0,56,0,56,0,0
교육기관,교육부,영락중학교,교육부 서울특별시교육청 서울특별시서부교육지원청 영락중학교,16,16,0,16,16,0,0,0
교육기관,교육부,예일여자중학교,교육부 서울특별시교육청 서울특별시서부교육지원청 예일여자중학교,39,39,0,39,0,39,0,0
교육기관,교육부,예일유치원,교육부 서울특별시교육청 서울특별시서부교육지원청 예일유치원,16,16,0,16,8,8,0,0
교육기관,교육부,유정유치원,교육부 서울특별시교육청 서울특별시서부교육지원청 유정유치원,24,7,17,7,2,2,2,1
교육기관,교육부,은평중학교,교육부 서울특별시교육청 서울특별시서부교육지원청 은평중학교,36,36,0,36,0,36,0,0
교육기관,교육부,이화여자대학교사범대학부속이화금란중학교,교육부 서울특별시교육청 서울특별시서부교육지원청 이화여자대학교사범대학부속이화금란중학교,33,33,0,33,0,33,0,0
교육기관,교육부,이화여자대학교사범대학부속이화유치원,교육부 서울특별시교육청 서울특별시서부교육지원청 이화여자대학교사범대학부속이화유치원,13,13,0,13,3,10,0,0
교육기관,교육부,이화여자대학교사범대학부속초등학교,교육부 서울특별시교육청 서울특별시서부교육지원청 이화여자대학교사범대학부속초등학교,53,53,0,53,53,0,0,0
교육기관,교육부,인왕중학교,교육부 서울특별시교육청 서울특별시서부교육지원청 인왕중학교,72,72,0,72,0,72,0,0
교육기관,교육부,인창중학교,교육부 서울특별시교육청 서울특별시서부교육지원청 인창중학교,41,38,3,38,4,34,0,0
교육기관,교육부,자연유치원,교육부 서울특별시교육청 서울특별시서부교육지원청 자연유치원,12,12,0,12,2,10,0,0
교육기관,교육부,정원여자중학교,교육부 서울특별시교육청 서울특별시서부교육지원청 정원여자중학교,48,48,0,48,27,16,3,2
교육기관,교육부,조은유치원,교육부 서울특별시교육청 서울특별시서부교육지원청 조은유치원,16,16,0,16,0,16,0,0
교육기관,교육부,중암중학교,교육부 서울특별시교육청 서울특별시서부교육지원청 중암중학교,57,57,0,57,40,17,0,0
교육기관,교육부,중앙여자중학교,교육부 서울특별시교육청 서울특별시서부교육지원청 중앙여자중학교,13,13,0,13,10,3,0,0
교육기관,교육부,증산중학교,교육부 서울특별시교육청 서울특별시서부교육지원청 증산중학교,41,41,0,41,29,10,1,1
교육기관,교육부,진관중학교,교육부 서울특별시교육청 서울특별시서부교육지원청 진관중학교,41,41,0,41,20,21,0,0
교육기관,교육부,창천중학교,교육부 서울특별시교육청 서울특별시서부교육지원청 창천중학교,40,40,0,40,0,40,0,0
교육기관,교육부,충암유치원,교육부 서울특별시교육청 서울특별시서부교육지원청 충암유치원,21,21,0,21,0,21,0,0
교육기관,교육부,충암중학교,교육부 서울특별시교육청 서울특별시서부교육지원청 충암중학교,36,36,0,36,36,0,0,0
교육기관,교육부,충암초등학교,교육부 서울특별시교육청 서울특별시서부교육지원청 충암초등학교,33,33,0,33,0,33,0,0
교육기관,교육부,한성중학교,교육부 서울특별시교육청 서울특별시서부교육지원청 한성중학교,26,26,0,26,0,26,0,0
교육기관,교육부,한양제일유치원,교육부 서울특별시교육청 서울특별시서부교육지원청 한양제일유치원,9,1,8,1,0,1,0,0
교육기관,교육부,현대경복유치원,교육부 서울특별시교육청 서울특별시서부교육지원청 현대경복유치원,10,10,0,10,0,10,0,0
교육기관,교육부,현대홍익유치원,교육부 서울특별시교육청 서울특별시서부교육지원청 현대홍익유치원,16,16,0,16,10,6,0,0
교육기관,교육부,홍은중학교,교육부 서울특별시교육청 서울특별시서부교육지원청 홍은중학교,30,28,2,28,15,13,0,0
교육기관,교육부,홍익대학교사범대학부속여자중학교,교육부 서울특별시교육청 서울특별시서부교육지원청 홍익대학교사범대학부속여자중학교,28,28,0,28,28,0,0,0
교육기관,교육부,홍익대학교사범대학부속초등학교,교육부 서울특별시교육청 서울특별시서부교육지원청 홍익대학교사범대학부속초등학교,54,54,0,54,17,37,0,0
교육기관,교육부,홍제성당유치원,교육부 서울특별시교육청 서울특별시서부교육지원청 홍제성당유치원,14,5,9,5,5,0,0,0
교육기관,교육부,효림유치원,교육부 서울특별시교육청 서울특별시서부교육지원청 효림유치원,20,0,20,0,0,0,0,0
교육기관,교육부,서울특별시성동광진교육지원청,교육부 서울특별시교육청 서울특별시성동광진교육지원청,16,15,1,15,0,15,0,0
교육기관,교육부,경동유치원,교육부 서울특별시교육청 서울특별시성동광진교육지원청 경동유치원,16,0,16,0,0,0,0,0
교육기관,교육부,경복초등학교,교육부 서울특별시교육청 서울특별시성동광진교육지원청 경복초등학교,87,87,0,87,0,87,0,0
교육기관,교육부,광남유치원,교육부 서울특별시교육청 서울특별시성동광진교육지원청 광남유치원,16,1,15,1,0,1,0,0
교육기관,교육부,광남중학교,교육부 서울특별시교육청 서울특별시성동광진교육지원청 광남중학교,70,70,0,70,70,0,0,0
교육기관,교육부,광양중학교,교육부 서울특별시교육청 서울특별시성동광진교육지원청 광양중학교,35,35,0,35,0,35,0,0
교육기관,교육부,광장유치원,교육부 서울특별시교육청 서울특별시성동광진교육지원청 광장유치원,10,4,6,4,0,4,0,0
교육기관,교육부,광장중학교,교육부 서울특별시교육청 서울특별시성동광진교육지원청 광장중학교,32,32,0,32,0,32,0,0
교육기관,교육부,광진중학교,교육부 서울특별시교육청 서울특별시성동광진교육지원청 광진중학교,59,59,0,59,59,0,0,0
교육기관,교육부,광희중학교,교육부 서울특별시교육청 서울특별시성동광진교육지원청 광희중학교,43,43,0,43,21,22,0,0
교육기관,교육부,구의중학교,교육부 서울특별시교육청 서울특별시성동광진교육지원청 구의중학교,58,58,0,58,15,38,3,2
교육기관,교육부,금호유치원,교육부 서울특별시교육청 서울특별시성동광진교육지원청 금호유치원,6,6,0,6,6,0,0,0
교육기관,교육부,대원국제중학교,교육부 서울특별시교육청 서울특별시성동광진교육지원청 대원국제중학교,23,23,0,23,0,23,0,0
교육기관,교육부,동국대학교사범대학부속여자중학교,교육부 서울특별시교육청 서울특별시성동광진교육지원청 동국대학교사범대학부속여자중학교,43,43,0,43,13,30,0,0
교육기관,교육부,동마중학교,교육부 서울특별시교육청 서울특별시성동광진교육지원청 동마중학교,42,42,0,42,0,42,0,0
교육기관,교육부,마장중학교,교육부 서울특별시교육청 서울특별시성동광진교육지원청 마장중학교,60,60,0,60,0,60,0,0
교육기관,교육부,무학중학교,교육부 서울특별시교육청 서울특별시성동광진교육지원청 무학중학교,59,59,0,59,5,49,2,3
교육기관,교육부,미타유치원,교육부 서울특별시교육청 서울특별시성동광진교육지원청 미타유치원,16,4,12,4,3,1,0,0
교육기관,교육부,보성유치원,교육부 서울특별시교육청 서울특별시성동광진교육지원청 보성유치원,16,6,10,6,0,6,0,0
교육기관,교육부,서울경동유치원,교육부 서울특별시교육청 서울특별시성동광진교육지원청 서울경동유치원,9,9,0,9,0,9,0,0
교육기관,교육부,서울경동초등학교,교육부 서울특별시교육청 서울특별시성동광진교육지원청 서울경동초등학교,33,33,0,33,0,33,0,0
교육기관,교육부,서울경수초등학교,교육부 서울특별시교육청 서울특별시성동광진교육지원청 서울경수초등학교,26,26,0,26,26,0,0,0
교육기관,교육부,서울경수초등학교병설유치원,교육부 서울특별시교육청 서울특별시성동광진교육지원청 서울경수초등학교병설유치원,8,8,0,8,3,5,0,0
교육기관,교육부,서울경일초등학교,교육부 서울특별시교육청 서울특별시성동광진교육지원청 서울경일초등학교,27,27,0,27,0,27,0,0
교육기관,교육부,서울광남초등학교,교육부 서울특별시교육청 서울특별시성동광진교육지원청 서울광남초등학교,26,26,0,26,25,1,0,0
교육기관,교육부,서울광장초등학교,교육부 서울특별시교육청 서울특별시성동광진교육지원청 서울광장초등학교,24,24,0,24,13,11,0,0
교육기관,교육부,서울광진초등학교,교육부 서울특별시교육청 서울특별시성동광진교육지원청 서울광진초등학교,39,21,18,21,21,0,0,0
교육기관,교육부,서울구남초등학교,교육부 서울특별시교육청 서울특별시성동광진교육지원청 서울구남초등학교,15,15,0,15,0,15,0,0
교육기관,교육부,서울구의초등학교,교육부 서울특별시교육청 서울특별시성동광진교육지원청 서울구의초등학교,27,27,0,27,6,21,0,0
교육기관,교육부,서울구의초등학교병설유치원,교육부 서울특별시교육청 서울특별시성동광진교육지원청 서울구의초등학교병설유치원,3,3,0,3,1,2,0,0
교육기관,교육부,서울금북초등학교,교육부 서울특별시교육청 서울특별시성동광진교육지원청 서울금북초등학교,40,40,0,40,4,36,0,0
교육기관,교육부,서울금호초등학교,교육부 서울특별시교육청 서울특별시성동광진교육지원청 서울금호초등학교,20,0,20,0,0,0,0,0
교육기관,교육부,서울금호초등학교병설유치원,교육부 서울특별시교육청 서울특별시성동광진교육지원청 서울금호초등학교병설유치원,34,19,15,19,10,9,0,0
교육기관,교육부,서울동명초등학교,교육부 서울특별시교육청 서울특별시성동광진교육지원청 서울동명초등학교,31,31,0,31,10,21,0,0
교육기관,교육부,서울동의초등학교,교육부 서울특별시교육청 서울특별시성동광진교육지원청 서울동의초등학교,25,25,0,25,0,25,0,0
교육기관,교육부,서울동자초등학교,교육부 서울특별시교육청 서울특별시성동광진교육지원청 서울동자초등학교,15,15,0,15,0,15,0,0
교육기관,교육부,서울동호초등학교,교육부 서울특별시교육청 서울특별시성동광진교육지원청 서울동호초등학교,34,34,0,34,34,0,0,0
교육기관,교육부,서울마장초등학교,교육부 서울특별시교육청 서울특별시성동광진교육지원청 서울마장초등학교,32,32,0,32,4,28,0,0
교육기관,교육부,서울무학초등학교,교육부 서울특별시교육청 서울특별시성동광진교육지원청 서울무학초등학교,36,36,0,36,36,0,0,0
교육기관,교육부,서울사근초등학교,교육부 서울특별시교육청 서울특별시성동광진교육지원청 서울사근초등학교,18,16,2,16,0,16,0,0
교육기관,교육부,서울성수초등학교,교육부 서울특별시교육청 서울특별시성동광진교육지원청 서울성수초등학교,22,22,0,22,0,22,0,0
교육기관,교육부,서울성자초등학교,교육부 서울특별시교육청 서울특별시성동광진교육지원청 서울성자초등학교,17,17,0,17,3,14,0,0
교육기관,교육부,서울송원초등학교,교육부 서울특별시교육청 서울특별시성동광진교육지원청 서울송원초등학교,19,19,0,19,19,0,0,0
교육기관,교육부,서울송원초등학교병설유치원,교육부 서울특별시교육청 서울특별시성동광진교육지원청 서울송원초등학교병설유치원,3,3,0,3,1,2,0,0
교육기관,교육부,서울숭신초등학교,교육부 서울특별시교육청 서울특별시성동광진교육지원청 서울숭신초등학교,33,33,0,33,0,33,0,0
교육기관,교육부,서울신양초등학교,교육부 서울특별시교육청 서울특별시성동광진교육지원청 서울신양초등학교,25,25,0,25,15,10,0,0
교육기관,교육부,서울신자초등학교,교육부 서울특별시교육청 서울특별시성동광진교육지원청 서울신자초등학교,21,21,0,21,0,21,0,0
교육기관,교육부,서울신자초등학교병설유치원,교육부 서울특별시교육청 서울특별시성동광진교육지원청 서울신자초등학교병설유치원,5,5,0,5,0,5,0,0
교육기관,교육부,서울양남초등학교,교육부 서울특별시교육청 서울특별시성동광진교육지원청 서울양남초등학교,11,11,0,11,3,8,0,0
교육기관,교육부,서울양남초등학교병설유치원,교육부 서울특별시교육청 서울특별시성동광진교육지원청 서울양남초등학교병설유치원,4,4,0,4,2,2,0,0
교육기관,교육부,서울양진초등학교,교육부 서울특별시교육청 서울특별시성동광진교육지원청 서울양진초등학교,26,26,0,26,26,0,0,0
교육기관,교육부,서울양진초등학교병설유치원,교육부 서울특별시교육청 서울특별시성동광진교육지원청 서울양진초등학교병설유치원,5,5,0,5,5,0,0,0
교육기관,교육부,서울옥수초등학교,교육부 서울특별시교육청 서울특별시성동광진교육지원청 서울옥수초등학교,31,31,0,31,0,31,0,0
교육기관,교육부,서울옥정초등학교,교육부 서울특별시교육청 서울특별시성동광진교육지원청 서울옥정초등학교,27,27,0,27,27,0,0,0
교육기관,교육부,서울옥정초등학교병설유치원,교육부 서울특별시교육청 서울특별시성동광진교육지원청 서울옥정초등학교병설유치원,0,0,0,0,0,0,0,0
교육기관,교육부,서울용곡초등학교,교육부 서울특별시교육청 서울특별시성동광진교육지원청 서울용곡초등학교,25,25,0,25,0,25,0,0
교육기관,교육부,서울용답초등학교,교육부 서울특별시교육청 서울특별시성동광진교육지원청 서울용답초등학교,32,32,0,32,26,5,1,0
교육기관,교육부,서울용답초등학교병설유치원,교육부 서울특별시교육청 서울특별시성동광진교육지원청 서울용답초등학교병설유치원,5,5,0,5,5,0,0,0
교육기관,교육부,서울용마초등학교,교육부 서울특별시교육청 서울특별시성동광진교육지원청 서울용마초등학교,16,16,0,16,0,16,0,0
교육기관,교육부,서울응봉초등학교,교육부 서울특별시교육청 서울특별시성동광진교육지원청 서울응봉초등학교,16,16,0,16,11,5,0,0
교육기관,교육부,서울자양초등학교,교육부 서울특별시교육청 서울특별시성동광진교육지원청 서울자양초등학교,18,18,0,18,18,0,0,0
교육기관,교육부,서울자양초등학교병설유치원,교육부 서울특별시교육청 서울특별시성동광진교육지원청 서울자양초등학교병설유치원,3,1,2,1,1,0,0,0
교육기관,교육부,서울장안초등학교,교육부 서울특별시교육청 서울특별시성동광진교육지원청 서울장안초등학교,27,27,0,27,27,0,0,0
교육기관,교육부,서울중광초등학교,교육부 서울특별시교육청 서울특별시성동광진교육지원청 서울중광초등학교,24,24,0,24,24,0,0,0
교육기관,교육부,서울중광초등학교병설유치원,교육부 서울특별시교육청 서울특별시성동광진교육지원청 서울중광초등학교병설유치원,7,7,0,7,7,0,0,0
교육기관,교육부,서울중마초등학교,교육부 서울특별시교육청 서울특별시성동광진교육지원청 서울중마초등학교,30,30,0,30,15,15,0,0
교육기관,교육부,서울행당초등학교,교육부 서울특별시교육청 서울특별시성동광진교육지원청 서울행당초등학교,20,20,0,20,20,0,0,0
교육기관,교육부,서울행현초등학교,교육부 서울특별시교육청 서울특별시성동광진교육지원청 서울행현초등학교,25,25,0,25,17,8,0,0
교육기관,교육부,선경유치원,교육부 서울특별시교육청 서울특별시성동광진교육지원청 선경유치원,28,28,0,28,28,0,0,0
교육기관,교육부,선화예술학교,교육부 서울특별시교육청 서울특별시성동광진교육지원청 선화예술학교,100,100,0,100,100,0,0,0
교육기관,교육부,성동초등학교,교육부 서울특별시교육청 서울특별시성동광진교육지원청 성동초등학교,4,4,0,4,0,4,0,0
교육기관,교육부,성산유치원,교육부 서울특별시교육청 서울특별시성동광진교육지원청 성산유치원,1,0,1,0,0,0,0,0
교육기관,교육부,성수중학교,교육부 서울특별시교육청 서울특별시성동광진교육지원청 성수중학교,32,32,0,32,17,15,0,0
교육기관,교육부,성심유치원,교육부 서울특별시교육청 서울특별시성동광진교육지원청 성심유치원,11,11,0,11,0,11,0,0
교육기관,교육부,성원중학교,교육부 서울특별시교육청 서울특별시성동광진교육지원청 성원중학교,49,49,0,49,15,34,0,0
교육기관,교육부,세종초등학교,교육부 서울특별시교육청 서울특별시성동광진교육지원청 세종초등학교,25,25,0,25,0,25,0,0
교육기관,교육부,슬기유치원,교육부 서울특별시교육청 서울특별시성동광진교육지원청 슬기유치원,16,16,0,16,14,2,0,0
교육기관,교육부,신양중학교,교육부 서울특별시교육청 서울특별시성동광진교육지원청 신양중학교,56,56,0,56,56,0,0,0
교육기관,교육부,아이들세상유치원,교육부 서울특별시교육청 서울특별시성동광진교육지원청 아이들세상유치원,10,4,6,4,1,1,1,1
교육기관,교육부,양진중학교,교육부 서울특별시교육청 서울특별시성동광진교육지원청 양진중학교,46,46,0,46,36,10,0,0
교육기관,교육부,에덴유치원,교육부 서울특별시교육청 서울특별시성동광진교육지원청 에덴유치원,16,16,0,16,0,16,0,0
교육기관,교육부,영화유치원,교육부 서울특별시교육청 서울특별시성동광진교육지원청 영화유치원,11,11,0,11,2,9,0,0
교육기관,교육부,옥정중학교,교육부 서울특별시교육청 서울특별시성동광진교육지원청 옥정중학교,39,38,1,38,33,3,2,0
교육기관,교육부,율화유치원,교육부 서울특별시교육청 서울특별시성동광진교육지원청 율화유치원,13,13,0,13,1,12,0,0
교육기관,교육부,인애유치원,교육부 서울특별시교육청 서울특별시성동광진교육지원청 인애유치원,7,0,7,0,0,0,0,0
교육기관,교육부,자양중학교,교육부 서울특별시교육청 서울특별시성동광진교육지원청 자양중학교,69,68,1,68,30,38,0,0
교육기관,교육부,조은유치원,교육부 서울특별시교육청 서울특별시성동광진교육지원청 조은유치원,8,0,8,0,0,0,0,0
교육기관,교육부,청구이화유치원,교육부 서울특별시교육청 서울특별시성동광진교육지원청 청구이화유치원,16,16,0,16,0,16,0,0
교육기관,교육부,프라임유치원,교육부 서울특별시교육청 서울특별시성동광진교육지원청 프라임유치원,22,22,0,22,1,21,0,0
교육기관,교육부,한양여자대학교부속유치원,교육부 서울특별시교육청 서울특별시성동광진교육지원청 한양여자대학교부속유치원,23,23,0,23,23,0,0,0
교육기관,교육부,한양초등학교,교육부 서울특별시교육청 서울특별시성동광진교육지원청 한양초등학교,48,48,0,48,48,0,0,0
교육기관,교육부,한일유치원,교육부 서울특별시교육청 서울특별시성동광진교육지원청 한일유치원,16,0,16,0,0,0,0,0
교육기관,교육부,행당중학교,교육부 서울특별시교육청 서울특별시성동광진교육지원청 행당중학교,58,58,0,58,58,0,0,0
교육기관,교육부,서울특별시성북강북교육지원청,교육부 서울특별시교육청 서울특별시성북강북교육지원청,16,16,0,16,0,16,0,0
교육기관,교육부,강북중학교,교육부 서울특별시교육청 서울특별시성북강북교육지원청 강북중학교,69,69,0,69,9,60,0,0
교육기관,교육부,개운중학교,교육부 서울특별시교육청 서울특별시성북강북교육지원청 개운중학교,54,54,0,54,38,16,0,0
교육기관,교육부,고려대학교사범대학부속중학교,교육부 서울특별시교육청 서울특별시성북강북교육지원청 고려대학교사범대학부속중학교,29,29,0,29,0,29,0,0
교육기관,교육부,고명중학교,교육부 서울특별시교육청 서울특별시성북강북교육지원청 고명중학교,22,22,0,22,0,22,0,0
교육기관,교육부,광운초등학교,교육부 서울특별시교육청 서울특별시성북강북교육지원청 광운초등학교,16,16,0,16,0,16,0,0
교육기관,교육부,길음중학교,교육부 서울특별시교육청 서울특별시성북강북교육지원청 길음중학교,55,55,0,55,20,35,0,0
교육기관,교육부,나래유치원,교육부 서울특별시교육청 서울특별시성북강북교육지원청 나래유치원,3,3,0,3,1,2,0,0
교육기관,교육부,남대문중학교,교육부 서울특별시교육청 서울특별시성북강북교육지원청 남대문중학교,53,53,0,53,16,37,0,0
교육기관,교육부,대광초등학교,교육부 서울특별시교육청 서울특별시성북강북교육지원청 대광초등학교,16,16,0,16,0,16,0,0
교육기관,교육부,덕수유치원,교육부 서울특별시교육청 서울특별시성북강북교육지원청 덕수유치원,32,8,24,8,4,4,0,0
교육기관,교육부,동덕여자대학교부속유치원,교육부 서울특별시교육청 서울특별시성북강북교육지원청 동덕여자대학교부속유치원,15,4,11,4,0,4,0,0
교육기관,교육부,두산효자유치원,교육부 서울특별시교육청 서울특별시성북강북교육지원청 두산효자유치원,16,6,10,6,2,2,1,1
교육기관,교육부,매원초등학교,교육부 서울특별시교육청 서울특별시성북강북교육지원청 매원초등학교,36,36,0,36,8,28,0,0
교육기관,교육부,미양중학교,교육부 서울특별시교육청 서울특별시성북강북교육지원청 미양중학교,45,45,0,45,0,45,0,0
교육기관,교육부,반디유치원,교육부 서울특별시교육청 서울특별시성북강북교육지원청 반디유치원,15,15,0,15,2,13,0,0
교육기관,교육부,북악중학교,교육부 서울특별시교육청 서울특별시성북강북교육지원청 북악중학교,30,30,0,30,30,0,0,0
교육기관,교육부,삼각산중학교,교육부 서울특별시교육청 서울특별시성북강북교육지원청 삼각산중학교,48,48,0,48,0,48,0,0
교육기관,교육부,삼선중학교,교육부 서울특별시교육청 서울특별시성북강북교육지원청 삼선중학교,73,73,0,73,0,73,0,0
교육기관,교육부,새삼선유치원,교육부 서울특별시교육청 서울특별시성북강북교육지원청 새삼선유치원,16,16,0,16,1,15,0,0
교육기관,교육부,새싹유치원,교육부 서울특별시교육청 서울특별시성북강북교육지원청 새싹유치원,22,22,0,22,0,22,0,0
교육기관,교육부,서라벌중학교,교육부 서울특별시교육청 서울특별시성북강북교육지원청 서라벌중학교,29,29,0,29,27,2,0,0
교육기관,교육부,서울개운초등학교,교육부 서울특별시교육청 서울특별시성북강북교육지원청 서울개운초등학교,28,28,0,28,28,0,0,0
교육기관,교육부,서울길원초등학교,교육부 서울특별시교육청 서울특별시성북강북교육지원청 서울길원초등학교,31,31,0,31,31,0,0,0
교육기관,교육부,서울길음유치원,교육부 서울특별시교육청 서울특별시성북강북교육지원청 서울길음유치원,10,10,0,10,0,10,0,0
교육기관,교육부,서울길음초등학교,교육부 서울특별시교육청 서울특별시성북강북교육지원청 서울길음초등학교,16,16,0,16,0,16,0,0
교육기관,교육부,서울대학교사범대학부설중학교,교육부 서울특별시교육청 서울특별시성북강북교육지원청 서울대학교사범대학부설중학교,47,47,0,47,0,47,0,0
교육기관,교육부,서울돈암초등학교,교육부 서울특별시교육청 서울특별시성북강북교육지원청 서울돈암초등학교,35,35,0,35,0,35,0,0
교육기관,교육부,서울돈암초등학교병설유치원,교육부 서울특별시교육청 서울특별시성북강북교육지원청 서울돈암초등학교병설유치원,4,4,0,4,4,0,0,0
교육기관,교육부,서울동신초등학교,교육부 서울특별시교육청 서울특별시성북강북교육지원청 서울동신초등학교,14,11,3,11,11,0,0,0
교육기관,교육부,서울동신초등학교병설유치원,교육부 서울특별시교육청 서울특별시성북강북교육지원청 서울동신초등학교병설유치원,10,2,8,2,0,2,0,0
교육기관,교육부,서울미아초등학교,교육부 서울특별시교육청 서울특별시성북강북교육지원청 서울미아초등학교,14,14,0,14,14,0,0,0
교육기관,교육부,서울미양초등학교병설유치원,교육부 서울특별시교육청 서울특별시성북강북교육지원청 서울미양초등학교병설유치원,8,2,6,2,2,0,0,0
교육기관,교육부,서울번동초등학교,교육부 서울특별시교육청 서울특별시성북강북교육지원청 서울번동초등학교,27,27,0,27,9,18,0,0
교육기관,교육부,서울베네딕도유치원,교육부 서울특별시교육청 서울특별시성북강북교육지원청 서울베네딕도유치원,28,28,0,28,28,0,0,0
교육기관,교육부,서울삼양초등학교,교육부 서울특별시교육청 서울특별시성북강북교육지원청 서울삼양초등학교,25,25,0,25,5,20,0,0
교육기관,교육부,서울석계초등학교,교육부 서울특별시교육청 서울특별시성북강북교육지원청 서울석계초등학교,20,20,0,20,20,0,0,0
교육기관,교육부,서울석관초등학교,교육부 서울특별시교육청 서울특별시성북강북교육지원청 서울석관초등학교,17,17,0,17,17,0,0,0
교육기관,교육부,서울석관초등학교병설유치원,교육부 서울특별시교육청 서울특별시성북강북교육지원청 서울석관초등학교병설유치원,10,0,10,0,0,0,0,0
교육기관,교육부,서울성북초등학교,교육부 서울특별시교육청 서울특별시성북강북교육지원청 서울성북초등학교,44,44,0,44,13,31,0,0
교육기관,교육부,서울송중초등학교,교육부 서울특별시교육청 서울특별시성북강북교육지원청 서울송중초등학교,33,26,7,26,0,24,2,0
교육기관,교육부,서울송천초등학교,교육부 서울특별시교육청 서울특별시성북강북교육지원청 서울송천초등학교,30,30,0,30,30,0,0,0
교육기관,교육부,서울송천초등학교병설유치원,교육부 서울특별시교육청 서울특별시성북강북교육지원청 서울송천초등학교병설유치원,7,2,5,2,1,1,0,0
교육기관,교육부,서울수송초등학교,교육부 서울특별시교육청 서울특별시성북강북교육지원청 서울수송초등학교,39,39,0,39,24,15,0,0
교육기관,교육부,서울수송초등학교병설유치원,교육부 서울특별시교육청 서울특별시성북강북교육지원청 서울수송초등학교병설유치원,14,0,14,0,0,0,0,0
교육기관,교육부,서울수유초등학교,교육부 서울특별시교육청 서울특별시성북강북교육지원청 서울수유초등학교,23,23,0,23,23,0,0,0
교육기관,교육부,서울수유초등학교병설유치원,교육부 서울특별시교육청 서울특별시성북강북교육지원청 서울수유초등학교병설유치원,11,11,0,11,11,0,0,0
교육기관,교육부,서울숭곡초등학교,교육부 서울특별시교육청 서울특별시성북강북교육지원청 서울숭곡초등학교,15,15,0,15,15,0,0,0
교육기관,교육부,서울숭곡초등학교병설유치원,교육부 서울특별시교육청 서울특별시성북강북교육지원청 서울숭곡초등학교병설유치원,4,4,0,4,0,4,0,0
교육기관,교육부,서울숭덕초등학교,교육부 서울특별시교육청 서울특별시성북강북교육지원청 서울숭덕초등학교,30,30,0,30,0,30,0,0
교육기관,교육부,서울숭례초등학교병설유치원,교육부 서울특별시교육청 서울특별시성북강북교육지원청 서울숭례초등학교병설유치원,7,7,0,7,0,7,0,0
교육기관,교육부,서울숭인초등학교,교육부 서울특별시교육청 서울특별시성북강북교육지원청 서울숭인초등학교,28,28,0,28,28,0,0,0
교육기관,교육부,서울안암초등학교,교육부 서울특별시교육청 서울특별시성북강북교육지원청 서울안암초등학교,28,28,0,28,14,14,0,0
교육기관,교육부,서울오현초등학교,교육부 서울특별시교육청 서울특별시성북강북교육지원청 서울오현초등학교,25,25,0,25,0,25,0,0
교육기관,교육부,서울우이유치원,교육부 서울특별시교육청 서울특별시성북강북교육지원청 서울우이유치원,35,35,0,35,11,24,0,0
교육기관,교육부,서울우이초등학교,교육부 서울특별시교육청 서울특별시성북강북교육지원청 서울우이초등학교,20,20,0,20,20,0,0,0
교육기관,교육부,서울월곡초등학교,교육부 서울특별시교육청 서울특별시성북강북교육지원청 서울월곡초등학교,18,18,0,18,0,18,0,0
교육기관,교육부,서울유현초등학교,교육부 서울특별시교육청 서울특별시성북강북교육지원청 서울유현초등학교,16,16,0,16,0,16,0,0
교육기관,교육부,서울인수초등학교,교육부 서울특별시교육청 서울특별시성북강북교육지원청 서울인수초등학교,27,27,0,27,0,27,0,0
교육기관,교육부,서울일신초등학교,교육부 서울특별시교육청 서울특별시성북강북교육지원청 서울일신초등학교,21,21,0,21,11,10,0,0
교육기관,교육부,서울장곡초등학교,교육부 서울특별시교육청 서울특별시성북강북교육지원청 서울장곡초등학교,11,11,0,11,11,0,0,0
교육기관,교육부,서울장곡초등학교병설유치원,교육부 서울특별시교육청 서울특별시성북강북교육지원청 서울장곡초등학교병설유치원,4,4,0,4,2,2,0,0
교육기관,교육부,서울장월초등학교,교육부 서울특별시교육청 서울특별시성북강북교육지원청 서울장월초등학교,28,28,0,28,8,20,0,0
교육기관,교육부,서울장월초등학교병설유치원,교육부 서울특별시교육청 서울특별시성북강북교육지원청 서울장월초등학교병설유치원,3,3,0,3,0,3,0,0
교육기관,교육부,서울장위초등학교,교육부 서울특별시교육청 서울특별시성북강북교육지원청 서울장위초등학교,48,48,0,48,0,48,0,0
교육기관,교육부,서울장위초등학교병설유치원,교육부 서울특별시교육청 서울특별시성북강북교육지원청 서울장위초등학교병설유치원,12,0,12,0,0,0,0,0
교육기관,교육부,서울정덕초등학교,교육부 서울특별시교육청 서울특별시성북강북교육지원청 서울정덕초등학교,22,22,0,22,20,2,0,0
교육기관,교육부,서울정덕초등학교병설유치원,교육부 서울특별시교육청 서울특별시성북강북교육지원청 서울정덕초등학교병설유치원,6,6,0,6,0,6,0,0
교육기관,교육부,서울정릉초등학교,교육부 서울특별시교육청 서울특별시성북강북교육지원청 서울정릉초등학교,24,24,0,24,9,15,0,0
교육기관,교육부,서울정수초등학교,교육부 서울특별시교육청 서울특별시성북강북교육지원청 서울정수초등학교,23,23,0,23,23,0,0,0
교육기관,교육부,서울좋은소리유치원,교육부 서울특별시교육청 서울특별시성북강북교육지원청 서울좋은소리유치원,25,25,0,25,0,25,0,0
교육기관,교육부,서울청덕초등학교,교육부 서울특별시교육청 서울특별시성북강북교육지원청 서울청덕초등학교,50,50,0,50,27,23,0,0
교육기관,교육부,서울청덕초등학교병설유치원,교육부 서울특별시교육청 서울특별시성북강북교육지원청 서울청덕초등학교병설유치원,7,7,0,7,7,0,0,0
교육기관,교육부,서울화계초등학교,교육부 서울특별시교육청 서울특별시성북강북교육지원청 서울화계초등학교,34,34,0,34,0,34,0,0
교육기관,교육부,서울화계초등학교병설유치원,교육부 서울특별시교육청 서울특별시성북강북교육지원청 서울화계초등학교병설유치원,5,5,0,5,0,5,0,0
교육기관,교육부,성신여자중학교,교육부 서울특별시교육청 서울특별시성북강북교육지원청 성신여자중학교,34,34,0,34,18,16,0,0
교육기관,교육부,성신유치원,교육부 서울특별시교육청 서울특별시성북강북교육지원청 성신유치원,22,22,0,22,0,22,0,0
교육기관,교육부,성신초등학교,교육부 서울특별시교육청 서울특별시성북강북교육지원청 성신초등학교,16,16,0,16,8,8,0,0
교육기관,교육부,성실유치원,교육부 서울특별시교육청 서울특별시성북강북교육지원청 성실유치원,15,2,13,2,0,2,0,0
교육기관,교육부,성암여자중학교,교육부 서울특별시교육청 서울특별시성북강북교육지원청 성암여자중학교,24,24,0,24,11,13,0,0
교육기관,교육부,성체유치원,교육부 서울특별시교육청 서울특별시성북강북교육지원청 성체유치원,10,2,8,2,1,1,0,0
교육기관,교육부,솔샘유치원,교육부 서울특별시교육청 서울특별시성북강북교육지원청 솔샘유치원,32,0,32,0,0,0,0,0
교육기관,교육부,수유중학교,교육부 서울특별시교육청 서울특별시성북강북교육지원청 수유중학교,53,40,13,40,35,5,0,0
교육기관,교육부,숭곡중학교,교육부 서울특별시교육청 서울특별시성북강북교육지원청 숭곡중학교,44,44,0,44,0,40,4,0
교육기관,교육부,신암유치원,교육부 서울특별시교육청 서울특별시성북강북교육지원청 신암유치원,15,4,11,4,2,2,0,0
교육기관,교육부,신일중학교,교육부 서울특별시교육청 서울특별시성북강북교육지원청 신일중학교,46,46,0,46,0,46,0,0
교육기관,교육부,영암유치원,교육부 서울특별시교육청 서울특별시성북강북교육지원청 영암유치원,4,4,0,4,2,2,0,0
교육기관,교육부,영재유치원,교육부 서울특별시교육청 서울특별시성북강북교육지원청 영재유치원,15,15,0,15,0,15,0,0
교육기관,교육부,영천유치원,교육부 서울특별시교육청 서울특별시성북강북교육지원청 영천유치원,8,8,0,8,8,0,0,0
교육기관,교육부,영훈초등학교,교육부 서울특별시교육청 서울특별시성북강북교육지원청 영훈초등학교,40,15,25,15,0,15,0,0
교육기관,교육부,예원유치원,교육부 서울특별시교육청 서울특별시성북강북교육지원청 예원유치원,8,8,0,8,0,8,0,0
교육기관,교육부,용문중학교,교육부 서울특별시교육청 서울특별시성북강북교육지원청 용문중학교,14,14,0,14,0,14,0,0
교육기관,교육부,우촌초등학교,교육부 서울특별시교육청 서울특별시성북강북교육지원청 우촌초등학교,69,69,0,69,2,67,0,0
교육기관,교육부,월곡중학교,교육부 서울특별시교육청 서울특별시성북강북교육지원청 월곡중학교,24,24,0,24,24,0,0,0
교육기관,교육부,인수중학교,교육부 서울특별시교육청 서울특별시성북강북교육지원청 인수중학교,50,50,0,50,50,0,0,0
교육기관,교육부,장위중학교,교육부 서울특별시교육청 서울특별시성북강북교육지원청 장위중학교,71,21,50,21,15,6,0,0
교육기관,교육부,종암중학교,교육부 서울특별시교육청 서울특별시성북강북교육지원청 종암중학교,57,57,0,57,0,57,0,0
교육기관,교육부,좋은나라유치원,교육부 서울특별시교육청 서울특별시성북강북교육지원청 좋은나라유치원,64,64,0,64,0,64,0,0
교육기관,교육부,창문여자중학교,교육부 서울특별시교육청 서울특별시성북강북교육지원청 창문여자중학교,44,44,0,44,0,44,0,0
교육기관,교육부,탑주유치원,교육부 서울특별시교육청 서울특별시성북강북교육지원청 탑주유치원,24,2,22,2,0,2,0,0
교육기관,교육부,한가람유치원,교육부 서울특별시교육청 서울특별시성북강북교육지원청 한가람유치원,16,0,16,0,0,0,0,0
교육기관,교육부,한성여자중학교,교육부 서울특별시교육청 서울특별시성북강북교육지원청 한성여자중학교,30,30,0,30,16,14,0,0
교육기관,교육부,홍익대학교사범대학부속중학교,교육부 서울특별시교육청 서울특별시성북강북교육지원청 홍익대학교사범대학부속중학교,36,36,0,36,36,0,0,0
교육기관,교육부,화계유치원,교육부 서울특별시교육청 서울특별시성북강북교육지원청 화계유치원,14,0,14,0,0,0,0,0
교육기관,교육부,화계중학교,교육부 서울특별시교육청 서울특별시성북강북교육지원청 화계중학교,63,63,0,63,63,0,0,0
교육기관,교육부,희망찬유치원,교육부 서울특별시교육청 서울특별시성북강북교육지원청 희망찬유치원,32,32,0,32,32,0,0,0
교육기관,교육부,서울특별시유아교육진흥원,교육부 서울특별시교육청 서울특별시유아교육진흥원,69,69,0,69,0,69,0,0
교육기관,교육부,서울특별시중부교육지원청,교육부 서울특별시교육청 서울특별시중부교육지원청,21,21,0,21,0,21,0,0
교육기관,교육부,가명유치원,교육부 서울특별시교육청 서울특별시중부교육지원청 가명유치원,12,12,0,12,4,8,0,0
교육기관,교육부,강변유치원,교육부 서울특별시교육청 서울특별시중부교육지원청 강변유치원,6,0,6,0,0,0,0,0
교육기관,교육부,경신중학교,교육부 서울특별시교육청 서울특별시중부교육지원청 경신중학교,16,16,0,16,16,0,0,0
교육기관,교육부,계성유치원,교육부 서울특별시교육청 서울특별시중부교육지원청 계성유치원,32,32,0,32,0,32,0,0
교육기관,교육부,근화유치원,교육부 서울특별시교육청 서울특별시중부교육지원청 근화유치원,16,16,0,16,0,16,0,0
교육기관,교육부,금호여자중학교,교육부 서울특별시교육청 서울특별시중부교육지원청 금호여자중학교,22,21,1,21,5,16,0,0
교육기관,교육부,대건유치원,교육부 서울특별시교육청 서울특별시중부교육지원청 대건유치원,12,6,6,6,2,4,0,0
교육기관,교육부,대경중학교,교육부 서울특별시교육청 서울특별시중부교육지원청 대경중학교,19,19,0,19,3,16,0,0
교육기관,교육부,덕성여자중학교,교육부 서울특별시교육청 서울특별시중부교육지원청 덕성여자중학교,13,13,0,13,13,0,0,0
교육기관,교육부,덕수중학교,교육부 서울특별시교육청 서울특별시중부교육지원청 덕수중학교,27,27,0,27,20,7,0,0
교육기관,교육부,동산초등학교,교육부 서울특별시교육청 서울특별시중부교육지원청 동산초등학교,38,38,0,38,0,38,0,0
교육기관,교육부,동성중학교,교육부 서울특별시교육청 서울특별시중부교육지원청 동성중학교,18,18,0,18,0,18,0,0
교육기관,교육부,린덴바움유치원,교육부 서울특별시교육청 서울특별시중부교육지원청 린덴바움유치원,48,48,0,48,0,48,0,0
교육기관,교육부,배문중학교,교육부 서울특별시교육청 서울특별시중부교육지원청 배문중학교,25,25,0,25,21,4,0,0
교육기관,교육부,배화여자대학교부속배화유치원,교육부 서울특별시교육청 서울특별시중부교육지원청 배화여자대학교부속배화유치원,4,4,0,4,0,4,0,0
교육기관,교육부,배화여자중학교,교육부 서울특별시교육청 서울특별시중부교육지원청 배화여자중학교,41,41,0,41,41,0,0,0
교육기관,교육부,보성여자중학교,교육부 서울특별시교육청 서울특별시중부교육지원청 보성여자중학교,16,16,0,16,0,16,0,0
교육기관,교육부,복자유치원,교육부 서울특별시교육청 서울특별시중부교육지원청 복자유치원,11,0,11,0,0,0,0,0
교육기관,교육부,봄샘유치원,교육부 서울특별시교육청 서울특별시중부교육지원청 봄샘유치원,14,14,0,14,0,14,0,0
교육기관,교육부,상명대학교사범대학부속여자중학교,교육부 서울특별시교육청 서울특별시중부교육지원청 상명대학교사범대학부속여자중학교,16,16,0,16,5,11,0,0
교육기관,교육부,상명사대부속유치원,교육부 서울특별시교육청 서울특별시중부교육지원청 상명사대부속유치원,25,3,22,3,3,0,0,0
교육기관,교육부,서울광희초등학교,교육부 서울특별시교육청 서울특별시중부교육지원청 서울광희초등학교,24,24,0,24,0,24,0,0
교육기관,교육부,서울교동초등학교,교육부 서울특별시교육청 서울특별시중부교육지원청 서울교동초등학교,15,15,0,15,0,15,0,0
교육기관,교육부,서울금양초등학교,교육부 서울특별시교육청 서울특별시중부교육지원청 서울금양초등학교,23,23,0,23,0,23,0,0
교육기관,교육부,서울남산초등학교,교육부 서울특별시교육청 서울특별시중부교육지원청 서울남산초등학교,40,40,0,40,31,9,0,0
교육기관,교육부,서울남정초등학교,교육부 서울특별시교육청 서울특별시중부교육지원청 서울남정초등학교,38,38,0,38,38,0,0,0
교육기관,교육부,서울덕수초등학교,교육부 서울특별시교육청 서울특별시중부교육지원청 서울덕수초등학교,23,23,0,23,23,0,0,0
교육기관,교육부,서울덕수초등학교병설유치원,교육부 서울특별시교육청 서울특별시중부교육지원청 서울덕수초등학교병설유치원,7,7,0,7,7,0,0,0
교육기관,교육부,서울독립문초등학교,교육부 서울특별시교육청 서울특별시중부교육지원청 서울독립문초등학교,16,16,0,16,16,0,0,0
교육기관,교육부,서울매동초등학교,교육부 서울특별시교육청 서울특별시중부교육지원청 서울매동초등학교,13,13,0,13,0,13,0,0
교육기관,교육부,서울명신초등학교,교육부 서울특별시교육청 서울특별시중부교육지원청 서울명신초등학교,30,0,30,0,0,0,0,0
교육기관,교육부,서울보광초등학교,교육부 서울특별시교육청 서울특별시중부교육지원청 서울보광초등학교,17,17,0,17,0,17,0,0
교육기관,교육부,서울봉래초등학교,교육부 서울특별시교육청 서울특별시중부교육지원청 서울봉래초등학교,20,20,0,20,13,7,0,0
교육기관,교육부,서울삼광초등학교,교육부 서울특별시교육청 서울특별시중부교육지원청 서울삼광초등학교,20,20,0,20,20,0,0,0
교육기관,교육부,서울세검정초등학교,교육부 서울특별시교육청 서울특별시중부교육지원청 서울세검정초등학교,16,16,0,16,16,0,0,0
교육기관,교육부,서울신당초등학교,교육부 서울특별시교육청 서울특별시중부교육지원청 서울신당초등학교,23,23,0,23,23,0,0,0
교육기관,교육부,서울신용산초등학교,교육부 서울특별시교육청 서울특별시중부교육지원청 서울신용산초등학교,31,31,0,31,0,31,0,0
교육기관,교육부,서울용산초등학교,교육부 서울특별시교육청 서울특별시중부교육지원청 서울용산초등학교,29,29,0,29,29,0,0,0
교육기관,교육부,서울용암초등학교,교육부 서울특별시교육청 서울특별시중부교육지원청 서울용암초등학교,18,18,0,18,9,9,0,0
교육기관,교육부,서울원효초등학교,교육부 서울특별시교육청 서울특별시중부교육지원청 서울원효초등학교,5,5,0,5,0,5,0,0
교육기관,교육부,서울이태원초등학교,교육부 서울특별시교육청 서울특별시중부교육지원청 서울이태원초등학교,21,21,0,21,16,5,0,0
교육기관,교육부,서울장충유치원,교육부 서울특별시교육청 서울특별시중부교육지원청 서울장충유치원,16,16,0,16,11,5,0,0
교육기관,교육부,서울장충초등학교,교육부 서울특별시교육청 서울특별시중부교육지원청 서울장충초등학교,32,32,0,32,32,0,0,0
교육기관,교육부,서울재동초등학교,교육부 서울특별시교육청 서울특별시중부교육지원청 서울재동초등학교,19,19,0,19,12,7,0,0
교육기관,교육부,서울창신초등학교,교육부 서울특별시교육청 서울특별시중부교육지원청 서울창신초등학교,17,17,0,17,17,0,0,0
교육기관,교육부,서울청구초등학교,교육부 서울특별시교육청 서울특별시중부교육지원청 서울청구초등학교,25,25,0,25,25,0,0,0
교육기관,교육부,서울청운초등학교,교육부 서울특별시교육청 서울특별시중부교육지원청 서울청운초등학교,25,25,0,25,25,0,0,0
교육기관,교육부,서울청운초등학교병설유치원,교육부 서울특별시교육청 서울특별시중부교육지원청 서울청운초등학교병설유치원,4,1,3,1,1,0,0,0
교육기관,교육부,서울청파유치원,교육부 서울특별시교육청 서울특별시중부교육지원청 서울청파유치원,17,2,15,2,2,0,0,0
교육기관,교육부,서울청파초등학교,교육부 서울특별시교육청 서울특별시중부교육지원청 서울청파초등학교,30,30,0,30,14,16,0,0
교육기관,교육부,서울충무초등학교,교육부 서울특별시교육청 서울특별시중부교육지원청 서울충무초등학교,26,26,0,26,0,26,0,0
교육기관,교육부,서울한강초등학교,교육부 서울특별시교육청 서울특별시중부교육지원청 서울한강초등학교,21,21,0,21,15,3,0,3
교육기관,교육부,서울한남초등학교,교육부 서울특별시교육청 서울특별시중부교육지원청 서울한남초등학교,21,21,0,21,10,8,2,1
교육기관,교육부,서울혜화초등학교,교육부 서울특별시교육청 서울특별시중부교육지원청 서울혜화초등학교,22,22,0,22,0,22,0,0
교육기관,교육부,서울효제초등학교,교육부 서울특별시교육청 서울특별시중부교육지원청 서울효제초등학교,16,10,6,10,3,7,0,0
교육기관,교육부,서울후암초등학교,교육부 서울특별시교육청 서울특별시중부교육지원청 서울후암초등학교,26,0,26,0,0,0,0,0
교육기관,교육부,선린중학교,교육부 서울특별시교육청 서울특별시중부교육지원청 선린중학교,31,31,0,31,0,31,0,0
교육기관,교육부,성심여자중학교,교육부 서울특별시교육청 서울특별시중부교육지원청 성심여자중학교,14,14,0,14,3,11,0,0
교육기관,교육부,세검정유치원,교육부 서울특별시교육청 서울특별시중부교육지원청 세검정유치원,13,3,10,3,1,2,0,0
교육기관,교육부,수암유치원,교육부 서울특별시교육청 서울특별시중부교육지원청 수암유치원,29,3,26,3,3,0,0,0
교육기관,교육부,숭의초등학교,교육부 서울특별시교육청 서울특별시중부교육지원청 숭의초등학교,20,20,0,20,0,20,0,0
교육기관,교육부,신광여자중학교,교육부 서울특별시교육청 서울특별시중부교육지원청 신광여자중학교,24,24,0,24,24,0,0,0
교육기관,교육부,신광초등학교,교육부 서울특별시교육청 서울특별시중부교육지원청 신광초등학교,31,31,0,31,31,0,0,0
교육기관,교육부,오산중학교,교육부 서울특별시교육청 서울특별시중부교육지원청 오산중학교,26,26,0,26,0,26,0,0
교육기관,교육부,옥인유치원,교육부 서울특별시교육청 서울특별시중부교육지원청 옥인유치원,16,16,0,16,16,0,0,0
교육기관,교육부,용강중학교,교육부 서울특별시교육청 서울특별시중부교육지원청 용강중학교,56,56,0,56,20,36,0,0
교육기관,교육부,용산중학교,교육부 서울특별시교육청 서울특별시중부교육지원청 용산중학교,33,33,0,33,0,33,0,0
교육기관,교육부,운현유치원,교육부 서울특별시교육청 서울특별시중부교육지원청 운현유치원,16,14,2,14,0,14,0,0
교육기관,교육부,운현초등학교,교육부 서울특별시교육청 서울특별시중부교육지원청 운현초등학교,14,14,0,14,14,0,0,0
교육기관,교육부,원유치원,교육부 서울특별시교육청 서울특별시중부교육지원청 원유치원,7,7,0,7,0,7,0,0
교육기관,교육부,장원중학교,교육부 서울특별시교육청 서울특별시중부교육지원청 장원중학교,51,51,0,51,0,51,0,0
교육기관,교육부,장충중학교,교육부 서울특별시교육청 서울특별시중부교육지원청 장충중학교,22,22,0,22,0,22,0,0
교육기관,교육부,중앙중학교,교육부 서울특별시교육청 서울특별시중부교육지원청 중앙중학교,33,33,0,33,27,6,0,0
교육기관,교육부,창덕여자중학교,교육부 서울특별시교육청 서울특별시중부교육지원청 창덕여자중학교,24,23,1,23,0,23,0,0
교육기관,교육부,청룡유치원,교육부 서울특별시교육청 서울특별시중부교육지원청 청룡유치원,8,1,7,1,1,0,0,0
교육기관,교육부,청운중학교,교육부 서울특별시교육청 서울특별시중부교육지원청 청운중학교,51,51,0,51,42,9,0,0
교육기관,교육부,충신유치원,교육부 서울특별시교육청 서울특별시중부교육지원청 충신유치원,13,0,13,0,0,0,0,0
교육기관,교육부,한가람유치원,교육부 서울특별시교육청 서울특별시중부교육지원청 한가람유치원,0,0,0,0,0,0,0,0
교육기관,교육부,한강중학교,교육부 서울특별시교육청 서울특별시중부교육지원청 한강중학교,44,43,1,43,5,38,0,0
교육기관,교육부,한아름유치원,교육부 서울특별시교육청 서울특별시중부교육지원청 한아름유치원,13,4,9,4,4,0,0,0
교육기관,교육부,한양중학교,교육부 서울특별시교육청 서울특별시중부교육지원청 한양중학교,16,16,0,16,0,16,0,0
교육기관,교육부,한일유치원,교육부 서울특별시교육청 서울특별시중부교육지원청 한일유치원,9,0,9,0,0,0,0,0
교육기관,교육부,혜화유치원,교육부 서울특별시교육청 서울특별시중부교육지원청 혜화유치원,30,1,29,1,1,0,0,0
교육기관,교육부,환일중학교,교육부 서울특별시교육청 서울특별시중부교육지원청 환일중학교,20,20,0,20,4,16,0,0
교육기관,교육부,서울특별시학생교육원,교육부 서울특별시교육청 서울특별시학생교육원,212,212,0,212,0,212,0,0
교육기관,교육부,서울특별시학생체육관,교육부 서울특별시교육청 서울특별시학생체육관,25,25,0,25,14,11,0,0
교육기관,교육부,서울효정학교,교육부 서울특별시교육청 서울효정학교,12,12,0,12,5,7,0,0
교육기관,교육부,서일문화예술고등학교,교육부 서울특별시교육청 서일문화예술고등학교,30,30,0,30,0,30,0,0
교육기관,교육부,서초문화예술정보학교,교육부 서울특별시교육청 서초문화예술정보학교,21,21,0,21,0,21,0,0
교육기관,교육부,석관고등학교,교육부 서울특별시교육청 석관고등학교,68,68,0,68,0,68,0,0
교육기관,교육부,선덕고등학교,교육부 서울특별시교육청 선덕고등학교,33,33,0,33,33,0,0,0
교육기관,교육부,선린인터넷고등학교,교육부 서울특별시교육청 선린인터넷고등학교,63,63,0,63,63,0,0,0
교육기관,교육부,선사고등학교,교육부 서울특별시교육청 선사고등학교,43,43,0,43,0,43,0,0
교육기관,교육부,선유고등학교,교육부 서울특별시교육청 선유고등학교,50,50,0,50,0,50,0,0
교육기관,교육부,선일빅데이터고등학교,교육부 서울특별시교육청 선일빅데이터고등학교,32,32,0,32,32,0,0,0
교육기관,교육부,선일여자고등학교,교육부 서울특별시교육청 선일여자고등학교,39,39,0,39,21,18,0,0
교육기관,교육부,선정고등학교,교육부 서울특별시교육청 선정고등학교,71,71,0,71,58,13,0,0
교육기관,교육부,선정국제관광고등학교,교육부 서울특별시교육청 선정국제관광고등학교,23,23,0,23,6,17,0,0
교육기관,교육부,선화예술고등학교,교육부 서울특별시교육청 선화예술고등학교,121,121,0,121,121,0,0,0
교육기관,교육부,성남고등학교,교육부 서울특별시교육청 성남고등학교,30,30,0,30,30,0,0,0
교육기관,교육부,성동고등학교,교육부 서울특별시교육청 성동고등학교,43,43,0,43,0,43,0,0
교육기관,교육부,성동공업고등학교,교육부 서울특별시교육청 성동공업고등학교,131,131,0,131,0,131,0,0
교육기관,교육부,성동글로벌경영고등학교,교육부 서울특별시교육청 성동글로벌경영고등학교,21,21,0,21,12,9,0,0
교육기관,교육부,성베드로학교,교육부 서울특별시교육청 성베드로학교,22,22,0,22,0,22,0,0
교육기관,교육부,성수고등학교,교육부 서울특별시교육청 성수고등학교,38,38,0,38,38,0,0,0
교육기관,교육부,성수공업고등학교,교육부 서울특별시교육청 성수공업고등학교,59,8,51,8,4,3,0,1
교육기관,교육부,성신여자고등학교,교육부 서울특별시교육청 성신여자고등학교,49,47,2,47,47,0,0,0
교육기관,교육부,성심여자고등학교,교육부 서울특별시교육청 성심여자고등학교,38,38,0,38,0,38,0,0
교육기관,교육부,성암국제무역고등학교,교육부 서울특별시교육청 성암국제무역고등학교,40,40,0,40,40,0,0,0
교육기관,교육부,세그루패션디자인고등학교,교육부 서울특별시교육청 세그루패션디자인고등학교,43,43,0,43,43,0,0,0
교육기관,교육부,세명컴퓨터고등학교,교육부 서울특별시교육청 세명컴퓨터고등학교,46,46,0,46,6,40,0,0
교육기관,교육부,세종과학고등학교,교육부 서울특별시교육청 세종과학고등학교,96,96,0,96,0,96,0,0
교육기관,교육부,세화여자고등학교,교육부 서울특별시교육청 세화여자고등학교,22,22,0,22,15,7,0,0
교육기관,교육부,솔샘고등학교,교육부 서울특별시교육청 솔샘고등학교,53,53,0,53,0,53,0,0
교육기관,교육부,송곡고등학교,교육부 서울특별시교육청 송곡고등학교,77,77,0,77,0,77,0,0
교육기관,교육부,송곡관광고등학교,교육부 서울특별시교육청 송곡관광고등학교,35,35,0,35,0,35,0,0
교육기관,교육부,송파공업고등학교,교육부 서울특별시교육청 송파공업고등학교,34,34,0,34,0,34,0,0
교육기관,교육부,송파도서관,교육부 서울특별시교육청 송파도서관,48,48,0,48,0,48,0,0
교육기관,교육부,수도사랑의학교,교육부 서울특별시교육청 수도사랑의학교,15,10,5,10,9,1,0,0
교육기관,교육부,수도여자고등학교,교육부 서울특별시교육청 수도여자고등학교,29,29,0,29,29,0,0,0
교육기관,교육부,수도전기공업고등학교,교육부 서울특별시교육청 수도전기공업고등학교,74,74,0,74,0,74,0,0
교육기관,교육부,숭문고등학교,교육부 서울특별시교육청 숭문고등학교,43,43,0,43,40,3,0,0
교육기관,교육부,숭실고등학교,교육부 서울특별시교육청 숭실고등학교,72,72,0,72,72,0,0,0
교육기관,교육부,숭의여자고등학교,교육부 서울특별시교육청 숭의여자고등학교,17,17,0,17,0,17,0,0
교육기관,교육부,신광여자고등학교,교육부 서울특별시교육청 신광여자고등학교,48,48,0,48,48,0,0,0
교육기관,교육부,신도고등학교,교육부 서울특별시교육청 신도고등학교,48,48,0,48,0,48,0,0
교육기관,교육부,신도림고등학교,교육부 서울특별시교육청 신도림고등학교,32,32,0,32,0,32,0,0
교육기관,교육부,신림고등학교,교육부 서울특별시교육청 신림고등학교,35,35,0,35,35,0,0,0
교육기관,교육부,신일고등학교,교육부 서울특별시교육청 신일고등학교,85,85,0,85,34,51,0,0
교육기관,교육부,신진과학기술고등학교,교육부 서울특별시교육청 신진과학기술고등학교,41,41,0,41,0,41,0,0
교육기관,교육부,신현고등학교,교육부 서울특별시교육청 신현고등학교,77,0,77,0,0,0,0,0
교육기관,교육부,아현산업정보학교,교육부 서울특별시교육청 아현산업정보학교,20,20,0,20,8,12,0,0
교육기관,교육부,압구정고등학교,교육부 서울특별시교육청 압구정고등학교,36,36,0,36,9,9,9,9
교육기관,교육부,양재고등학교,교육부 서울특별시교육청 양재고등학교,33,33,0,33,31,2,0,0
교육기관,교육부,양천도서관,교육부 서울특별시교육청 양천도서관,63,63,0,63,63,0,0,0
교육기관,교육부,어린이도서관,교육부 서울특별시교육청 어린이도서관,26,26,0,26,0,26,0,0
교육기관,교육부,언남고등학교,교육부 서울특별시교육청 언남고등학교,32,32,0,32,21,11,0,0
교육기관,교육부,여의도고등학교,교육부 서울특별시교육청 여의도고등학교,70,70,0,70,70,0,0,0
교육기관,교육부,여의도여자고등학교,교육부 서울특별시교육청 여의도여자고등학교,77,77,0,77,0,77,0,0
교육기관,교육부,연세대학교재활학교,교육부 서울특별시교육청 연세대학교재활학교,43,43,0,43,0,43,0,0
교육기관,교육부,염광고등학교,교육부 서울특별시교육청 염광고등학교,49,49,0,49,49,0,0,0
교육기관,교육부,염광여자메디텍고등학교,교육부 서울특별시교육청 염광여자메디텍고등학교,24,24,0,24,0,24,0,0
교육기관,교육부,영동고등학교,교육부 서울특별시교육청 영동고등학교,106,53,53,53,30,23,0,0
교육기관,교육부,영동일고등학교,교육부 서울특별시교육청 영동일고등학교,102,102,0,102,51,51,0,0
교육기관,교육부,영등포고등학교,교육부 서울특별시교육청 영등포고등학교,40,40,0,40,10,30,0,0
교육기관,교육부,영등포평생학습관,교육부 서울특별시교육청 영등포평생학습관,24,0,24,0,0,0,0,0
교육기관,교육부,영락고등학교,교육부 서울특별시교육청 영락고등학교,38,38,0,38,20,18,0,0
교육기관,교육부,영락의료과학고등학교,교육부 서울특별시교육청 영락의료과학고등학교,35,35,0,35,0,35,0,0
교육기관,교육부,영신간호비즈니스고등학교,교육부 서울특별시교육청 영신간호비즈니스고등학교,32,32,0,32,13,19,0,0
교육기관,교육부,영신고등학교,교육부 서울특별시교육청 영신고등학교,41,41,0,41,11,30,0,0
교육기관,교육부,영신여자고등학교,교육부 서울특별시교육청 영신여자고등학교,40,11,29,11,7,4,0,0
교육기관,교육부,영파여자고등학교,교육부 서울특별시교육청 영파여자고등학교,24,24,0,24,0,24,0,0
교육기관,교육부,예림디자인고등학교,교육부 서울특별시교육청 예림디자인고등학교,29,29,0,29,29,0,0,0
교육기관,교육부,예일디자인고등학교,교육부 서울특별시교육청 예일디자인고등학교,32,32,0,32,19,13,0,0
교육기관,교육부,예일여자고등학교,교육부 서울특별시교육청 예일여자고등학교,44,40,4,40,40,0,0,0
교육기관,교육부,오금고등학교,교육부 서울특별시교육청 오금고등학교,70,67,3,67,12,53,2,0
교육기관,교육부,오류고등학교,교육부 서울특별시교육청 오류고등학교,26,26,0,26,15,11,0,0
교육기관,교육부,오산고등학교,교육부 서울특별시교육청 오산고등학교,36,36,0,36,0,36,0,0
교육기관,교육부,용산고등학교,교육부 서울특별시교육청 용산고등학교,87,87,0,87,47,40,0,0
교육기관,교육부,용산공업고등학교,교육부 서울특별시교육청 용산공업고등학교,59,59,0,59,59,0,0,0
교육기관,교육부,용산도서관,교육부 서울특별시교육청 용산도서관,44,43,1,43,0,35,8,0
교육기관,교육부,용화여자고등학교,교육부 서울특별시교육청 용화여자고등학교,95,95,0,95,0,95,0,0
교육기관,교육부,우신고등학교,교육부 서울특별시교육청 우신고등학교,126,126,0,126,80,46,0,0
교육기관,교육부,원묵고등학교,교육부 서울특별시교육청 원묵고등학교,60,58,2,58,58,0,0,0
교육기관,교육부,월계고등학교,교육부 서울특별시교육청 월계고등학교,47,47,0,47,0,47,0,0
교육기관,교육부,유한공업고등학교,교육부 서울특별시교육청 유한공업고등학교,56,56,0,56,56,0,0,0
교육기관,교육부,은광여자고등학교,교육부 서울특별시교육청 은광여자고등학교,37,35,2,35,0,35,0,0
교육기관,교육부,은평고등학교,교육부 서울특별시교육청 은평고등학교,60,16,44,16,16,0,0,0
교육기관,교육부,은평대영학교,교육부 서울특별시교육청 은평대영학교,61,12,49,12,2,10,0,0
교육기관,교육부,은평메디텍고등학교,교육부 서울특별시교육청 은평메디텍고등학교,71,71,0,71,65,6,0,0
교육기관,교육부,은평문화예술정보학교,교육부 서울특별시교육청 은평문화예술정보학교,24,24,0,24,0,24,0,0
교육기관,교육부,이화여자대학교병설미디어고등학교,교육부 서울특별시교육청 이화여자대학교병설미디어고등학교,17,17,0,17,17,0,0,0
교육기관,교육부,이화여자대학교사범대학부속이화금란고등학교,교육부 서울특별시교육청 이화여자대학교사범대학부속이화금란고등학교,75,75,0,75,34,33,8,0
교육기관,교육부,이화여자외국어고등학교,교육부 서울특별시교육청 이화여자외국어고등학교,37,0,37,0,0,0,0,0
교육기관,교육부,인덕과학기술고등학교,교육부 서울특별시교육청 인덕과학기술고등학교,42,40,2,40,30,8,1,1
교육기관,교육부,인창고등학교,교육부 서울특별시교육청 인창고등학교,61,61,0,61,60,1,0,0
교육기관,교육부,인헌고등학교,교육부 서울특별시교육청 인헌고등학교,43,43,0,43,0,43,0,0
교육기관,교육부,일신여자상업고등학교,교육부 서울특별시교육청 일신여자상업고등학교,68,68,0,68,2,66,0,0
교육기관,교육부,자양고등학교,교육부 서울특별시교육청 자양고등학교,79,79,0,79,0,79,0,0
교육기관,교육부,자운고등학교,교육부 서울특별시교육청 자운고등학교,80,79,1,79,70,9,0,0
교육기관,교육부,잠신고등학교,교육부 서울특별시교육청 잠신고등학교,47,47,0,47,0,47,0,0
교육기관,교육부,잠실고등학교,교육부 서울특별시교육청 잠실고등학교,59,59,0,59,20,39,0,0
교육기관,교육부,잠일고등학교,교육부 서울특별시교육청 잠일고등학교,50,50,0,50,0,50,0,0
교육기관,교육부,장충고등학교,교육부 서울특별시교육청 장충고등학교,52,52,0,52,0,52,0,0
교육기관,교육부,장훈고등학교,교육부 서울특별시교육청 장훈고등학교,47,47,0,47,10,37,0,0
교육기관,교육부,재현고등학교,교육부 서울특별시교육청 재현고등학교,44,44,0,44,0,44,0,0
교육기관,교육부,정독도서관,교육부 서울특별시교육청 정독도서관,79,79,0,79,79,0,0,0
교육기관,교육부,정신여자고등학교,교육부 서울특별시교육청 정신여자고등학교,39,39,0,39,0,39,0,0
교육기관,교육부,정암미용고등학교,교육부 서울특별시교육청 정암미용고등학교,17,17,0,17,2,15,0,0
교육기관,교육부,정의여자고등학교,교육부 서울특별시교육청 정의여자고등학교,52,52,0,52,36,16,0,0
교육기관,교육부,종로도서관,교육부 서울특별시교육청 종로도서관,40,39,1,39,31,8,0,0
교육기관,교육부,종로산업정보학교,교육부 서울특별시교육청 종로산업정보학교,41,41,0,41,39,1,1,0
교육기관,교육부,주몽학교,교육부 서울특별시교육청 주몽학교,25,25,0,25,0,25,0,0
교육기관,교육부,중경고등학교,교육부 서울특별시교육청 중경고등학교,62,61,1,61,0,61,0,0
교육기관,교육부,중동고등학교,교육부 서울특별시교육청 중동고등학교,51,51,0,51,0,51,0,0
교육기관,교육부,중산고등학교,교육부 서울특별시교육청 중산고등학교,59,59,0,59,0,59,0,0
교육기관,교육부,중앙대학교사범대학부속고등학교,교육부 서울특별시교육청 중앙대학교사범대학부속고등학교,77,77,0,77,0,77,0,0
교육기관,교육부,중앙여자고등학교,교육부 서울특별시교육청 중앙여자고등학교,38,38,0,38,19,19,0,0
교육기관,교육부,중화고등학교,교육부 서울특별시교육청 중화고등학교,39,38,1,38,0,38,0,0
교육기관,교육부,진관고등학교,교육부 서울특별시교육청 진관고등학교,66,64,2,64,0,64,0,0
교육기관,교육부,창덕여자고등학교,교육부 서울특별시교육청 창덕여자고등학교,53,53,0,53,7,46,0,0
교육기관,교육부,창동고등학교,교육부 서울특별시교육청 창동고등학교,46,46,0,46,44,1,1,0
교육기관,교육부,창문여자고등학교,교육부 서울특별시교육청 창문여자고등학교,52,52,0,52,0,52,0,0
교육기관,교육부,청담고등학교,교육부 서울특별시교육청 청담고등학교,52,52,0,52,10,42,0,0
교육기관,교육부,청량고등학교,교육부 서울특별시교육청 청량고등학교,75,55,20,55,50,3,1,1
교육기관,교육부,청원고등학교,교육부 서울특별시교육청 청원고등학교,61,61,0,61,61,0,0,0
교육기관,교육부,청원여자고등학교,교육부 서울특별시교육청 청원여자고등학교,29,29,0,29,29,0,0,0
교육기관,교육부,충암고등학교,교육부 서울특별시교육청 충암고등학교,71,71,0,71,3,68,0,0
교육기관,교육부,태릉고등학교,교육부 서울특별시교육청 태릉고등학교,14,14,0,14,0,14,0,0
교육기관,교육부,하나고등학교,교육부 서울특별시교육청 하나고등학교,144,144,0,144,17,127,0,0
교육기관,교육부,학교보건진흥원,교육부 서울특별시교육청 학교보건진흥원,4,4,0,4,1,3,0,0
교육기관,교육부,한강미디어고등학교,교육부 서울특별시교육청 한강미디어고등학교,42,42,0,42,0,42,0,0
교육기관,교육부,한국구화학교,교육부 서울특별시교육청 한국구화학교,48,48,0,48,14,34,0,0
교육기관,교육부,한국삼육고등학교,교육부 서울특별시교육청 한국삼육고등학교,50,50,0,50,12,38,0,0
교육기관,교육부,한국우진학교,교육부 서울특별시교육청 한국우진학교,55,55,0,55,39,16,0,0
교육기관,교육부,한국육영학교,교육부 서울특별시교육청 한국육영학교,20,20,0,20,0,20,0,0
교육기관,교육부,한빛맹학교,교육부 서울특별시교육청 한빛맹학교,36,36,0,36,14,19,3,0
교육기관,교육부,한성과학고등학교,교육부 서울특별시교육청 한성과학고등학교,73,73,0,73,16,57,0,0
교육기관,교육부,한세사이버보안고등학교,교육부 서울특별시교육청 한세사이버보안고등학교,35,35,0,35,26,9,0,0
교육기관,교육부,한양공업고등학교,교육부 서울특별시교육청 한양공업고등학교,45,44,1,44,40,4,0,0
교육기관,교육부,한영고등학교,교육부 서울특별시교육청 한영고등학교,42,41,1,41,30,11,0,0
교육기관,교육부,해성국제컨벤션고등학교,교육부 서울특별시교육청 해성국제컨벤션고등학교,29,29,0,29,29,0,0,0
교육기관,교육부,해성여자고등학교,교육부 서울특별시교육청 해성여자고등학교,30,30,0,30,30,0,0,0
교육기관,교육부,현대고등학교,교육부 서울특별시교육청 현대고등학교,64,64,0,64,17,47,0,0
교육기관,교육부,혜성여자고등학교,교육부 서울특별시교육청 혜성여자고등학교,31,29,2,29,24,5,0,0
교육기관,교육부,혜원여자고등학교,교육부 서울특별시교육청 혜원여자고등학교,51,50,1,50,0,50,0,0
교육기관,교육부,혜화여자고등학교,교육부 서울특별시교육청 혜화여자고등학교,58,58,0,58,0,58,0,0
교육기관,교육부,홍익대학교사범대학부속고등학교,교육부 서울특별시교육청 홍익대학교사범대학부속고등학교,51,51,0,51,39,12,0,0
교육기관,교육부,홍익대학교사범대학부속여자고등학교,교육부 서울특별시교육청 홍익대학교사범대학부속여자고등학교,38,38,0,38,0,38,0,0
교육기관,교육부,홍익디자인고등학교,교육부 서울특별시교육청 홍익디자인고등학교,20,20,0,20,10,10,0,0
교육기관,교육부,환일고등학교,교육부 서울특별시교육청 환일고등학교,107,107,0,107,33,74,0,0
교육기관,교육부,효문고등학교,교육부 서울특별시교육청 효문고등학교,40,40,0,40,11,29,0,0
교육기관,교육부,휘경공업고등학교,교육부 서울특별시교육청 휘경공업고등학교,88,88,0,88,0,88,0,0
교육기관,교육부,휘경여자고등학교,교육부 서울특별시교육청 휘경여자고등학교,34,34,0,34,2,32,0,0
교육기관,교육부,휘봉고등학교,교육부 서울특별시교육청 휘봉고등학교,50,47,3,47,0,47,0,0
교육기관,교육부,부산광역시교육청,교육부 부산광역시교육청,61,36,25,36,0,36,0,0
교육기관,교육부,가야고등학교,교육부 부산광역시교육청 가야고등학교,36,36,0,36,0,36,0,0
교육기관,교육부,개금고등학교,교육부 부산광역시교육청 개금고등학교,34,34,0,34,0,34,0,0
교육기관,교육부,개성고등학교,교육부 부산광역시교육청 개성고등학교,60,60,0,60,60,0,0,0
교육기관,교육부,건국고등학교,교육부 부산광역시교육청 건국고등학교,28,28,0,28,28,0,0,0
교육기관,교육부,경남고등학교,교육부 부산광역시교육청 경남고등학교,54,54,0,54,54,0,0,0
교육기관,교육부,경남공업고등학교,교육부 부산광역시교육청 경남공업고등학교,85,85,0,85,85,0,0,0
교육기관,교육부,경남여자고등학교,교육부 부산광역시교육청 경남여자고등학교,40,40,0,40,38,2,0,0
교육기관,교육부,경성전자고등학교,교육부 부산광역시교육청 경성전자고등학교,39,37,2,37,6,31,0,0
교육기관,교육부,경원고등학교,교육부 부산광역시교육청 경원고등학교,52,51,1,51,0,47,2,2
교육기관,교육부,경일고등학교,교육부 부산광역시교육청 경일고등학교,84,84,0,84,84,0,0,0
교육기관,교육부,경혜여자고등학교,교육부 부산광역시교육청 경혜여자고등학교,16,16,0,16,16,0,0,0
교육기관,교육부,계성여자고등학교,교육부 부산광역시교육청 계성여자고등학교,23,23,0,23,10,11,2,0
교육기관,교육부,광명고등학교,교육부 부산광역시교육청 광명고등학교,15,15,0,15,15,0,0,0
교육기관,교육부,구덕고등학교,교육부 부산광역시교육청 구덕고등학교,43,43,0,43,23,20,0,0
교육기관,교육부,금곡고등학교,교육부 부산광역시교육청 금곡고등학교,54,52,2,52,52,0,0,0
교육기관,교육부,금명여자고등학교,교육부 부산광역시교육청 금명여자고등학교,39,39,0,39,0,39,0,0
교육기관,교육부,금성고등학교,교육부 부산광역시교육청 금성고등학교,26,26,0,26,8,18,0,0
교육기관,교육부,금정고등학교,교육부 부산광역시교육청 금정고등학교,33,33,0,33,24,8,1,0
교육기관,교육부,금정여자고등학교,교육부 부산광역시교육청 금정여자고등학교,25,8,17,8,0,8,0,0
교육기관,교육부,금정전자고등학교,교육부 부산광역시교육청 금정전자고등학교,55,55,0,55,54,1,0,0
교육기관,교육부,기장고등학교,교육부 부산광역시교육청 기장고등학교,65,54,11,54,16,38,0,0
교육기관,교육부,남산고등학교,교육부 부산광역시교육청 남산고등학교,46,46,0,46,0,46,0,0
교육기관,교육부,남성여자고등학교,교육부 부산광역시교육청 남성여자고등학교,23,23,0,23,23,0,0,0
교육기관,교육부,내성고등학교,교육부 부산광역시교육청 내성고등학교,59,59,0,59,59,0,0,0
교육기관,교육부,다대고등학교,교육부 부산광역시교육청 다대고등학교,64,61,3,61,38,23,0,0
교육기관,교육부,대덕여자고등학교,교육부 부산광역시교육청 대덕여자고등학교,17,16,1,16,5,11,0,0
교육기관,교육부,대동고등학교,교육부 부산광역시교육청 대동고등학교,16,14,2,14,6,6,2,0
교육기관,교육부,대명여자고등학교,교육부 부산광역시교육청 대명여자고등학교,27,27,0,27,27,0,0,0
교육기관,교육부,대양고등학교,교육부 부산광역시교육청 대양고등학교,33,33,0,33,9,24,0,0
교육기관,교육부,대연고등학교,교육부 부산광역시교육청 대연고등학교,38,38,0,38,38,0,0,0
교육기관,교육부,대진전자통신고등학교,교육부 부산광역시교육청 대진전자통신고등학교,72,68,4,68,34,32,1,1
교육기관,교육부,덕문고등학교,교육부 부산광역시교육청 덕문고등학교,26,26,0,26,0,26,0,0
교육기관,교육부,덕문여자고등학교,교육부 부산광역시교육청 덕문여자고등학교,32,32,0,32,32,0,0,0
교육기관,교육부,데레사여자고등학교,교육부 부산광역시교육청 데레사여자고등학교,32,0,32,0,0,0,0,0
교육기관,교육부,동래고등학교,교육부 부산광역시교육청 동래고등학교,40,40,0,40,20,20,0,0
교육기관,교육부,동래여자고등학교,교육부 부산광역시교육청 동래여자고등학교,30,30,0,30,0,30,0,0
교육기관,교육부,동래원예고등학교,교육부 부산광역시교육청 동래원예고등학교,36,36,0,36,18,18,0,0
교육기관,교육부,동명공업고등학교,교육부 부산광역시교육청 동명공업고등학교,72,72,0,72,0,72,0,0
교육기관,교육부,동아고등학교,교육부 부산광역시교육청 동아고등학교,32,32,0,32,8,24,0,0
교육기관,교육부,동아공업고등학교,교육부 부산광역시교육청 동아공업고등학교,51,51,0,51,7,44,0,0
교육기관,교육부,동의공업고등학교,교육부 부산광역시교육청 동의공업고등학교,21,21,0,21,0,21,0,0
교육기관,교육부,동인고등학교,교육부 부산광역시교육청 동인고등학교,45,43,2,43,3,37,3,0
교육기관,교육부,동주여자고등학교,교육부 부산광역시교육청 동주여자고등학교,20,20,0,20,6,14,0,0
교육기관,교육부,동천고등학교,교육부 부산광역시교육청 동천고등학교,75,75,0,75,62,13,0,0
교육기관,교육부,만덕고등학교,교육부 부산광역시교육청 만덕고등학교,47,47,0,47,0,47,0,0
교육기관,교육부,명호고등학교,교육부 부산광역시교육청 명호고등학교,57,55,2,55,0,55,0,0
교육기관,교육부,문현여자고등학교,교육부 부산광역시교육청 문현여자고등학교,41,3,38,3,1,2,0,0
교육기관,교육부,반여고등학교,교육부 부산광역시교육청 반여고등학교,56,56,0,56,10,46,0,0
교육기관,교육부,배정고등학교,교육부 부산광역시교육청 배정고등학교,66,66,0,66,0,66,0,0
교육기관,교육부,배정미래고등학교,교육부 부산광역시교육청 배정미래고등학교,49,49,0,49,27,20,2,0
교육기관,교육부,부경고등학교,교육부 부산광역시교육청 부경고등학교,61,61,0,61,50,11,0,0
교육기관,교육부,부산강서고등학교,교육부 부산광역시교육청 부산강서고등학교,39,39,0,39,21,18,0,0
교육기관,교육부,부산고등학교,교육부 부산광역시교육청 부산고등학교,68,68,0,68,28,40,0,0
교육기관,교육부,부산공업고등학교,교육부 부산광역시교육청 부산공업고등학교,77,59,18,59,20,37,2,0
교육기관,교육부,부산과학고등학교,교육부 부산광역시교육청 부산과학고등학교,99,96,3,96,5,89,2,0
교육기관,교육부,부산관광고등학교,교육부 부산광역시교육청 부산관광고등학교,36,8,28,8,0,8,0,0
교육기관,교육부,부산광역시교육연수원,교육부 부산광역시교육청 부산광역시교육연수원,35,35,0,35,0,35,0,0
교육기관,교육부,부산광역시교육청교육연구정보원,교육부 부산광역시교육청 부산광역시교육청교육연구정보원,42,32,10,32,0,32,0,0
교육기관,교육부,부산광역시남부교육지원청,교육부 부산광역시교육청 부산광역시남부교육지원청,18,18,0,18,0,18,0,0
교육기관,교육부,LG메트로시티유치원,교육부 부산광역시교육청 부산광역시남부교육지원청 LG메트로시티유치원,15,4,11,4,1,1,1,1
교육기관,교육부,가남초등학교,교육부 부산광역시교육청 부산광역시남부교육지원청 가남초등학교,15,15,0,15,15,0,0,0
교육기관,교육부,가산초등학교,교육부 부산광역시교육청 부산광역시남부교육지원청 가산초등학교,14,14,0,14,14,0,0,0
교육기관,교육부,가야여자중학교,교육부 부산광역시교육청 부산광역시남부교육지원청 가야여자중학교,27,26,1,26,19,7,0,0
교육기관,교육부,가야초등학교,교육부 부산광역시교육청 부산광역시남부교육지원청 가야초등학교,23,23,0,23,20,3,0,0
교육기관,교육부,가평초등학교,교육부 부산광역시교육청 부산광역시남부교육지원청 가평초등학교,20,20,0,20,20,0,0,0
교육기관,교육부,감만중학교,교육부 부산광역시교육청 부산광역시남부교육지원청 감만중학교,19,18,1,18,0,18,0,0
교육기관,교육부,개금유치원,교육부 부산광역시교육청 부산광역시남부교육지원청 개금유치원,11,2,9,2,0,2,0,0
교육기관,교육부,개금초등학교,교육부 부산광역시교육청 부산광역시남부교육지원청 개금초등학교,23,23,0,23,23,0,0,0
교육기관,교육부,개림초등학교,교육부 부산광역시교육청 부산광역시남부교육지원청 개림초등학교,13,11,2,11,0,11,0,0
교육기관,교육부,개림초등학교병설유치원,교육부 부산광역시교육청 부산광역시남부교육지원청 개림초등학교병설유치원,7,7,0,7,0,7,0,0
교육기관,교육부,개원초등학교,교육부 부산광역시교육청 부산광역시남부교육지원청 개원초등학교,16,16,0,16,4,12,0,0
교육기관,교육부,개포초등학교,교육부 부산광역시교육청 부산광역시남부교육지원청 개포초등학교,14,14,0,14,7,7,0,0
교육기관,교육부,개화초등학교,교육부 부산광역시교육청 부산광역시남부교육지원청 개화초등학교,16,16,0,16,0,16,0,0
교육기관,교육부,경남여자중학교,교육부 부산광역시교육청 부산광역시남부교육지원청 경남여자중학교,39,39,0,39,0,39,0,0
교육기관,교육부,금란유치원,교육부 부산광역시교육청 부산광역시남부교육지원청 금란유치원,16,0,16,0,0,0,0,0
교육기관,교육부,남천중학교,교육부 부산광역시교육청 부산광역시남부교육지원청 남천중학교,48,48,0,48,0,48,0,0
교육기관,교육부,당감초등학교,교육부 부산광역시교육청 부산광역시남부교육지원청 당감초등학교,15,15,0,15,11,4,0,0
교육기관,교육부,당평초등학교,교육부 부산광역시교육청 부산광역시남부교육지원청 당평초등학교,14,14,0,14,14,0,0,0
교육기관,교육부,당평초등학교병설유치원,교육부 부산광역시교육청 부산광역시남부교육지원청 당평초등학교병설유치원,5,0,5,0,0,0,0,0
교육기관,교육부,대남초등학교,교육부 부산광역시교육청 부산광역시남부교육지원청 대남초등학교,13,13,0,13,7,4,1,1
교육기관,교육부,대연중학교,교육부 부산광역시교육청 부산광역시남부교육지원청 대연중학교,38,38,0,38,22,12,2,2
교육기관,교육부,대연초등학교,교육부 부산광역시교육청 부산광역시남부교육지원청 대연초등학교,15,15,0,15,0,15,0,0
교육기관,교육부,대천중학교,교육부 부산광역시교육청 부산광역시남부교육지원청 대천중학교,46,46,0,46,42,4,0,0
교육기관,교육부,대천초등학교,교육부 부산광역시교육청 부산광역시남부교육지원청 대천초등학교,19,19,0,19,10,9,0,0
교육기관,교육부,덕명여자중학교,교육부 부산광역시교육청 부산광역시남부교육지원청 덕명여자중학교,32,32,0,32,16,16,0,0
교육기관,교육부,동성초등학교,교육부 부산광역시교육청 부산광역시남부교육지원청 동성초등학교,30,30,0,30,20,10,0,0
교육기관,교육부,동양중학교,교육부 부산광역시교육청 부산광역시남부교육지원청 동양중학교,48,48,0,48,0,48,0,0
교육기관,교육부,동양초등학교,교육부 부산광역시교육청 부산광역시남부교육지원청 동양초등학교,21,14,7,14,10,3,1,0
교육기관,교육부,동원초등학교,교육부 부산광역시교육청 부산광역시남부교육지원청 동원초등학교,15,15,0,15,13,2,0,0
교육기관,교육부,동의중학교,교육부 부산광역시교육청 부산광역시남부교육지원청 동의중학교,15,15,0,15,0,15,0,0
교육기관,교육부,동일유치원,교육부 부산광역시교육청 부산광역시남부교육지원청 동일유치원,16,16,0,16,11,5,0,0
교육기관,교육부,동일중앙초등학교,교육부 부산광역시교육청 부산광역시남부교육지원청 동일중앙초등학교,16,16,0,16,8,3,2,3
교육기관,교육부,동천초등학교,교육부 부산광역시교육청 부산광역시남부교육지원청 동천초등학교,14,13,1,13,2,11,0,0
교육기관,교육부,동평여자중학교,교육부 부산광역시교육청 부산광역시남부교육지원청 동평여자중학교,52,52,0,52,52,0,0,0
교육기관,교육부,동평중학교,교육부 부산광역시교육청 부산광역시남부교육지원청 동평중학교,35,35,0,35,30,5,0,0
교육기관,교육부,동평초등학교,교육부 부산광역시교육청 부산광역시남부교육지원청 동평초등학교,12,12,0,12,3,9,0,0
교육기관,교육부,동항중학교,교육부 부산광역시교육청 부산광역시남부교육지원청 동항중학교,49,49,0,49,49,0,0,0
교육기관,교육부,동항초등학교,교육부 부산광역시교육청 부산광역시남부교육지원청 동항초등학교,15,15,0,15,15,0,0,0
교육기관,교육부,무지개유치원,교육부 부산광역시교육청 부산광역시남부교육지원청 무지개유치원,12,0,12,0,0,0,0,0
교육기관,교육부,문현여자중학교,교육부 부산광역시교육청 부산광역시남부교육지원청 문현여자중학교,45,45,0,45,8,36,1,0
교육기관,교육부,문현초등학교,교육부 부산광역시교육청 부산광역시남부교육지원청 문현초등학교,14,14,0,14,9,5,0,0
교육기관,교육부,문현초등학교병설유치원,교육부 부산광역시교육청 부산광역시남부교육지원청 문현초등학교병설유치원,4,4,0,4,2,2,0,0
교육기관,교육부,백운초등학교,교육부 부산광역시교육청 부산광역시남부교육지원청 백운초등학교,16,16,0,16,0,16,0,0
교육기관,교육부,범일초등학교,교육부 부산광역시교육청 부산광역시남부교육지원청 범일초등학교,21,21,0,21,21,0,0,0
교육기관,교육부,범일초등학교병설유치원,교육부 부산광역시교육청 부산광역시남부교육지원청 범일초등학교병설유치원,5,5,0,5,5,0,0,0
교육기관,교육부,부산국제중학교,교육부 부산광역시교육청 부산광역시남부교육지원청 부산국제중학교,16,16,0,16,9,7,0,0
교육기관,교육부,부산대연유치원,교육부 부산광역시교육청 부산광역시남부교육지원청 부산대연유치원,16,16,0,16,2,14,0,0
교육기관,교육부,부산동여자중학교,교육부 부산광역시교육청 부산광역시남부교육지원청 부산동여자중학교,19,19,0,19,19,0,0,0
교육기관,교육부,부산서중학교,교육부 부산광역시교육청 부산광역시남부교육지원청 부산서중학교,32,32,0,32,0,32,0,0
교육기관,교육부,부산여대부속유치원,교육부 부산광역시교육청 부산광역시남부교육지원청 부산여대부속유치원,15,1,14,1,1,0,0,0
교육기관,교육부,부산중학교,교육부 부산광역시교육청 부산광역시남부교육지원청 부산중학교,29,29,0,29,0,29,0,0
교육기관,교육부,부산진유치원,교육부 부산광역시교육청 부산광역시남부교육지원청 부산진유치원,11,6,5,6,0,6,0,0
교육기관,교육부,부산진중학교,교육부 부산광역시교육청 부산광역시남부교육지원청 부산진중학교,16,16,0,16,16,0,0,0
교육기관,교육부,부산진초등학교,교육부 부산광역시교육청 부산광역시남부교육지원청 부산진초등학교,13,13,0,13,6,7,0,0
교육기관,교육부,부암초등학교,교육부 부산광역시교육청 부산광역시남부교육지원청 부암초등학교,15,15,0,15,15,0,0,0
교육기관,교육부,부전초등학교,교육부 부산광역시교육청 부산광역시남부교육지원청 부전초등학교,29,29,0,29,29,0,0,0
교육기관,교육부,부전초등학교병설유치원,교육부 부산광역시교육청 부산광역시남부교육지원청 부전초등학교병설유치원,9,9,0,9,3,6,0,0
교육기관,교육부,분포중학교,교육부 부산광역시교육청 부산광역시남부교육지원청 분포중학교,60,60,0,60,14,46,0,0
교육기관,교육부,분포초등학교,교육부 부산광역시교육청 부산광역시남부교육지원청 분포초등학교,36,36,0,36,36,0,0,0
교육기관,교육부,색동유치원,교육부 부산광역시교육청 부산광역시남부교육지원청 색동유치원,26,26,0,26,10,12,2,2
교육기관,교육부,서면중학교,교육부 부산광역시교육청 부산광역시남부교육지원청 서면중학교,12,12,0,12,4,8,0,0
교육기관,교육부,석포초등학교,교육부 부산광역시교육청 부산광역시남부교육지원청 석포초등학교,16,16,0,16,0,16,0,0
교육기관,교육부,선암초등학교,교육부 부산광역시교육청 부산광역시남부교육지원청 선암초등학교,17,17,0,17,0,15,1,1
교육기관,교육부,선화여자중학교,교육부 부산광역시교육청 부산광역시남부교육지원청 선화여자중학교,38,38,0,38,38,0,0,0
교육기관,교육부,성남초등학교,교육부 부산광역시교육청 부산광역시남부교육지원청 성남초등학교,15,15,0,15,2,13,0,0
교육기관,교육부,성남초등학교병설유치원,교육부 부산광역시교육청 부산광역시남부교육지원청 성남초등학교병설유치원,4,4,0,4,1,3,0,0
교육기관,교육부,성동중학교,교육부 부산광역시교육청 부산광역시남부교육지원청 성동중학교,32,32,0,32,0,28,3,1
교육기관,교육부,성동초등학교,교육부 부산광역시교육청 부산광역시남부교육지원청 성동초등학교,24,24,0,24,24,0,0,0
교육기관,교육부,성동초등학교병설유치원,교육부 부산광역시교육청 부산광역시남부교육지원청 성동초등학교병설유치원,2,2,0,2,2,0,0,0
교육기관,교육부,성북초등학교,교육부 부산광역시교육청 부산광역시남부교육지원청 성북초등학교,17,17,0,17,17,0,0,0
교육기관,교육부,성신유치원,교육부 부산광역시교육청 부산광역시남부교육지원청 성신유치원,16,16,0,16,1,15,0,0
교육기관,교육부,성전초등학교,교육부 부산광역시교육청 부산광역시남부교육지원청 성전초등학교,19,19,0,19,12,7,0,0
교육기관,교육부,성지초등학교,교육부 부산광역시교육청 부산광역시남부교육지원청 성지초등학교,14,14,0,14,2,12,0,0
교육기관,교육부,수성초등학교,교육부 부산광역시교육청 부산광역시남부교육지원청 수성초등학교,17,17,0,17,17,0,0,0
교육기관,교육부,수성초등학교병설유치원,교육부 부산광역시교육청 부산광역시남부교육지원청 수성초등학교병설유치원,4,4,0,4,4,0,0,0
교육기관,교육부,수정초등학교,교육부 부산광역시교육청 부산광역시남부교육지원청 수정초등학교,14,14,0,14,7,7,0,0
교육기관,교육부,양동여자중학교,교육부 부산광역시교육청 부산광역시남부교육지원청 양동여자중학교,31,31,0,31,31,0,0,0
교육기관,교육부,양동초등학교,교육부 부산광역시교육청 부산광역시남부교육지원청 양동초등학교,13,13,0,13,13,0,0,0
교육기관,교육부,양성초등학교,교육부 부산광역시교육청 부산광역시남부교육지원청 양성초등학교,14,14,0,14,7,7,0,0
교육기관,교육부,양정초등학교,교육부 부산광역시교육청 부산광역시남부교육지원청 양정초등학교,18,18,0,18,4,14,0,0
교육기관,교육부,연지초등학교,교육부 부산광역시교육청 부산광역시남부교육지원청 연지초등학교,32,32,0,32,16,16,0,0
교육기관,교육부,연포초등학교병설유치원,교육부 부산광역시교육청 부산광역시남부교육지원청 연포초등학교병설유치원,32,32,0,32,24,8,0,0
교육기관,교육부,오륙도중학교,교육부 부산광역시교육청 부산광역시남부교육지원청 오륙도중학교,44,43,1,43,36,7,0,0
교육기관,교육부,오륙도초등학교,교육부 부산광역시교육청 부산광역시남부교육지원청 오륙도초등학교,17,17,0,17,7,5,5,0
교육기관,교육부,용당초등학교,교육부 부산광역시교육청 부산광역시남부교육지원청 용당초등학교,14,14,0,14,0,13,1,0
교육기관,교육부,용문중학교,교육부 부산광역시교육청 부산광역시남부교육지원청 용문중학교,32,32,0,32,16,16,0,0
교육기관,교육부,용문초등학교,교육부 부산광역시교육청 부산광역시남부교육지원청 용문초등학교,23,23,0,23,0,23,0,0
교육기관,교육부,용산초등학교,교육부 부산광역시교육청 부산광역시남부교육지원청 용산초등학교,14,14,0,14,0,14,0,0
교육기관,교육부,용산초등학교병설유치원,교육부 부산광역시교육청 부산광역시남부교육지원청 용산초등학교병설유치원,4,4,0,4,4,0,0,0
교육기관,교육부,용소초등학교,교육부 부산광역시교육청 부산광역시남부교육지원청 용소초등학교,24,24,0,24,24,0,0,0
교육기관,교육부,용호중학교,교육부 부산광역시교육청 부산광역시남부교육지원청 용호중학교,48,48,0,48,46,2,0,0
교육기관,교육부,용호초등학교,교육부 부산광역시교육청 부산광역시남부교육지원청 용호초등학교,20,20,0,20,0,20,0,0
교육기관,교육부,우암초등학교,교육부 부산광역시교육청 부산광역시남부교육지원청 우암초등학교,11,11,0,11,8,3,0,0
교육기관,교육부,운산초등학교,교육부 부산광역시교육청 부산광역시남부교육지원청 운산초등학교,21,20,1,20,19,1,0,0
교육기관,교육부,전포유치원,교육부 부산광역시교육청 부산광역시남부교육지원청 전포유치원,7,7,0,7,7,0,0,0
교육기관,교육부,전포초등학교,교육부 부산광역시교육청 부산광역시남부교육지원청 전포초등학교,15,15,0,15,11,4,0,0
교육기관,교육부,주례초등학교,교육부 부산광역시교육청 부산광역시남부교육지원청 주례초등학교,16,16,0,16,7,9,0,0
교육기관,교육부,주원초등학교,교육부 부산광역시교육청 부산광역시남부교육지원청 주원초등학교,16,16,0,16,16,0,0,0
교육기관,교육부,초량초등학교,교육부 부산광역시교육청 부산광역시남부교육지원청 초량초등학교,13,13,0,13,10,2,1,0
교육기관,교육부,초연중학교,교육부 부산광역시교육청 부산광역시남부교육지원청 초연중학교,52,52,0,52,52,0,0,0
교육기관,교육부,초읍중학교,교육부 부산광역시교육청 부산광역시남부교육지원청 초읍중학교,40,40,0,40,30,10,0,0
교육기관,교육부,초읍초등학교,교육부 부산광역시교육청 부산광역시남부교육지원청 초읍초등학교,15,15,0,15,12,3,0,0
교육기관,교육부,큰별유치원,교육부 부산광역시교육청 부산광역시남부교육지원청 큰별유치원,7,1,6,1,1,0,0,0
교육기관,교육부,한림유치원,교육부 부산광역시교육청 부산광역시남부교육지원청 한림유치원,16,2,14,2,1,1,0,0
교육기관,교육부,한사랑유치원,교육부 부산광역시교육청 부산광역시남부교육지원청 한사랑유치원,11,2,9,2,1,1,0,0
교육기관,교육부,항도중학교,교육부 부산광역시교육청 부산광역시남부교육지원청 항도중학교,22,22,0,22,13,8,1,0
교육기관,교육부,해맑은유치원,교육부 부산광역시교육청 부산광역시남부교육지원청 해맑은유치원,16,3,13,3,0,3,0,0
교육기관,교육부,해바라기자연유치원,교육부 부산광역시교육청 부산광역시남부교육지원청 해바라기자연유치원,16,16,0,16,0,16,0,0
교육기관,교육부,해연중학교,교육부 부산광역시교육청 부산광역시남부교육지원청 해연중학교,20,20,0,20,10,10,0,0
교육기관,교육부,화승예그린유치원,교육부 부산광역시교육청 부산광역시남부교육지원청 화승예그린유치원,33,32,1,32,1,29,2,0
교육기관,교육부,화승유치원,교육부 부산광역시교육청 부산광역시남부교육지원청 화승유치원,11,11,0,11,0,11,0,0
교육기관,교육부,부산광역시동래교육지원청,교육부 부산광역시교육청 부산광역시동래교육지원청,13,13,0,13,0,13,0,0
교육기관,교육부,거성유치원,교육부 부산광역시교육청 부산광역시동래교육지원청 거성유치원,4,4,0,4,2,2,0,0
교육기관,교육부,거성중학교,교육부 부산광역시교육청 부산광역시동래교육지원청 거성중학교,44,44,0,44,40,4,0,0
교육기관,교육부,거제여자중학교,교육부 부산광역시교육청 부산광역시동래교육지원청 거제여자중학교,42,41,1,41,20,21,0,0
교육기관,교육부,거제초등학교,교육부 부산광역시교육청 부산광역시동래교육지원청 거제초등학교,7,7,0,7,7,0,0,0
교육기관,교육부,거제초등학교병설유치원,교육부 부산광역시교육청 부산광역시동래교육지원청 거제초등학교병설유치원,7,7,0,7,0,7,0,0
교육기관,교육부,거학초등학교,교육부 부산광역시교육청 부산광역시동래교육지원청 거학초등학교,16,16,0,16,0,16,0,0
교육기관,교육부,고은유치원,교육부 부산광역시교육청 부산광역시동래교육지원청 고은유치원,16,5,11,5,1,2,1,1
교육기관,교육부,공덕초등학교,교육부 부산광역시교육청 부산광역시동래교육지원청 공덕초등학교,11,11,0,11,11,0,0,0
교육기관,교육부,과정유치원,교육부 부산광역시교육청 부산광역시동래교육지원청 과정유치원,15,0,15,0,0,0,0,0
교육기관,교육부,과정초등학교,교육부 부산광역시교육청 부산광역시동래교육지원청 과정초등학교,11,11,0,11,5,6,0,0
교육기관,교육부,교동초등학교,교육부 부산광역시교육청 부산광역시동래교육지원청 교동초등학교,14,14,0,14,0,14,0,0
교육기관,교육부,교동초등학교병설유치원,교육부 부산광역시교육청 부산광역시동래교육지원청 교동초등학교병설유치원,4,0,4,0,0,0,0,0
교육기관,교육부,구서여자중학교,교육부 부산광역시교육청 부산광역시동래교육지원청 구서여자중학교,32,32,0,32,32,0,0,0
교육기관,교육부,구서초등학교,교육부 부산광역시교육청 부산광역시동래교육지원청 구서초등학교,12,12,0,12,12,0,0,0
교육기관,교육부,구서초등학교병설유치원,교육부 부산광역시교육청 부산광역시동래교육지원청 구서초등학교병설유치원,6,6,0,6,6,0,0,0
교육기관,교육부,글로잉유치원,교육부 부산광역시교육청 부산광역시동래교육지원청 글로잉유치원,32,0,32,0,0,0,0,0
교육기관,교육부,금강초등학교,교육부 부산광역시교육청 부산광역시동래교육지원청 금강초등학교,12,12,0,12,12,0,0,0
교육기관,교육부,금빛초등학교,교육부 부산광역시교육청 부산광역시동래교육지원청 금빛초등학교,16,14,2,14,14,0,0,0
교육기관,교육부,금사중학교,교육부 부산광역시교육청 부산광역시동래교육지원청 금사중학교,20,20,0,20,14,6,0,0
교육기관,교육부,금사초등학교,교육부 부산광역시교육청 부산광역시동래교육지원청 금사초등학교,11,11,0,11,7,4,0,0
교육기관,교육부,금사초등학교병설유치원,교육부 부산광역시교육청 부산광역시동래교육지원청 금사초등학교병설유치원,4,4,0,4,0,4,0,0
교육기관,교육부,금샘누리유치원,교육부 부산광역시교육청 부산광역시동래교육지원청 금샘누리유치원,15,15,0,15,8,7,0,0
교육기관,교육부,금샘초등학교,교육부 부산광역시교육청 부산광역시동래교육지원청 금샘초등학교,20,20,0,20,16,4,0,0
교육기관,교육부,금성초등학교,교육부 부산광역시교육청 부산광역시동래교육지원청 금성초등학교,11,11,0,11,8,3,0,0
교육기관,교육부,금양중학교,교육부 부산광역시교육청 부산광역시동래교육지원청 금양중학교,32,32,0,32,24,8,0,0
교육기관,교육부,금양초등학교,교육부 부산광역시교육청 부산광역시동래교육지원청 금양초등학교,12,12,0,12,11,1,0,0
교육기관,교육부,금정유치원,교육부 부산광역시교육청 부산광역시동래교육지원청 금정유치원,9,9,0,9,2,7,0,0
교육기관,교육부,금정중학교,교육부 부산광역시교육청 부산광역시동래교육지원청 금정중학교,50,49,1,49,44,5,0,0
교육기관,교육부,금정초등학교,교육부 부산광역시교육청 부산광역시동래교육지원청 금정초등학교,27,27,0,27,12,10,5,0
교육기관,교육부,낙민초등학교,교육부 부산광역시교육청 부산광역시동래교육지원청 낙민초등학교,25,25,0,25,25,0,0,0
교육기관,교육부,낙민초등학교병설유치원,교육부 부산광역시교육청 부산광역시동래교육지원청 낙민초등학교병설유치원,4,4,0,4,4,0,0,0
교육기관,교육부,남문초등학교,교육부 부산광역시교육청 부산광역시동래교육지원청 남문초등학교,24,24,0,24,13,11,0,0
교육기관,교육부,남산중학교,교육부 부산광역시교육청 부산광역시동래교육지원청 남산중학교,36,36,0,36,13,23,0,0
교육기관,교육부,남산초등학교,교육부 부산광역시교육청 부산광역시동래교육지원청 남산초등학교,12,12,0,12,11,1,0,0
교육기관,교육부,남일중학교,교육부 부산광역시교육청 부산광역시동래교육지원청 남일중학교,35,35,0,35,23,12,0,0
교육기관,교육부,내산초등학교,교육부 부산광역시교육청 부산광역시동래교육지원청 내산초등학교,27,27,0,27,27,0,0,0
교육기관,교육부,내성초등학교,교육부 부산광역시교육청 부산광역시동래교육지원청 내성초등학교,25,25,0,25,25,0,0,0
교육기관,교육부,내성초등학교병설유치원,교육부 부산광역시교육청 부산광역시동래교육지원청 내성초등학교병설유치원,6,6,0,6,3,3,0,0
교육기관,교육부,느티나무유치원,교육부 부산광역시교육청 부산광역시동래교육지원청 느티나무유치원,16,16,0,16,0,16,0,0
교육기관,교육부,달북초등학교,교육부 부산광역시교육청 부산광역시동래교육지원청 달북초등학교,16,16,0,16,12,4,0,0
교육기관,교육부,대우유치원,교육부 부산광역시교육청 부산광역시동래교육지원청 대우유치원,11,11,0,11,11,0,0,0
교육기관,교육부,동래여자중학교,교육부 부산광역시교육청 부산광역시동래교육지원청 동래여자중학교,30,30,0,30,30,0,0,0
교육기관,교육부,동래유치원,교육부 부산광역시교육청 부산광역시동래교육지원청 동래유치원,8,8,0,8,0,8,0,0
교육기관,교육부,동래중학교,교육부 부산광역시교육청 부산광역시동래교육지원청 동래중학교,53,53,0,53,44,8,1,0
교육기관,교육부,동래초등학교,교육부 부산광역시교육청 부산광역시동래교육지원청 동래초등학교,48,48,0,48,35,13,0,0
교육기관,교육부,동명초등학교,교육부 부산광역시교육청 부산광역시동래교육지원청 동명초등학교,22,22,0,22,22,0,0,0
교육기관,교육부,동명초등학교병설유치원,교육부 부산광역시교육청 부산광역시동래교육지원청 동명초등학교병설유치원,8,8,0,8,8,0,0,0
교육기관,교육부,동백유치원,교육부 부산광역시교육청 부산광역시동래교육지원청 동백유치원,16,16,0,16,0,16,0,0
교육기관,교육부,동상초등학교,교육부 부산광역시교육청 부산광역시동래교육지원청 동상초등학교,12,12,0,12,10,2,0,0
교육기관,교육부,동신중학교,교육부 부산광역시교육청 부산광역시동래교육지원청 동신중학교,48,16,32,16,8,8,0,0
교육기관,교육부,동해중학교,교육부 부산광역시교육청 부산광역시동래교육지원청 동해중학교,27,27,0,27,27,0,0,0
교육기관,교육부,동현중학교,교육부 부산광역시교육청 부산광역시동래교육지원청 동현중학교,25,25,0,25,9,13,0,3
교육기관,교육부,동현초등학교,교육부 부산광역시교육청 부산광역시동래교육지원청 동현초등학교,15,15,0,15,7,8,0,0
교육기관,교육부,두실초등학교,교육부 부산광역시교육청 부산광역시동래교육지원청 두실초등학교,16,15,1,15,15,0,0,0
교육기관,교육부,럭키동래유치원,교육부 부산광역시교육청 부산광역시동래교육지원청 럭키동래유치원,16,1,15,1,0,1,0,0
교육기관,교육부,명동초등학교,교육부 부산광역시교육청 부산광역시동래교육지원청 명동초등학교,22,22,0,22,5,17,0,0
교육기관,교육부,명륜자연유치원,교육부 부산광역시교육청 부산광역시동래교육지원청 명륜자연유치원,16,0,16,0,0,0,0,0
교육기관,교육부,명륜초등학교,교육부 부산광역시교육청 부산광역시동래교육지원청 명륜초등학교,26,26,0,26,3,23,0,0
교육기관,교육부,명서초등학교,교육부 부산광역시교육청 부산광역시동래교육지원청 명서초등학교,12,12,0,12,12,0,0,0
교육기관,교육부,명장초등학교,교육부 부산광역시교육청 부산광역시동래교육지원청 명장초등학교,23,23,0,23,20,3,0,0
교육기관,교육부,미남초등학교,교육부 부산광역시교육청 부산광역시동래교육지원청 미남초등학교,12,12,0,12,12,0,0,0
교육기관,교육부,법륜유치원,교육부 부산광역시교육청 부산광역시동래교육지원청 법륜유치원,10,10,0,10,0,10,0,0
교육기관,교육부,부곡여자중학교,교육부 부산광역시교육청 부산광역시동래교육지원청 부곡여자중학교,34,34,0,34,34,0,0,0
교육기관,교육부,부곡중학교,교육부 부산광역시교육청 부산광역시동래교육지원청 부곡중학교,55,53,2,53,5,43,5,0
교육기관,교육부,부곡초등학교,교육부 부산광역시교육청 부산광역시동래교육지원청 부곡초등학교,37,37,0,37,0,37,0,0
교육기관,교육부,부산경상대학교부속유치원,교육부 부산광역시교육청 부산광역시동래교육지원청 부산경상대학교부속유치원,14,1,13,1,0,1,0,0
교육기관,교육부,부산교육대학교부설초등학교,교육부 부산광역시교육청 부산광역시동래교육지원청 부산교육대학교부설초등학교,36,36,0,36,0,36,0,0
교육기관,교육부,부산내성중학교,교육부 부산광역시교육청 부산광역시동래교육지원청 부산내성중학교,22,22,0,22,22,0,0,0
교육기관,교육부,부산삼육초등학교,교육부 부산광역시교육청 부산광역시동래교육지원청 부산삼육초등학교,25,25,0,25,10,15,0,0
교육기관,교육부,브니엘예술중학교,교육부 부산광역시교육청 부산광역시동래교육지원청 브니엘예술중학교,33,33,0,33,0,33,0,0
교육기관,교육부,브니엘유치원,교육부 부산광역시교육청 부산광역시동래교육지원청 브니엘유치원,8,0,8,0,0,0,0,0
교육기관,교육부,사직여자중학교,교육부 부산광역시교육청 부산광역시동래교육지원청 사직여자중학교,41,41,0,41,0,41,0,0
교육기관,교육부,사직유치원,교육부 부산광역시교육청 부산광역시동래교육지원청 사직유치원,8,2,6,2,1,1,0,0
교육기관,교육부,사직중학교,교육부 부산광역시교육청 부산광역시동래교육지원청 사직중학교,68,68,0,68,0,68,0,0
교육기관,교육부,사직초등학교,교육부 부산광역시교육청 부산광역시동래교육지원청 사직초등학교,25,25,0,25,13,12,0,0
교육기관,교육부,서동초등학교,교육부 부산광역시교육청 부산광역시동래교육지원청 서동초등학교,10,10,0,10,6,4,0,0
교육기관,교육부,서명초등학교,교육부 부산광역시교육청 부산광역시동래교육지원청 서명초등학교,16,16,0,16,16,0,0,0
교육기관,교육부,서명초등학교병설유치원,교육부 부산광역시교육청 부산광역시동래교육지원청 서명초등학교병설유치원,16,16,0,16,16,0,0,0
교육기관,교육부,소심유치원,교육부 부산광역시교육청 부산광역시동래교육지원청 소심유치원,16,16,0,16,0,16,0,0
교육기관,교육부,수안유치원,교육부 부산광역시교육청 부산광역시동래교육지원청 수안유치원,4,4,0,4,4,0,0,0
교육기관,교육부,수안초등학교,교육부 부산광역시교육청 부산광역시동래교육지원청 수안초등학교,12,12,0,12,12,0,0,0
교육기관,교육부,스펀지유치원,교육부 부산광역시교육청 부산광역시동래교육지원청 스펀지유치원,16,16,0,16,2,14,0,0
교육기관,교육부,아람유치원,교육부 부산광역시교육청 부산광역시동래교육지원청 아람유치원,15,15,0,15,3,12,0,0
교육기관,교육부,아이숲유치원,교육부 부산광역시교육청 부산광역시동래교육지원청 아이숲유치원,13,1,12,1,1,0,0,0
교육기관,교육부,아인유치원,교육부 부산광역시교육청 부산광역시동래교육지원청 아인유치원,14,14,0,14,2,12,0,0
교육기관,교육부,안남초등학교,교육부 부산광역시교육청 부산광역시동래교육지원청 안남초등학교,16,16,0,16,2,14,0,0
교육기관,교육부,안락중학교,교육부 부산광역시교육청 부산광역시동래교육지원청 안락중학교,68,68,0,68,40,20,8,0
교육기관,교육부,안락초등학교,교육부 부산광역시교육청 부산광역시동래교육지원청 안락초등학교,22,22,0,22,22,0,0,0
교육기관,교육부,안락초등학교병설유치원,교육부 부산광역시교육청 부산광역시동래교육지원청 안락초등학교병설유치원,8,8,0,8,8,0,0,0
교육기관,교육부,안민초등학교,교육부 부산광역시교육청 부산광역시동래교육지원청 안민초등학교,16,16,0,16,16,0,0,0
교육기관,교육부,안진초등학교,교육부 부산광역시교육청 부산광역시동래교육지원청 안진초등학교,19,0,19,0,0,0,0,0
교육기관,교육부,안진초등학교병설유치원,교육부 부산광역시교육청 부산광역시동래교육지원청 안진초등학교병설유치원,10,0,10,0,0,0,0,0
교육기관,교육부,양지유치원,교육부 부산광역시교육청 부산광역시동래교육지원청 양지유치원,8,0,8,0,0,0,0,0
교육기관,교육부,여고유치원,교육부 부산광역시교육청 부산광역시동래교육지원청 여고유치원,16,16,0,16,11,5,0,0
교육기관,교육부,여고초등학교,교육부 부산광역시교육청 부산광역시동래교육지원청 여고초등학교,25,25,0,25,19,6,0,0
교육기관,교육부,여명중학교,교육부 부산광역시교육청 부산광역시동래교육지원청 여명중학교,37,37,0,37,0,37,0,0
교육기관,교육부,연동초등학교,교육부 부산광역시교육청 부산광역시동래교육지원청 연동초등학교,24,24,0,24,10,14,0,0
교육기관,교육부,연동초등학교병설유치원,교육부 부산광역시교육청 부산광역시동래교육지원청 연동초등학교병설유치원,6,6,0,6,0,6,0,0
교육기관,교육부,연미초등학교,교육부 부산광역시교육청 부산광역시동래교육지원청 연미초등학교,24,24,0,24,24,0,0,0
교육기관,교육부,연산유치원,교육부 부산광역시교육청 부산광역시동래교육지원청 연산유치원,8,8,0,8,5,3,0,0
교육기관,교육부,연산중학교,교육부 부산광역시교육청 부산광역시동래교육지원청 연산중학교,25,25,0,25,25,0,0,0
교육기관,교육부,연산초등학교,교육부 부산광역시교육청 부산광역시동래교육지원청 연산초등학교,13,13,0,13,6,7,0,0
교육기관,교육부,연서초등학교,교육부 부산광역시교육청 부산광역시동래교육지원청 연서초등학교,17,17,0,17,17,0,0,0
교육기관,교육부,연신초등학교,교육부 부산광역시교육청 부산광역시동래교육지원청 연신초등학교,13,13,0,13,4,8,1,0
교육기관,교육부,연일중학교,교육부 부산광역시교육청 부산광역시동래교육지원청 연일중학교,40,40,0,40,31,9,0,0
교육기관,교육부,연일초등학교,교육부 부산광역시교육청 부산광역시동래교육지원청 연일초등학교,19,19,0,19,9,8,1,1
교육기관,교육부,연제중학교,교육부 부산광역시교육청 부산광역시동래교육지원청 연제중학교,36,36,0,36,28,8,0,0
교육기관,교육부,연제초등학교,교육부 부산광역시교육청 부산광역시동래교육지원청 연제초등학교,20,20,0,20,20,0,0,0
교육기관,교육부,연천유치원,교육부 부산광역시교육청 부산광역시동래교육지원청 연천유치원,21,2,19,2,0,2,0,0
교육기관,교육부,연천중학교,교육부 부산광역시교육청 부산광역시동래교육지원청 연천중학교,45,45,0,45,45,0,0,0
교육기관,교육부,연천초등학교,교육부 부산광역시교육청 부산광역시동래교육지원청 연천초등학교,17,17,0,17,17,0,0,0
교육기관,교육부,연천초등학교병설유치원,교육부 부산광역시교육청 부산광역시동래교육지원청 연천초등학교병설유치원,10,10,0,10,0,10,0,0
교육기관,교육부,예람유치원,교육부 부산광역시교육청 부산광역시동래교육지원청 예람유치원,8,1,7,1,1,0,0,0
교육기관,교육부,예원초등학교,교육부 부산광역시교육청 부산광역시동래교육지원청 예원초등학교,20,20,0,20,0,20,0,0
교육기관,교육부,온샘초등학교,교육부 부산광역시교육청 부산광역시동래교육지원청 온샘초등학교,36,34,2,34,0,34,0,0
교육기관,교육부,온천중학교,교육부 부산광역시교육청 부산광역시동래교육지원청 온천중학교,36,36,0,36,26,10,0,0
교육기관,교육부,온천초등학교,교육부 부산광역시교육청 부산광역시동래교육지원청 온천초등학교,32,32,0,32,32,0,0,0
교육기관,교육부,유락여자중학교,교육부 부산광역시교육청 부산광역시동래교육지원청 유락여자중학교,22,22,0,22,22,0,0,0
교육기관,교육부,이사벨중학교,교육부 부산광역시교육청 부산광역시동래교육지원청 이사벨중학교,34,34,0,34,7,27,0,0
교육기관,교육부,이화유치원,교육부 부산광역시교육청 부산광역시동래교육지원청 이화유치원,13,13,0,13,2,11,0,0
교육기관,교육부,장서초등학교,교육부 부산광역시교육청 부산광역시동래교육지원청 장서초등학교,12,12,0,12,0,12,0,0
교육기관,교육부,장전중학교,교육부 부산광역시교육청 부산광역시동래교육지원청 장전중학교,11,11,0,11,11,0,0,0
교육기관,교육부,장전초등학교,교육부 부산광역시교육청 부산광역시동래교육지원청 장전초등학교,32,32,0,32,32,0,0,0
교육기관,교육부,창신초등학교,교육부 부산광역시교육청 부산광역시동래교육지원청 창신초등학교,12,12,0,12,12,0,0,0
교육기관,교육부,창신초등학교병설유치원,교육부 부산광역시교육청 부산광역시동래교육지원청 창신초등학교병설유치원,10,10,0,10,5,5,0,0
교육기관,교육부,청룡초등학교병설유치원,교육부 부산광역시교육청 부산광역시동래교육지원청 청룡초등학교병설유치원,4,0,4,0,0,0,0,0
교육기관,교육부,충렬중학교,교육부 부산광역시교육청 부산광역시동래교육지원청 충렬중학교,37,37,0,37,37,0,0,0
교육기관,교육부,충렬초등학교,교육부 부산광역시교육청 부산광역시동래교육지원청 충렬초등학교,24,24,0,24,12,12,0,0
교육기관,교육부,토현유치원,교육부 부산광역시교육청 부산광역시동래교육지원청 토현유치원,24,3,21,3,0,3,0,0
교육기관,교육부,토현중학교,교육부 부산광역시교육청 부산광역시동래교육지원청 토현중학교,29,29,0,29,26,3,0,0
교육기관,교육부,토현초등학교,교육부 부산광역시교육청 부산광역시동래교육지원청 토현초등학교,11,11,0,11,2,9,0,0
교육기관,교육부,트니트니유치원,교육부 부산광역시교육청 부산광역시동래교육지원청 트니트니유치원,8,8,0,8,5,1,1,1
교육기관,교육부,파랑새유치원,교육부 부산광역시교육청 부산광역시동래교육지원청 파랑새유치원,16,4,12,4,1,1,1,1
교육기관,교육부,하나유치원,교육부 부산광역시교육청 부산광역시동래교육지원청 하나유치원,13,13,0,13,0,13,0,0
교육기관,교육부,하늘빛유치원,교육부 부산광역시교육청 부산광역시동래교육지원청 하늘빛유치원,38,5,33,5,1,2,1,1
교육기관,교육부,학산여자중학교,교육부 부산광역시교육청 부산광역시동래교육지원청 학산여자중학교,24,24,0,24,24,0,0,0
교육기관,교육부,한누리유치원,교육부 부산광역시교육청 부산광역시동래교육지원청 한누리유치원,12,12,0,12,0,12,0,0
교육기관,교육부,한신유치원,교육부 부산광역시교육청 부산광역시동래교육지원청 한신유치원,8,8,0,8,1,7,0,0
교육기관,교육부,해솔유치원,교육부 부산광역시교육청 부산광역시동래교육지원청 해솔유치원,10,10,0,10,0,10,0,0
교육기관,교육부,현곡초등학교,교육부 부산광역시교육청 부산광역시동래교육지원청 현곡초등학교,8,8,0,8,8,0,0,0
교육기관,교육부,혜화병설유치원,교육부 부산광역시교육청 부산광역시동래교육지원청 혜화병설유치원,28,28,0,28,0,28,0,0
교육기관,교육부,혜화여자중학교,교육부 부산광역시교육청 부산광역시동래교육지원청 혜화여자중학교,25,25,0,25,3,22,0,0
교육기관,교육부,혜화초등학교,교육부 부산광역시교육청 부산광역시동래교육지원청 혜화초등학교,10,10,0,10,6,4,0,0
교육기관,교육부,홍익유치원,교육부 부산광역시교육청 부산광역시동래교육지원청 홍익유치원,8,0,8,0,0,0,0,0
교육기관,교육부,부산광역시립구덕도서관,교육부 부산광역시교육청 부산광역시립구덕도서관,14,14,0,14,6,8,0,0
교육기관,교육부,부산광역시립구포도서관,교육부 부산광역시교육청 부산광역시립구포도서관,27,27,0,27,12,15,0,0
교육기관,교육부,부산광역시립명장도서관,교육부 부산광역시교육청 부산광역시립명장도서관,16,16,0,16,16,0,0,0
교육기관,교육부,부산광역시립반송도서관,교육부 부산광역시교육청 부산광역시립반송도서관,11,11,0,11,8,3,0,0
교육기관,교육부,부산광역시립부전도서관,교육부 부산광역시교육청 부산광역시립부전도서관,24,24,0,24,13,10,1,0
교육기관,교육부,부산광역시립사하도서관,교육부 부산광역시교육청 부산광역시립사하도서관,14,14,0,14,4,9,1,0
교육기관,교육부,부산광역시립서동도서관,교육부 부산광역시교육청 부산광역시립서동도서관,16,16,0,16,16,0,0,0
교육기관,교육부,부산광역시립시민도서관,교육부 부산광역시교육청 부산광역시립시민도서관,54,54,0,54,0,54,0,0
교육기관,교육부,부산광역시립연산도서관,교육부 부산광역시교육청 부산광역시립연산도서관,16,16,0,16,0,16,0,0
교육기관,교육부,부산광역시립중앙도서관,교육부 부산광역시교육청 부산광역시립중앙도서관,38,38,0,38,7,31,0,0
교육기관,교육부,부산광역시립해운대도서관,교육부 부산광역시교육청 부산광역시립해운대도서관,80,80,0,80,0,80,0,0
교육기관,교육부,부산광역시북부교육지원청,교육부 부산광역시교육청 부산광역시북부교육지원청,25,25,0,25,0,25,0,0
교육기관,교육부,가락초등학교,교육부 부산광역시교육청 부산광역시북부교육지원청 가락초등학교,14,14,0,14,5,9,0,0
교육기관,교육부,가락초등학교병설유치원,교육부 부산광역시교육청 부산광역시북부교육지원청 가락초등학교병설유치원,14,14,0,14,5,9,0,0
교육기관,교육부,감전초등학교,교육부 부산광역시교육청 부산광역시북부교육지원청 감전초등학교,23,23,0,23,23,0,0,0
교육기관,교육부,경일중학교,교육부 부산광역시교육청 부산광역시북부교육지원청 경일중학교,46,46,0,46,44,2,0,0
교육기관,교육부,괘법초등학교,교육부 부산광역시교육청 부산광역시북부교육지원청 괘법초등학교,14,14,0,14,2,12,0,0
교육기관,교육부,구남중학교,교육부 부산광역시교육청 부산광역시북부교육지원청 구남중학교,20,20,0,20,20,0,0,0
교육기관,교육부,구남초등학교,교육부 부산광역시교육청 부산광역시북부교육지원청 구남초등학교,32,15,17,15,0,15,0,0
교육기관,교육부,구남초등학교병설유치원,교육부 부산광역시교육청 부산광역시북부교육지원청 구남초등학교병설유치원,5,5,0,5,5,0,0,0
교육기관,교육부,구포성당부설소화유치원,교육부 부산광역시교육청 부산광역시북부교육지원청 구포성당부설소화유치원,11,1,10,1,0,1,0,0
교육기관,교육부,구포중학교,교육부 부산광역시교육청 부산광역시북부교육지원청 구포중학교,31,31,0,31,27,4,0,0
교육기관,교육부,구포초등학교,교육부 부산광역시교육청 부산광역시북부교육지원청 구포초등학교,10,10,0,10,7,3,0,0
교육기관,교육부,구학초등학교,교육부 부산광역시교육청 부산광역시북부교육지원청 구학초등학교,18,18,0,18,18,0,0,0
교육기관,교육부,금곡나래유치원,교육부 부산광역시교육청 부산광역시북부교육지원청 금곡나래유치원,18,18,0,18,16,2,0,0
교육기관,교육부,금곡초등학교,교육부 부산광역시교육청 부산광역시북부교육지원청 금곡초등학교,16,16,0,16,13,3,0,0
교육기관,교육부,금란자연유치원,교육부 부산광역시교육청 부산광역시북부교육지원청 금란자연유치원,18,18,0,18,0,18,0,0
교육기관,교육부,금명중학교,교육부 부산광역시교육청 부산광역시북부교육지원청 금명중학교,44,2,42,2,0,2,0,0
교육기관,교육부,금명초등학교,교육부 부산광역시교육청 부산광역시북부교육지원청 금명초등학교,32,32,0,32,32,0,0,0
교육기관,교육부,금명초등학교병설유치원,교육부 부산광역시교육청 부산광역시북부교육지원청 금명초등학교병설유치원,7,7,0,7,1,6,0,0
교육기관,교육부,금창초등학교병설유치원,교육부 부산광역시교육청 부산광역시북부교육지원청 금창초등학교병설유치원,7,7,0,7,7,0,0,0
교육기관,교육부,낙동중학교,교육부 부산광역시교육청 부산광역시북부교육지원청 낙동중학교,32,32,0,32,20,10,2,0
교육기관,교육부,남명유치원,교육부 부산광역시교육청 부산광역시북부교육지원청 남명유치원,16,0,16,0,0,0,0,0
교육기관,교육부,남명초등학교,교육부 부산광역시교육청 부산광역시북부교육지원청 남명초등학교,25,25,0,25,0,25,0,0
교육기관,교육부,녹명초등학교,교육부 부산광역시교육청 부산광역시북부교육지원청 녹명초등학교,30,30,0,30,30,0,0,0
교육기관,교육부,녹산유치원,교육부 부산광역시교육청 부산광역시북부교육지원청 녹산유치원,16,16,0,16,3,13,0,0
교육기관,교육부,녹산초등학교,교육부 부산광역시교육청 부산광역시북부교육지원청 녹산초등학교,32,32,0,32,22,4,6,0
교육기관,교육부,대림유치원,교육부 부산광역시교육청 부산광역시북부교육지원청 대림유치원,18,18,0,18,6,12,0,0
교육기관,교육부,대사초등학교,교육부 부산광역시교육청 부산광역시북부교육지원청 대사초등학교,15,15,0,15,15,0,0,0
교육기관,교육부,대상초등학교,교육부 부산광역시교육청 부산광역시북부교육지원청 대상초등학교,14,14,0,14,10,4,0,0
교육기관,교육부,대저중학교,교육부 부산광역시교육청 부산광역시북부교육지원청 대저중학교,14,14,0,14,0,14,0,0
교육기관,교육부,대저초등학교,교육부 부산광역시교육청 부산광역시북부교육지원청 대저초등학교,16,16,0,16,9,7,0,0
교육기관,교육부,대천리중학교,교육부 부산광역시교육청 부산광역시북부교육지원청 대천리중학교,34,34,0,34,25,9,0,0
교육기관,교육부,대천리초등학교,교육부 부산광역시교육청 부산광역시북부교육지원청 대천리초등학교,19,19,0,19,9,8,1,1
교육기관,교육부,대천리초등학교병설유치원,교육부 부산광역시교육청 부산광역시북부교육지원청 대천리초등학교병설유치원,6,3,3,3,0,3,0,0
교육기관,교육부,덕두초등학교,교육부 부산광역시교육청 부산광역시북부교육지원청 덕두초등학교,13,13,0,13,13,0,0,0
교육기관,교육부,덕문중학교,교육부 부산광역시교육청 부산광역시북부교육지원청 덕문중학교,15,15,0,15,0,15,0,0
교육기관,교육부,덕상초등학교,교육부 부산광역시교육청 부산광역시북부교육지원청 덕상초등학교,16,16,0,16,16,0,0,0
교육기관,교육부,덕성초등학교,교육부 부산광역시교육청 부산광역시북부교육지원청 덕성초등학교,14,14,0,14,0,14,0,0
교육기관,교육부,덕성초등학교병설유치원,교육부 부산광역시교육청 부산광역시북부교육지원청 덕성초등학교병설유치원,14,14,0,14,0,14,0,0
교육기관,교육부,덕양초등학교,교육부 부산광역시교육청 부산광역시북부교육지원청 덕양초등학교,16,16,0,16,16,0,0,0
교육기관,교육부,덕양초등학교병설유치원,교육부 부산광역시교육청 부산광역시북부교육지원청 덕양초등학교병설유치원,7,7,0,7,7,0,0,0
교육기관,교육부,덕천유치원,교육부 부산광역시교육청 부산광역시북부교육지원청 덕천유치원,5,5,0,5,0,5,0,0
교육기관,교육부,덕천중학교,교육부 부산광역시교육청 부산광역시북부교육지원청 덕천중학교,55,55,0,55,15,40,0,0
교육기관,교육부,덕포여자중학교,교육부 부산광역시교육청 부산광역시북부교육지원청 덕포여자중학교,10,10,0,10,10,0,0,0
교육기관,교육부,덕포초등학교,교육부 부산광역시교육청 부산광역시북부교육지원청 덕포초등학교,16,16,0,16,16,0,0,0
교육기관,교육부,동궁초등학교,교육부 부산광역시교육청 부산광역시북부교육지원청 동궁초등학교,14,14,0,14,10,4,0,0
교육기관,교육부,동성럭키유치원,교육부 부산광역시교육청 부산광역시북부교육지원청 동성럭키유치원,16,2,14,2,0,2,0,0
교육기관,교육부,동주중학교,교육부 부산광역시교육청 부산광역시북부교육지원청 동주중학교,16,16,0,16,6,10,0,0
교육기관,교육부,동주초등학교,교육부 부산광역시교육청 부산광역시북부교육지원청 동주초등학교,11,11,0,11,9,2,0,0
교육기관,교육부,리라유치원,교육부 부산광역시교육청 부산광역시북부교육지원청 리라유치원,8,8,0,8,6,1,1,0
교육기관,교육부,만덕중학교,교육부 부산광역시교육청 부산광역시북부교육지원청 만덕중학교,58,58,0,58,31,27,0,0
교육기관,교육부,만덕초등학교,교육부 부산광역시교육청 부산광역시북부교육지원청 만덕초등학교,25,25,0,25,11,14,0,0
교육기관,교육부,명덕초등학교,교육부 부산광역시교육청 부산광역시북부교육지원청 명덕초등학교,16,16,0,16,12,2,1,1
교육기관,교육부,명덕초등학교병설유치원,교육부 부산광역시교육청 부산광역시북부교육지원청 명덕초등학교병설유치원,3,3,0,3,0,3,0,0
교육기관,교육부,명원초등학교,교육부 부산광역시교육청 부산광역시북부교육지원청 명원초등학교,40,40,0,40,20,20,0,0
교육기관,교육부,명일유치원,교육부 부산광역시교육청 부산광역시북부교육지원청 명일유치원,12,4,8,4,1,1,1,1
교육기관,교육부,명지가온유치원,교육부 부산광역시교육청 부산광역시북부교육지원청 명지가온유치원,48,48,0,48,0,48,0,0
교육기관,교육부,명지꿈자람유치원,교육부 부산광역시교육청 부산광역시북부교육지원청 명지꿈자람유치원,23,23,0,23,2,21,0,0
교육기관,교육부,명지유치원,교육부 부산광역시교육청 부산광역시북부교육지원청 명지유치원,7,7,0,7,2,5,0,0
교육기관,교육부,명지중학교,교육부 부산광역시교육청 부산광역시북부교육지원청 명지중학교,52,52,0,52,0,52,0,0
교육기관,교육부,명지초등학교,교육부 부산광역시교육청 부산광역시북부교육지원청 명지초등학교,30,30,0,30,8,22,0,0
교육기관,교육부,명진중학교,교육부 부산광역시교육청 부산광역시북부교육지원청 명진중학교,40,40,0,40,40,0,0,0
교육기관,교육부,명진초등학교,교육부 부산광역시교육청 부산광역시북부교육지원청 명진초등학교,16,16,0,16,16,0,0,0
교육기관,교육부,명진초등학교병설유치원,교육부 부산광역시교육청 부산광역시북부교육지원청 명진초등학교병설유치원,6,6,0,6,6,0,0,0
교육기관,교육부,명호중학교,교육부 부산광역시교육청 부산광역시북부교육지원청 명호중학교,61,61,0,61,0,61,0,0
교육기관,교육부,명호초등학교,교육부 부산광역시교육청 부산광역시북부교육지원청 명호초등학교,42,42,0,42,0,42,0,0
교육기관,교육부,명호초등학교병설유치원,교육부 부산광역시교육청 부산광역시북부교육지원청 명호초등학교병설유치원,7,7,0,7,7,0,0,0
교육기관,교육부,모덕초등학교,교육부 부산광역시교육청 부산광역시북부교육지원청 모덕초등학교,16,16,0,16,16,0,0,0
교육기관,교육부,모동중학교,교육부 부산광역시교육청 부산광역시북부교육지원청 모동중학교,30,30,0,30,15,15,0,0
교육기관,교육부,모라중학교,교육부 부산광역시교육청 부산광역시북부교육지원청 모라중학교,37,37,0,37,34,3,0,0
교육기관,교육부,모라초등학교,교육부 부산광역시교육청 부산광역시북부교육지원청 모라초등학교,21,21,0,21,21,0,0,0
교육기관,교육부,모산초등학교,교육부 부산광역시교육청 부산광역시북부교육지원청 모산초등학교,10,10,0,10,10,0,0,0
교육기관,교육부,배영초등학교,교육부 부산광역시교육청 부산광역시북부교육지원청 배영초등학교,12,12,0,12,0,12,0,0
교육기관,교육부,백산초등학교,교육부 부산광역시교육청 부산광역시북부교육지원청 백산초등학교,26,26,0,26,2,24,0,0
교육기관,교육부,백양중학교,교육부 부산광역시교육청 부산광역시북부교육지원청 백양중학교,55,55,0,55,7,48,0,0
교육기관,교육부,백양초등학교,교육부 부산광역시교육청 부산광역시북부교육지원청 백양초등학교,32,30,2,30,28,2,0,0
교육기관,교육부,버클리명문유치원,교육부 부산광역시교육청 부산광역시북부교육지원청 버클리명문유치원,13,0,13,0,0,0,0,0
교육기관,교육부,보광유치원,교육부 부산광역시교육청 부산광역시북부교육지원청 보광유치원,4,4,0,4,0,4,0,0
교육기관,교육부,사상초등학교병설유치원,교육부 부산광역시교육청 부산광역시북부교육지원청 사상초등학교병설유치원,5,5,0,5,5,0,0,0
교육기관,교육부,삼덕초등학교,교육부 부산광역시교육청 부산광역시북부교육지원청 삼덕초등학교,16,16,0,16,16,0,0,0
교육기관,교육부,상학초등학교,교육부 부산광역시교육청 부산광역시북부교육지원청 상학초등학교,29,29,0,29,28,1,0,0
교육기관,교육부,서감초등학교,교육부 부산광역시교육청 부산광역시북부교육지원청 서감초등학교,16,16,0,16,0,16,0,0
교육기관,교육부,송정유치원,교육부 부산광역시교육청 부산광역시북부교육지원청 송정유치원,25,25,0,25,25,0,0,0
교육기관,교육부,송정중학교,교육부 부산광역시교육청 부산광역시북부교육지원청 송정중학교,71,0,71,0,0,0,0,0
교육기관,교육부,송정초등학교,교육부 부산광역시교육청 부산광역시북부교육지원청 송정초등학교,25,25,0,25,5,20,0,0
교육기관,교육부,신금초등학교,교육부 부산광역시교육청 부산광역시북부교육지원청 신금초등학교,27,27,0,27,27,0,0,0
교육기관,교육부,신덕중학교,교육부 부산광역시교육청 부산광역시북부교육지원청 신덕중학교,63,63,0,63,0,63,0,0
교육기관,교육부,신덕초등학교,교육부 부산광역시교육청 부산광역시북부교육지원청 신덕초등학교,25,25,0,25,13,10,1,1
교육기관,교육부,신덕초등학교병설유치원,교육부 부산광역시교육청 부산광역시북부교육지원청 신덕초등학교병설유치원,9,9,0,9,3,6,0,0
교육기관,교육부,신라중학교,교육부 부산광역시교육청 부산광역시북부교육지원청 신라중학교,40,40,0,40,0,40,0,0
교육기관,교육부,신명유치원,교육부 부산광역시교육청 부산광역시북부교육지원청 신명유치원,10,10,0,10,7,2,1,0
교육기관,교육부,신명초등학교,교육부 부산광역시교육청 부산광역시북부교육지원청 신명초등학교,29,29,0,29,0,29,0,0
교육기관,교육부,신호중학교,교육부 부산광역시교육청 부산광역시북부교육지원청 신호중학교,64,64,0,64,0,64,0,0
교육기관,교육부,신호초등학교병설유치원,교육부 부산광역시교육청 부산광역시북부교육지원청 신호초등학교병설유치원,6,3,3,3,3,0,0,0
교육기관,교육부,양덕여자중학교,교육부 부산광역시교육청 부산광역시북부교육지원청 양덕여자중학교,13,12,1,12,2,9,1,0
교육기관,교육부,양덕초등학교,교육부 부산광역시교육청 부산광역시북부교육지원청 양덕초등학교,16,16,0,16,4,9,3,0
교육기관,교육부,양천초등학교,교육부 부산광역시교육청 부산광역시북부교육지원청 양천초등학교,15,15,0,15,9,6,0,0
교육기관,교육부,엄궁누리유치원,교육부 부산광역시교육청 부산광역시북부교육지원청 엄궁누리유치원,16,16,0,16,0,16,0,0
교육기관,교육부,엄궁중학교,교육부 부산광역시교육청 부산광역시북부교육지원청 엄궁중학교,32,32,0,32,23,9,0,0
교육기관,교육부,엄궁초등학교,교육부 부산광역시교육청 부산광역시북부교육지원청 엄궁초등학교,18,18,0,18,8,10,0,0
교육기관,교육부,오션유치원,교육부 부산광역시교육청 부산광역시북부교육지원청 오션유치원,10,10,0,10,1,8,1,0
교육기관,교육부,오션중학교,교육부 부산광역시교육청 부산광역시북부교육지원청 오션중학교,53,27,26,27,27,0,0,0
교육기관,교육부,와석초등학교,교육부 부산광역시교육청 부산광역시북부교육지원청 와석초등학교,20,20,0,20,0,20,0,0
교육기관,교육부,와석초등학교병설유치원,교육부 부산광역시교육청 부산광역시북부교육지원청 와석초등학교병설유치원,8,8,0,8,8,0,0,0
교육기관,교육부,용수중학교,교육부 부산광역시교육청 부산광역시북부교육지원청 용수중학교,57,57,0,57,37,16,4,0
교육기관,교육부,용수초등학교,교육부 부산광역시교육청 부산광역시북부교육지원청 용수초등학교,26,21,5,21,21,0,0,0
교육기관,교육부,용수초등학교병설유치원,교육부 부산광역시교육청 부산광역시북부교육지원청 용수초등학교병설유치원,10,10,0,10,10,0,0,0
교육기관,교육부,원효정사유치원,교육부 부산광역시교육청 부산광역시북부교육지원청 원효정사유치원,4,4,0,4,2,2,0,0
교육기관,교육부,으뜸유치원,교육부 부산광역시교육청 부산광역시북부교육지원청 으뜸유치원,18,6,12,6,2,1,1,2
교육기관,교육부,주감중학교,교육부 부산광역시교육청 부산광역시북부교육지원청 주감중학교,41,41,0,41,0,41,0,0
교육기관,교육부,주감초등학교,교육부 부산광역시교육청 부산광역시북부교육지원청 주감초등학교,19,19,0,19,19,0,0,0
교육기관,교육부,주례여자중학교,교육부 부산광역시교육청 부산광역시북부교육지원청 주례여자중학교,35,35,0,35,25,10,0,0
교육기관,교육부,주례중학교,교육부 부산광역시교육청 부산광역시북부교육지원청 주례중학교,37,37,0,37,18,19,0,0
교육기관,교육부,주양초등학교,교육부 부산광역시교육청 부산광역시북부교육지원청 주양초등학교,20,20,0,20,10,10,0,0
교육기관,교육부,주학초등학교,교육부 부산광역시교육청 부산광역시북부교육지원청 주학초등학교,11,11,0,11,11,0,0,0
교육기관,교육부,지사중학교,교육부 부산광역시교육청 부산광역시북부교육지원청 지사중학교,50,0,50,0,0,0,0,0
교육기관,교육부,창진초등학교,교육부 부산광역시교육청 부산광역시북부교육지원청 창진초등학교,10,10,0,10,5,5,0,0
교육기관,교육부,포천초등학교,교육부 부산광역시교육청 부산광역시북부교육지원청 포천초등학교,22,22,0,22,15,7,0,0
교육기관,교육부,포천초등학교병설유치원,교육부 부산광역시교육청 부산광역시북부교육지원청 포천초등학교병설유치원,5,5,0,5,3,2,0,0
교육기관,교육부,학사초등학교,교육부 부산광역시교육청 부산광역시북부교육지원청 학사초등학교,13,13,0,13,13,0,0,0
교육기관,교육부,학장중학교,교육부 부산광역시교육청 부산광역시북부교육지원청 학장중학교,37,35,2,35,31,4,0,0
교육기관,교육부,학장초등학교,교육부 부산광역시교육청 부산광역시북부교육지원청 학장초등학교,18,18,0,18,18,0,0,0
교육기관,교육부,학진초등학교,교육부 부산광역시교육청 부산광역시북부교육지원청 학진초등학교,12,12,0,12,12,0,0,0
교육기관,교육부,한빛유치원,교육부 부산광역시교육청 부산광역시북부교육지원청 한빛유치원,8,8,0,8,0,8,0,0
교육기관,교육부,화명꿈유치원,교육부 부산광역시교육청 부산광역시북부교육지원청 화명꿈유치원,10,10,0,10,3,7,0,0
교육기관,교육부,화명중학교,교육부 부산광역시교육청 부산광역시북부교육지원청 화명중학교,37,37,0,37,37,0,0,0
교육기관,교육부,화잠초등학교,교육부 부산광역시교육청 부산광역시북부교육지원청 화잠초등학교,30,30,0,30,24,6,0,0
교육기관,교육부,화잠초등학교병설유치원,교육부 부산광역시교육청 부산광역시북부교육지원청 화잠초등학교병설유치원,6,2,4,2,2,0,0,0
교육기관,교육부,화정초등학교,교육부 부산광역시교육청 부산광역시북부교육지원청 화정초등학교,32,32,0,32,25,7,0,0
교육기관,교육부,부산광역시서부교육지원청,교육부 부산광역시교육청 부산광역시서부교육지원청,7,7,0,7,7,0,0,0
교육기관,교육부,감천초등학교,교육부 부산광역시교육청 부산광역시서부교육지원청 감천초등학교,24,24,0,24,9,15,0,0
교육기관,교육부,건국중학교,교육부 부산광역시교육청 부산광역시서부교육지원청 건국중학교,23,23,0,23,0,23,0,0
교육기관,교육부,경남중학교,교육부 부산광역시교육청 부산광역시서부교육지원청 경남중학교,64,64,0,64,16,42,4,2
교육기관,교육부,광일초등학교,교육부 부산광역시교육청 부산광역시서부교육지원청 광일초등학교,18,18,0,18,18,0,0,0
교육기관,교육부,광일초등학교병설유치원,교육부 부산광역시교육청 부산광역시서부교육지원청 광일초등학교병설유치원,3,3,0,3,3,0,0,0
교육기관,교육부,괴정초등학교,교육부 부산광역시교육청 부산광역시서부교육지원청 괴정초등학교,29,29,0,29,29,0,0,0
교육기관,교육부,구덕초등학교,교육부 부산광역시교육청 부산광역시서부교육지원청 구덕초등학교,9,9,0,9,9,0,0,0
교육기관,교육부,구평초등학교,교육부 부산광역시교육청 부산광역시서부교육지원청 구평초등학교,16,16,0,16,16,0,0,0
교육기관,교육부,남도여자중학교,교육부 부산광역시교육청 부산광역시서부교육지원청 남도여자중학교,15,15,0,15,11,3,1,0
교육기관,교육부,남부민초등학교,교육부 부산광역시교육청 부산광역시서부교육지원청 남부민초등학교,10,9,1,9,9,0,0,0
교육기관,교육부,남부민초등학교병설유치원,교육부 부산광역시교육청 부산광역시서부교육지원청 남부민초등학교병설유치원,1,1,0,1,1,0,0,0
교육기관,교육부,남항초등학교,교육부 부산광역시교육청 부산광역시서부교육지원청 남항초등학교,14,14,0,14,0,14,0,0
교육기관,교육부,노틀담유치원,교육부 부산광역시교육청 부산광역시서부교육지원청 노틀담유치원,21,1,20,1,1,0,0,0
교육기관,교육부,놀이아유치원,교육부 부산광역시교육청 부산광역시서부교육지원청 놀이아유치원,10,10,0,10,3,7,0,0
교육기관,교육부,다대중학교,교육부 부산광역시교육청 부산광역시서부교육지원청 다대중학교,41,41,0,41,35,3,0,3
교육기관,교육부,다대초등학교,교육부 부산광역시교육청 부산광역시서부교육지원청 다대초등학교,16,16,0,16,11,2,1,2
교육기관,교육부,다선중학교,교육부 부산광역시교육청 부산광역시서부교육지원청 다선중학교,31,31,0,31,21,10,0,0
교육기관,교육부,다송중학교,교육부 부산광역시교육청 부산광역시서부교육지원청 다송중학교,46,46,0,46,30,10,3,3
교육기관,교육부,다송초등학교,교육부 부산광역시교육청 부산광역시서부교육지원청 다송초등학교,16,16,0,16,16,0,0,0
교육기관,교육부,다송초등학교병설유치원,교육부 부산광역시교육청 부산광역시서부교육지원청 다송초등학교병설유치원,20,20,0,20,20,0,0,0
교육기관,교육부,당리중학교,교육부 부산광역시교육청 부산광역시서부교육지원청 당리중학교,33,33,0,33,33,0,0,0
교육기관,교육부,당리초등학교,교육부 부산광역시교육청 부산광역시서부교육지원청 당리초등학교,11,11,0,11,11,0,0,0
교육기관,교육부,대교초등학교,교육부 부산광역시교육청 부산광역시서부교육지원청 대교초등학교,13,13,0,13,0,13,0,0
교육기관,교육부,대동중학교,교육부 부산광역시교육청 부산광역시서부교육지원청 대동중학교,26,26,0,26,18,8,0,0
교육기관,교육부,대신여자중학교,교육부 부산광역시교육청 부산광역시서부교육지원청 대신여자중학교,5,4,1,4,0,4,0,0
교육기관,교육부,대신초등학교,교육부 부산광역시교육청 부산광역시서부교육지원청 대신초등학교,39,39,0,39,28,11,0,0
교육기관,교육부,대평초등학교,교육부 부산광역시교육청 부산광역시서부교육지원청 대평초등학교,14,11,3,11,0,11,0,0
교육기관,교육부,더푸르네유치원,교육부 부산광역시교육청 부산광역시서부교육지원청 더푸르네유치원,13,0,13,0,0,0,0,0
교육기관,교육부,덕원중학교,교육부 부산광역시교육청 부산광역시서부교육지원청 덕원중학교,32,32,0,32,16,16,0,0
교육기관,교육부,동삼초등학교,교육부 부산광역시교육청 부산광역시서부교육지원청 동삼초등학교,16,16,0,16,2,14,0,0
교육기관,교육부,동신초등학교,교육부 부산광역시교육청 부산광역시서부교육지원청 동신초등학교,19,19,0,19,10,9,0,0
교육기관,교육부,두송중학교,교육부 부산광역시교육청 부산광역시서부교육지원청 두송중학교,49,0,49,0,0,0,0,0
교육기관,교육부,롯데캐슬유치원,교육부 부산광역시교육청 부산광역시서부교육지원청 롯데캐슬유치원,10,10,0,10,1,8,1,0
교육기관,교육부,몰운대초등학교,교육부 부산광역시교육청 부산광역시서부교육지원청 몰운대초등학교,16,16,0,16,0,16,0,0
교육기관,교육부,몰운대초등학교병설유치원,교육부 부산광역시교육청 부산광역시서부교육지원청 몰운대초등학교병설유치원,16,16,0,16,0,16,0,0
교육기관,교육부,바다유치원,교육부 부산광역시교육청 부산광역시서부교육지원청 바다유치원,12,2,10,2,1,1,0,0
교육기관,교육부,보림초등학교,교육부 부산광역시교육청 부산광역시서부교육지원청 보림초등학교,16,16,0,16,7,8,1,0
교육기관,교육부,복자유치원,교육부 부산광역시교육청 부산광역시서부교육지원청 복자유치원,13,13,0,13,2,11,0,0
교육기관,교육부,봉래초등학교,교육부 부산광역시교육청 부산광역시서부교육지원청 봉래초등학교,11,11,0,11,10,1,0,0
교육기관,교육부,봉삼초등학교,교육부 부산광역시교육청 부산광역시서부교육지원청 봉삼초등학교,16,16,0,16,16,0,0,0
교육기관,교육부,봉우리유치원,교육부 부산광역시교육청 부산광역시서부교육지원청 봉우리유치원,5,1,4,1,0,1,0,0
교육기관,교육부,봉학초등학교,교육부 부산광역시교육청 부산광역시서부교육지원청 봉학초등학교,16,16,0,16,9,5,1,1
교육기관,교육부,봉학초등학교병설유치원,교육부 부산광역시교육청 부산광역시서부교육지원청 봉학초등학교병설유치원,8,8,0,8,3,5,0,0
교육기관,교육부,부민초등학교,교육부 부산광역시교육청 부산광역시서부교육지원청 부민초등학교,11,11,0,11,11,0,0,0
교육기관,교육부,부산남중학교,교육부 부산광역시교육청 부산광역시서부교육지원청 부산남중학교,23,23,0,23,13,10,0,0
교육기관,교육부,부산대신중학교,교육부 부산광역시교육청 부산광역시서부교육지원청 부산대신중학교,53,53,0,53,0,53,0,0
교육기관,교육부,부산알로이시오초등학교,교육부 부산광역시교육청 부산광역시서부교육지원청 부산알로이시오초등학교,5,5,0,5,0,5,0,0
교육기관,교육부,부산여자중학교,교육부 부산광역시교육청 부산광역시서부교육지원청 부산여자중학교,21,21,0,21,21,0,0,0
교육기관,교육부,부산중앙여자중학교,교육부 부산광역시교육청 부산광역시서부교육지원청 부산중앙여자중학교,25,25,0,25,25,0,0,0
교육기관,교육부,부산체육중학교,교육부 부산광역시교육청 부산광역시서부교육지원청 부산체육중학교,13,13,0,13,0,13,0,0
교육기관,교육부,사남초등학교,교육부 부산광역시교육청 부산광역시서부교육지원청 사남초등학교,13,13,0,13,13,0,0,0
교육기관,교육부,사동초등학교,교육부 부산광역시교육청 부산광역시서부교육지원청 사동초등학교,27,27,0,27,17,10,0,0
교육기관,교육부,사동초등학교병설유치원,교육부 부산광역시교육청 부산광역시서부교육지원청 사동초등학교병설유치원,27,27,0,27,17,10,0,0
교육기관,교육부,사하중학교,교육부 부산광역시교육청 부산광역시서부교육지원청 사하중학교,38,38,0,38,0,38,0,0
교육기관,교육부,사하초등학교,교육부 부산광역시교육청 부산광역시서부교육지원청 사하초등학교,30,30,0,30,26,4,0,0
교육기관,교육부,삼성중학교,교육부 부산광역시교육청 부산광역시서부교육지원청 삼성중학교,18,18,0,18,0,18,0,0
교육기관,교육부,상리초등학교,교육부 부산광역시교육청 부산광역시서부교육지원청 상리초등학교,19,16,3,16,16,0,0,0
교육기관,교육부,서천초등학교,교육부 부산광역시교육청 부산광역시서부교육지원청 서천초등학교,24,24,0,24,24,0,0,0
교육기관,교육부,송도초등학교,교육부 부산광역시교육청 부산광역시서부교육지원청 송도초등학교,23,23,0,23,12,11,0,0
교육기관,교육부,승학초등학교,교육부 부산광역시교육청 부산광역시서부교육지원청 승학초등학교,15,15,0,15,10,5,0,0
교육기관,교육부,신남초등학교,교육부 부산광역시교육청 부산광역시서부교육지원청 신남초등학교,15,15,0,15,9,6,0,0
교육기관,교육부,신선중학교,교육부 부산광역시교육청 부산광역시서부교육지원청 신선중학교,23,22,1,22,20,2,0,0
교육기관,교육부,신선초등학교,교육부 부산광역시교육청 부산광역시서부교육지원청 신선초등학교,14,14,0,14,7,7,0,0
교육기관,교육부,신촌초등학교,교육부 부산광역시교육청 부산광역시서부교육지원청 신촌초등학교,10,10,0,10,0,10,0,0
교육기관,교육부,신평초등학교,교육부 부산광역시교육청 부산광역시서부교육지원청 신평초등학교,21,21,0,21,9,12,0,0
교육기관,교육부,아미초등학교,교육부 부산광역시교육청 부산광역시서부교육지원청 아미초등학교,20,20,0,20,0,20,0,0
교육기관,교육부,아미초등학교병설유치원,교육부 부산광역시교육청 부산광역시서부교육지원청 아미초등학교병설유치원,20,9,11,9,5,4,0,0
교육기관,교육부,영남중학교,교육부 부산광역시교육청 부산광역시서부교육지원청 영남중학교,32,32,0,32,0,32,0,0
교육기관,교육부,영도제일중학교,교육부 부산광역시교육청 부산광역시서부교육지원청 영도제일중학교,46,46,0,46,5,41,0,0
교육기관,교육부,영도초등학교,교육부 부산광역시교육청 부산광역시서부교육지원청 영도초등학교,23,23,0,23,23,0,0,0
교육기관,교육부,영일유치원,교육부 부산광역시교육청 부산광역시서부교육지원청 영일유치원,11,11,0,11,11,0,0,0
교육기관,교육부,옥천초등학교,교육부 부산광역시교육청 부산광역시서부교육지원청 옥천초등학교,19,19,0,19,8,11,0,0
교육기관,교육부,을숙도초등학교,교육부 부산광역시교육청 부산광역시서부교육지원청 을숙도초등학교,16,16,0,16,13,3,0,0
교육기관,교육부,응봉초등학교,교육부 부산광역시교육청 부산광역시서부교육지원청 응봉초등학교,12,12,0,12,3,3,3,3
교육기관,교육부,장림여자중학교,교육부 부산광역시교육청 부산광역시서부교육지원청 장림여자중학교,34,34,0,34,0,34,0,0
교육기관,교육부,장림초등학교병설유치원,교육부 부산광역시교육청 부산광역시서부교육지원청 장림초등학교병설유치원,24,24,0,24,24,0,0,0
교육기관,교육부,장평중학교,교육부 부산광역시교육청 부산광역시서부교육지원청 장평중학교,40,37,3,37,37,0,0,0
교육기관,교육부,절영초등학교,교육부 부산광역시교육청 부산광역시서부교육지원청 절영초등학교,24,24,0,24,24,0,0,0
교육기관,교육부,조아라유치원,교육부 부산광역시교육청 부산광역시서부교육지원청 조아라유치원,12,1,11,1,0,1,0,0
교육기관,교육부,중리초등학교,교육부 부산광역시교육청 부산광역시서부교육지원청 중리초등학교,22,22,0,22,20,2,0,0
교육기관,교육부,중현초등학교,교육부 부산광역시교육청 부산광역시서부교육지원청 중현초등학교,30,30,0,30,27,0,3,0
교육기관,교육부,즐거운루다유치원,교육부 부산광역시교육청 부산광역시서부교육지원청 즐거운루다유치원,30,30,0,30,0,30,0,0
교육기관,교육부,지산유치원,교육부 부산광역시교육청 부산광역시서부교육지원청 지산유치원,10,10,0,10,0,10,0,0
교육기관,교육부,천마초등학교,교육부 부산광역시교육청 부산광역시서부교육지원청 천마초등학교,16,16,0,16,16,0,0,0
교육기관,교육부,청동초등학교,교육부 부산광역시교육청 부산광역시서부교육지원청 청동초등학교,24,24,0,24,24,0,0,0
교육기관,교육부,청학초등학교,교육부 부산광역시교육청 부산광역시서부교육지원청 청학초등학교,16,16,0,16,6,10,0,0
교육기관,교육부,초장중학교,교육부 부산광역시교육청 부산광역시서부교육지원청 초장중학교,48,48,0,48,45,3,0,0
교육기관,교육부,태종대중학교,교육부 부산광역시교육청 부산광역시서부교육지원청 태종대중학교,34,34,0,34,0,34,0,0
교육기관,교육부,태종대초등학교,교육부 부산광역시교육청 부산광역시서부교육지원청 태종대초등학교,16,16,0,16,16,0,0,0
교육기관,교육부,토성초등학교병설유치원,교육부 부산광역시교육청 부산광역시서부교육지원청 토성초등학교병설유치원,16,16,0,16,0,16,0,0
교육기관,교육부,푸른유치원,교육부 부산광역시교육청 부산광역시서부교육지원청 푸른유치원,14,2,12,2,1,0,1,0
교육기관,교육부,하남중학교,교육부 부산광역시교육청 부산광역시서부교육지원청 하남중학교,41,41,0,41,41,0,0,0
교육기관,교육부,하남초등학교,교육부 부산광역시교육청 부산광역시서부교육지원청 하남초등학교,15,15,0,15,15,0,0,0
교육기관,교육부,하남초등학교병설유치원,교육부 부산광역시교육청 부산광역시서부교육지원청 하남초등학교병설유치원,6,0,6,0,0,0,0,0
교육기관,교육부,하늘꽃유치원,교육부 부산광역시교육청 부산광역시서부교육지원청 하늘꽃유치원,16,16,0,16,13,3,0,0
교육기관,교육부,하늘유치원,교육부 부산광역시교육청 부산광역시서부교육지원청 하늘유치원,10,10,0,10,10,0,0,0
교육기관,교육부,하단중학교,교육부 부산광역시교육청 부산광역시서부교육지원청 하단중학교,23,22,1,22,9,9,2,2
교육기관,교육부,하단초등학교,교육부 부산광역시교육청 부산광역시서부교육지원청 하단초등학교,19,19,0,19,19,0,0,0
교육기관,교육부,하단초등학교병설유치원,교육부 부산광역시교육청 부산광역시서부교육지원청 하단초등학교병설유치원,6,6,0,6,0,6,0,0
교육기관,교육부,한마음유치원,교육부 부산광역시교육청 부산광역시서부교육지원청 한마음유치원,7,7,0,7,2,5,0,0
교육기관,교육부,해동중학교,교육부 부산광역시교육청 부산광역시서부교육지원청 해동중학교,12,12,0,12,12,0,0,0
교육기관,교육부,햇빛유치원,교육부 부산광역시교육청 부산광역시서부교육지원청 햇빛유치원,12,12,0,12,6,6,0,0
교육기관,교육부,호산나유치원,교육부 부산광역시교육청 부산광역시서부교육지원청 호산나유치원,8,8,0,8,8,0,0,0
교육기관,교육부,화랑초등학교,교육부 부산광역시교육청 부산광역시서부교육지원청 화랑초등학교,21,21,0,21,10,11,0,0
교육기관,교육부,효림초등학교,교육부 부산광역시교육청 부산광역시서부교육지원청 효림초등학교,24,24,0,24,3,21,0,0
교육기관,교육부,부산광역시어린이창의교육관,교육부 부산광역시교육청 부산광역시어린이창의교육관,74,74,0,74,0,74,0,0
교육기관,교육부,부산광역시유아교육진흥원,교육부 부산광역시교육청 부산광역시유아교육진흥원,65,65,0,65,2,61,2,0
교육기관,교육부,부산광역시창의융합교육원,교육부 부산광역시교육청 부산광역시창의융합교육원,61,61,0,61,0,61,0,0
교육기관,교육부,부산광역시학생교육문화회관,교육부 부산광역시교육청 부산광역시학생교육문화회관,41,41,0,41,0,41,0,0
교육기관,교육부,부산광역시학생교육원,교육부 부산광역시교육청 부산광역시학생교육원,15,15,0,15,0,15,0,0
교육기관,교육부,부산광역시학생예술문화회관,교육부 부산광역시교육청 부산광역시학생예술문화회관,60,60,0,60,0,60,0,0
교육기관,교육부,부산광역시해운대교육지원청,교육부 부산광역시교육청 부산광역시해운대교육지원청,16,16,0,16,1,15,0,0
교육기관,교육부,가동유치원,교육부 부산광역시교육청 부산광역시해운대교육지원청 가동유치원,8,8,0,8,0,8,0,0
교육기관,교육부,가동초등학교,교육부 부산광역시교육청 부산광역시해운대교육지원청 가동초등학교,16,16,0,16,16,0,0,0
교육기관,교육부,강동유치원,교육부 부산광역시교육청 부산광역시해운대교육지원청 강동유치원,9,9,0,9,4,5,0,0
교육기관,교육부,강동초등학교,교육부 부산광역시교육청 부산광역시해운대교육지원청 강동초등학교,30,30,0,30,15,15,0,0
교육기관,교육부,광남초등학교,교육부 부산광역시교육청 부산광역시해운대교육지원청 광남초등학교,28,28,0,28,2,26,0,0
교육기관,교육부,광남초등학교병설유치원,교육부 부산광역시교육청 부산광역시해운대교육지원청 광남초등학교병설유치원,28,28,0,28,2,26,0,0
교육기관,교육부,광안유치원,교육부 부산광역시교육청 부산광역시해운대교육지원청 광안유치원,14,14,0,14,0,14,0,0
교육기관,교육부,광안중학교,교육부 부산광역시교육청 부산광역시해운대교육지원청 광안중학교,36,36,0,36,28,8,0,0
교육기관,교육부,광안초등학교,교육부 부산광역시교육청 부산광역시해운대교육지원청 광안초등학교,28,28,0,28,18,10,0,0
교육기관,교육부,교리초등학교,교육부 부산광역시교육청 부산광역시해운대교육지원청 교리초등학교,16,16,0,16,15,1,0,0
교육기관,교육부,교리초등학교병설유치원,교육부 부산광역시교육청 부산광역시해운대교육지원청 교리초등학교병설유치원,6,6,0,6,3,3,0,0
교육기관,교육부,기장중학교,교육부 부산광역시교육청 부산광역시해운대교육지원청 기장중학교,44,44,0,44,4,40,0,0
교육기관,교육부,기장초등학교병설유치원,교육부 부산광역시교육청 부산광역시해운대교육지원청 기장초등학교병설유치원,5,5,0,5,3,2,0,0
교육기관,교육부,남천유치원,교육부 부산광역시교육청 부산광역시해운대교육지원청 남천유치원,12,4,8,4,0,4,0,0
교육기관,교육부,남천초등학교,교육부 부산광역시교육청 부산광역시해운대교육지원청 남천초등학교,25,25,0,25,25,0,0,0
교육기관,교육부,내리초등학교,교육부 부산광역시교육청 부산광역시해운대교육지원청 내리초등학교,16,16,0,16,0,13,3,0
교육기관,교육부,녹원유치원,교육부 부산광역시교육청 부산광역시해운대교육지원청 녹원유치원,8,8,0,8,8,0,0,0
교육기관,교육부,달산유치원,교육부 부산광역시교육청 부산광역시해운대교육지원청 달산유치원,14,14,0,14,14,0,0,0
교육기관,교육부,달산초등학교,교육부 부산광역시교육청 부산광역시해운대교육지원청 달산초등학교,21,21,0,21,4,12,5,0
교육기관,교육부,대동유치원,교육부 부산광역시교육청 부산광역시해운대교육지원청 대동유치원,19,0,19,0,0,0,0,0
교육기관,교육부,대림유치원,교육부 부산광역시교육청 부산광역시해운대교육지원청 대림유치원,10,10,0,10,4,6,0,0
교육기관,교육부,대우사랑유치원,교육부 부산광역시교육청 부산광역시해운대교육지원청 대우사랑유치원,16,4,12,4,0,4,0,0
교육기관,교육부,대청중학교,교육부 부산광역시교육청 부산광역시해운대교육지원청 대청중학교,40,40,0,40,32,8,0,0
교육기관,교육부,더푸른유치원,교육부 부산광역시교육청 부산광역시해운대교육지원청 더푸른유치원,29,29,0,29,0,29,0,0
교육기관,교육부,동백중학교,교육부 부산광역시교육청 부산광역시해운대교육지원청 동백중학교,48,46,2,46,46,0,0,0
교육기관,교육부,동백초등학교,교육부 부산광역시교육청 부산광역시해운대교육지원청 동백초등학교,14,14,0,14,7,7,0,0
교육기관,교육부,동성제일유치원,교육부 부산광역시교육청 부산광역시해운대교육지원청 동성제일유치원,16,16,0,16,4,12,0,0
교육기관,교육부,동수영중학교,교육부 부산광역시교육청 부산광역시해운대교육지원청 동수영중학교,33,33,0,33,4,29,0,0
교육기관,교육부,동아중학교,교육부 부산광역시교육청 부산광역시해운대교육지원청 동아중학교,30,30,0,30,15,13,2,0
교육기관,교육부,마리나유치원,교육부 부산광역시교육청 부산광역시해운대교육지원청 마리나유치원,16,16,0,16,0,16,0,0
교육기관,교육부,망미중학교,교육부 부산광역시교육청 부산광역시해운대교육지원청 망미중학교,16,16,0,16,11,5,0,0
교육기관,교육부,망미초등학교,교육부 부산광역시교육청 부산광역시해운대교육지원청 망미초등학교,16,16,0,16,16,0,0,0
교육기관,교육부,모전중학교,교육부 부산광역시교육청 부산광역시해운대교육지원청 모전중학교,94,94,0,94,64,30,0,0
교육기관,교육부,모전초등학교,교육부 부산광역시교육청 부산광역시해운대교육지원청 모전초등학교,33,33,0,33,33,0,0,0
교육기관,교육부,모전초등학교병설유치원,교육부 부산광역시교육청 부산광역시해운대교육지원청 모전초등학교병설유치원,4,4,0,4,4,0,0,0
교육기관,교육부,무정초등학교,교육부 부산광역시교육청 부산광역시해운대교육지원청 무정초등학교,11,11,0,11,11,0,0,0
교육기관,교육부,민락초등학교,교육부 부산광역시교육청 부산광역시해운대교육지원청 민락초등학교,14,14,0,14,14,0,0,0
교육기관,교육부,민락초등학교병설유치원,교육부 부산광역시교육청 부산광역시해운대교육지원청 민락초등학교병설유치원,3,3,0,3,1,2,0,0
교육기관,교육부,민안초등학교,교육부 부산광역시교육청 부산광역시해운대교육지원청 민안초등학교,16,16,0,16,13,1,1,1
교육기관,교육부,반산초등학교,교육부 부산광역시교육청 부산광역시해운대교육지원청 반산초등학교,16,16,0,16,16,0,0,0
교육기관,교육부,반산초등학교병설유치원,교육부 부산광역시교육청 부산광역시해운대교육지원청 반산초등학교병설유치원,7,7,0,7,7,0,0,0
교육기관,교육부,반석초등학교,교육부 부산광역시교육청 부산광역시해운대교육지원청 반석초등학교,13,13,0,13,0,13,0,0
교육기관,교육부,반송여자중학교,교육부 부산광역시교육청 부산광역시해운대교육지원청 반송여자중학교,24,24,0,24,24,0,0,0
교육기관,교육부,반송중학교,교육부 부산광역시교육청 부산광역시해운대교육지원청 반송중학교,48,48,0,48,31,17,0,0
교육기관,교육부,반송초등학교,교육부 부산광역시교육청 부산광역시해운대교육지원청 반송초등학교,20,20,0,20,15,5,0,0
교육기관,교육부,반안중학교,교육부 부산광역시교육청 부산광역시해운대교육지원청 반안중학교,20,20,0,20,18,2,0,0
교육기관,교육부,반안초등학교,교육부 부산광역시교육청 부산광역시해운대교육지원청 반안초등학교,16,16,0,16,0,16,0,0
교육기관,교육부,반여중학교,교육부 부산광역시교육청 부산광역시해운대교육지원청 반여중학교,29,27,2,27,13,13,1,0
교육기관,교육부,반여초등학교,교육부 부산광역시교육청 부산광역시해운대교육지원청 반여초등학교,47,47,0,47,0,47,0,0
교육기관,교육부,반여초등학교병설유치원,교육부 부산광역시교육청 부산광역시해운대교육지원청 반여초등학교병설유치원,1,1,0,1,1,0,0,0
교육기관,교육부,방곡유치원,교육부 부산광역시교육청 부산광역시해운대교육지원청 방곡유치원,15,15,0,15,0,15,0,0
교육기관,교육부,방곡초등학교,교육부 부산광역시교육청 부산광역시해운대교육지원청 방곡초등학교,25,25,0,25,0,25,0,0
교육기관,교육부,배산초등학교,교육부 부산광역시교육청 부산광역시해운대교육지원청 배산초등학교,13,13,0,13,10,3,0,0
교육기관,교육부,버드내유치원,교육부 부산광역시교육청 부산광역시해운대교육지원청 버드내유치원,4,4,0,4,4,0,0,0
교육기관,교육부,부산수영중학교,교육부 부산광역시교육청 부산광역시해운대교육지원청 부산수영중학교,45,45,0,45,21,24,0,0
교육기관,교육부,부산중앙중학교,교육부 부산광역시교육청 부산광역시해운대교육지원청 부산중앙중학교,71,71,0,71,71,0,0,0
교육기관,교육부,부흥중학교,교육부 부산광역시교육청 부산광역시해운대교육지원청 부흥중학교,58,58,0,58,58,0,0,0
교육기관,교육부,부흥초등학교,교육부 부산광역시교육청 부산광역시해운대교육지원청 부흥초등학교,30,30,0,30,14,15,1,0
교육기관,교육부,분도유치원,교육부 부산광역시교육청 부산광역시해운대교육지원청 분도유치원,31,31,0,31,1,30,0,0
교육기관,교육부,쁘띠포레유치원,교육부 부산광역시교육청 부산광역시해운대교육지원청 쁘띠포레유치원,21,21,0,21,8,13,0,0
교육기관,교육부,산새소리유치원,교육부 부산광역시교육청 부산광역시해운대교육지원청 산새소리유치원,2,2,0,2,2,0,0,0
교육기관,교육부,삼어초등학교,교육부 부산광역시교육청 부산광역시해운대교육지원청 삼어초등학교,16,16,0,16,10,6,0,0
교육기관,교육부,상당중학교,교육부 부산광역시교육청 부산광역시해운대교육지원청 상당중학교,42,42,0,42,42,0,0,0
교육기관,교육부,상당초등학교,교육부 부산광역시교육청 부산광역시해운대교육지원청 상당초등학교,12,12,0,12,12,0,0,0
교육기관,교육부,성모유치원,교육부 부산광역시교육청 부산광역시해운대교육지원청 성모유치원,21,21,0,21,4,17,0,0
교육기관,교육부,센텀유치원,교육부 부산광역시교육청 부산광역시해운대교육지원청 센텀유치원,20,20,0,20,0,20,0,0
교육기관,교육부,센텀중학교,교육부 부산광역시교육청 부산광역시해운대교육지원청 센텀중학교,52,52,0,52,52,0,0,0
교육기관,교육부,센텀초등학교,교육부 부산광역시교육청 부산광역시해운대교육지원청 센텀초등학교,21,21,0,21,12,9,0,0
교육기관,교육부,센텀항도유치원,교육부 부산광역시교육청 부산광역시해운대교육지원청 센텀항도유치원,8,1,7,1,0,1,0,0
교육기관,교육부,송수초등학교,교육부 부산광역시교육청 부산광역시해운대교육지원청 송수초등학교,16,16,0,16,0,16,0,0
교육기관,교육부,송운초등학교,교육부 부산광역시교육청 부산광역시해운대교육지원청 송운초등학교,19,19,0,19,0,19,0,0
교육기관,교육부,송정초등학교,교육부 부산광역시교육청 부산광역시해운대교육지원청 송정초등학교,19,19,0,19,19,0,0,0
교육기관,교육부,수미초등학교,교육부 부산광역시교육청 부산광역시해운대교육지원청 수미초등학교,26,26,0,26,0,26,0,0
교육기관,교육부,수영로유치원,교육부 부산광역시교육청 부산광역시해운대교육지원청 수영로유치원,36,1,35,1,1,0,0,0
교육기관,교육부,수영초등학교,교육부 부산광역시교육청 부산광역시해운대교육지원청 수영초등학교,32,32,0,32,24,8,0,0
교육기관,교육부,숲속원광유치원,교육부 부산광역시교육청 부산광역시해운대교육지원청 숲속원광유치원,19,3,16,3,1,1,0,1
교육기관,교육부,신곡중학교,교육부 부산광역시교육청 부산광역시해운대교육지원청 신곡중학교,52,52,0,52,25,27,0,0
교육기관,교육부,신곡초등학교,교육부 부산광역시교육청 부산광역시해운대교육지원청 신곡초등학교,13,13,0,13,13,0,0,0
교육기관,교육부,신도중학교,교육부 부산광역시교육청 부산광역시해운대교육지원청 신도중학교,41,41,0,41,41,0,0,0
교육기관,교육부,신도초등학교,교육부 부산광역시교육청 부산광역시해운대교육지원청 신도초등학교,13,13,0,13,6,7,0,0
교육기관,교육부,신재초등학교,교육부 부산광역시교육청 부산광역시해운대교육지원청 신재초등학교,23,23,0,23,23,0,0,0
교육기관,교육부,신정중학교,교육부 부산광역시교육청 부산광역시해운대교육지원청 신정중학교,71,71,0,71,55,16,0,0
교육기관,교육부,신정초등학교,교육부 부산광역시교육청 부산광역시해운대교육지원청 신정초등학교,20,20,0,20,20,0,0,0
교육기관,교육부,신진초등학교,교육부 부산광역시교육청 부산광역시해운대교육지원청 신진초등학교,30,30,0,30,13,10,4,3
교육기관,교육부,아이윌유치원,교육부 부산광역시교육청 부산광역시해운대교육지원청 아이윌유치원,16,16,0,16,0,16,0,0
교육기관,교육부,양운중학교,교육부 부산광역시교육청 부산광역시해운대교육지원청 양운중학교,29,29,0,29,29,0,0,0
교육기관,교육부,양운초등학교,교육부 부산광역시교육청 부산광역시해운대교육지원청 양운초등학교,11,11,0,11,9,2,0,0
교육기관,교육부,양운초등학교병설유치원,교육부 부산광역시교육청 부산광역시해운대교육지원청 양운초등학교병설유치원,7,7,0,7,0,7,0,0
교육기관,교육부,에버그린유치원,교육부 부산광역시교육청 부산광역시해운대교육지원청 에버그린유치원,8,8,0,8,0,8,0,0
교육기관,교육부,영주암유치원,교육부 부산광역시교육청 부산광역시해운대교육지원청 영주암유치원,10,3,7,3,1,2,0,0
교육기관,교육부,용암초등학교,교육부 부산광역시교육청 부산광역시해운대교육지원청 용암초등학교,25,25,0,25,5,20,0,0
교육기관,교육부,용암초등학교병설유치원,교육부 부산광역시교육청 부산광역시해운대교육지원청 용암초등학교병설유치원,25,22,3,22,10,6,4,2
교육기관,교육부,운봉초등학교,교육부 부산광역시교육청 부산광역시해운대교육지원청 운봉초등학교,20,20,0,20,0,20,0,0
교육기관,교육부,운봉초등학교병설유치원,교육부 부산광역시교육청 부산광역시해운대교육지원청 운봉초등학교병설유치원,4,4,0,4,2,2,0,0
교육기관,교육부,운송초등학교,교육부 부산광역시교육청 부산광역시해운대교육지원청 운송초등학교,15,15,0,15,15,0,0,0
교육기관,교육부,월내초등학교,교육부 부산광역시교육청 부산광역시해운대교육지원청 월내초등학교,23,23,0,23,13,10,0,0
교육기관,교육부,월내초등학교병설유치원,교육부 부산광역시교육청 부산광역시해운대교육지원청 월내초등학교병설유치원,3,3,0,3,3,0,0,0
교육기관,교육부,월평초등학교,교육부 부산광역시교육청 부산광역시해운대교육지원청 월평초등학교,20,20,0,20,0,20,0,0
교육기관,교육부,월평초등학교병설유치원,교육부 부산광역시교육청 부산광역시해운대교육지원청 월평초등학교병설유치원,20,20,0,20,0,20,0,0
교육기관,교육부,은혜유치원,교육부 부산광역시교육청 부산광역시해운대교육지원청 은혜유치원,25,6,19,6,2,2,1,1
교육기관,교육부,인지중학교,교육부 부산광역시교육청 부산광역시해운대교육지원청 인지중학교,59,59,0,59,35,24,0,0
교육기관,교육부,인지초등학교,교육부 부산광역시교육청 부산광역시해운대교육지원청 인지초등학교,16,16,0,16,0,16,0,0
교육기관,교육부,인천유치원,교육부 부산광역시교육청 부산광역시해운대교육지원청 인천유치원,14,8,6,8,4,4,0,0
교육기관,교육부,일광유치원,교육부 부산광역시교육청 부산광역시해운대교육지원청 일광유치원,26,26,0,26,5,21,0,0
교육기관,교육부,일광중학교,교육부 부산광역시교육청 부산광역시해운대교육지원청 일광중학교,58,58,0,58,54,1,0,3
교육기관,교육부,일광초등학교,교육부 부산광역시교육청 부산광역시해운대교육지원청 일광초등학교,36,36,0,36,31,5,0,0
교육기관,교육부,장산중학교,교육부 부산광역시교육청 부산광역시해운대교육지원청 장산중학교,58,58,0,58,45,7,2,4
교육기관,교육부,장산초등학교,교육부 부산광역시교육청 부산광역시해운대교육지원청 장산초등학교,20,20,0,20,20,0,0,0
교육기관,교육부,장안중학교,교육부 부산광역시교육청 부산광역시해운대교육지원청 장안중학교,36,35,1,35,27,8,0,0
교육기관,교육부,장안초등학교,교육부 부산광역시교육청 부산광역시해운대교육지원청 장안초등학교,21,21,0,21,14,7,0,0
교육기관,교육부,장안초등학교병설유치원,교육부 부산광역시교육청 부산광역시해운대교육지원청 장안초등학교병설유치원,21,21,0,21,5,10,3,3
교육기관,교육부,재송여자중학교,교육부 부산광역시교육청 부산광역시해운대교육지원청 재송여자중학교,48,48,0,48,8,40,0,0
교육기관,교육부,재송유치원,교육부 부산광역시교육청 부산광역시해운대교육지원청 재송유치원,8,2,6,2,2,0,0,0
교육기관,교육부,재송중학교,교육부 부산광역시교육청 부산광역시해운대교육지원청 재송중학교,35,35,0,35,19,16,0,0
교육기관,교육부,재송초등학교,교육부 부산광역시교육청 부산광역시해운대교육지원청 재송초등학교,23,23,0,23,23,0,0,0
교육기관,교육부,정관유치원,교육부 부산광역시교육청 부산광역시해운대교육지원청 정관유치원,16,16,0,16,16,0,0,0
교육기관,교육부,정관중학교,교육부 부산광역시교육청 부산광역시해운대교육지원청 정관중학교,62,62,0,62,62,0,0,0
교육기관,교육부,정관초등학교,교육부 부산광역시교육청 부산광역시해운대교육지원청 정관초등학교,23,23,0,23,0,23,0,0
교육기관,교육부,정원초등학교,교육부 부산광역시교육청 부산광역시해운대교육지원청 정원초등학교,41,41,0,41,25,16,0,0
교육기관,교육부,정원초등학교병설유치원,교육부 부산광역시교육청 부산광역시해운대교육지원청 정원초등학교병설유치원,11,11,0,11,0,11,0,0
교육기관,교육부,좌동초등학교,교육부 부산광역시교육청 부산광역시해운대교육지원청 좌동초등학교,14,14,0,14,10,3,0,1
교육기관,교육부,좌산초등학교,교육부 부산광역시교육청 부산광역시해운대교육지원청 좌산초등학교,25,25,0,25,25,0,0,0
교육기관,교육부,좌천초등학교,교육부 부산광역시교육청 부산광역시해운대교육지원청 좌천초등학교,15,15,0,15,13,2,0,0
교육기관,교육부,좌천초등학교병설유치원,교육부 부산광역시교육청 부산광역시해운대교육지원청 좌천초등학교병설유치원,15,15,0,15,15,0,0,0
교육기관,교육부,죽성초등학교,교육부 부산광역시교육청 부산광역시해운대교육지원청 죽성초등학교,6,6,0,6,6,0,0,0
교육기관,교육부,중일유치원,교육부 부산광역시교육청 부산광역시해운대교육지원청 중일유치원,23,23,0,23,6,14,0,3
교육기관,교육부,천사유치원,교육부 부산광역시교육청 부산광역시해운대교육지원청 천사유치원,16,4,12,4,2,2,0,0
교육기관,교육부,철마초등학교,교육부 부산광역시교육청 부산광역시해운대교육지원청 철마초등학교,22,22,0,22,22,0,0,0
교육기관,교육부,칠암초등학교,교육부 부산광역시교육청 부산광역시해운대교육지원청 칠암초등학교,13,13,0,13,13,0,0,0
교육기관,교육부,파랑새유치원,교육부 부산광역시교육청 부산광역시해운대교육지원청 파랑새유치원,16,16,0,16,0,16,0,0
교육기관,교육부,푸른유치원,교육부 부산광역시교육청 부산광역시해운대교육지원청 푸른유치원,14,14,0,14,0,14,0,0
교육기관,교육부,풀꽃유치원,교육부 부산광역시교육청 부산광역시해운대교육지원청 풀꽃유치원,17,2,15,2,1,0,1,0
교육기관,교육부,피터팬유치원,교육부 부산광역시교육청 부산광역시해운대교육지원청 피터팬유치원,29,29,0,29,0,29,0,0
교육기관,교육부,한바다중학교,교육부 부산광역시교육청 부산광역시해운대교육지원청 한바다중학교,58,58,0,58,58,0,0,0
교육기관,교육부,해강유치원,교육부 부산광역시교육청 부산광역시해운대교육지원청 해강유치원,32,7,25,7,0,7,0,0
교육기관,교육부,해강중학교,교육부 부산광역시교육청 부산광역시해운대교육지원청 해강중학교,62,62,0,62,62,0,0,0
교육기관,교육부,해강초등학교,교육부 부산광역시교육청 부산광역시해운대교육지원청 해강초등학교,14,14,0,14,4,10,0,0
교육기관,교육부,해누리유치원,교육부 부산광역시교육청 부산광역시해운대교육지원청 해누리유치원,13,5,8,5,2,3,0,0
교육기관,교육부,해동초등학교,교육부 부산광역시교육청 부산광역시해운대교육지원청 해동초등학교,16,16,0,16,16,0,0,0
교육기관,교육부,해뜨는유치원,교육부 부산광역시교육청 부산광역시해운대교육지원청 해뜨는유치원,15,15,0,15,15,0,0,0
교육기관,교육부,해림초등학교,교육부 부산광역시교육청 부산광역시해운대교육지원청 해림초등학교,25,25,0,25,0,25,0,0
교육기관,교육부,해빛유치원,교육부 부산광역시교육청 부산광역시해운대교육지원청 해빛유치원,24,0,24,0,0,0,0,0
교육기관,교육부,해빛초등학교,교육부 부산광역시교육청 부산광역시해운대교육지원청 해빛초등학교,39,39,0,39,0,39,0,0
교육기관,교육부,해빛초등학교병설유치원,교육부 부산광역시교육청 부산광역시해운대교육지원청 해빛초등학교병설유치원,7,7,0,7,7,0,0,0
교육기관,교육부,해성유치원,교육부 부산광역시교육청 부산광역시해운대교육지원청 해성유치원,14,14,0,14,14,0,0,0
교육기관,교육부,해송초등학교,교육부 부산광역시교육청 부산광역시해운대교육지원청 해송초등학교,16,16,0,16,16,0,0,0
교육기관,교육부,해운대여자중학교,교육부 부산광역시교육청 부산광역시해운대교육지원청 해운대여자중학교,32,32,0,32,32,0,0,0
교육기관,교육부,해운대자연유치원,교육부 부산광역시교육청 부산광역시해운대교육지원청 해운대자연유치원,16,16,0,16,8,8,0,0
교육기관,교육부,해운대초등학교,교육부 부산광역시교육청 부산광역시해운대교육지원청 해운대초등학교,26,26,0,26,5,21,0,0
교육기관,교육부,해원초등학교,교육부 부산광역시교육청 부산광역시해운대교육지원청 해원초등학교,24,24,0,24,18,6,0,0
교육기관,교육부,행복엔젤유치원,교육부 부산광역시교육청 부산광역시해운대교육지원청 행복엔젤유치원,4,4,0,4,1,1,1,1
교육기관,교육부,호암유치원,교육부 부산광역시교육청 부산광역시해운대교육지원청 호암유치원,6,6,0,6,6,0,0,0
교육기관,교육부,호암초등학교,교육부 부산광역시교육청 부산광역시해운대교육지원청 호암초등학교,16,16,0,16,16,0,0,0
교육기관,교육부,부산구화학교,교육부 부산광역시교육청 부산구화학교,16,16,0,16,16,0,0,0
교육기관,교육부,부산국제고등학교,교육부 부산광역시교육청 부산국제고등학교,132,132,0,132,132,0,0,0
교육기관,교육부,부산국제영화고등학교,교육부 부산광역시교육청 부산국제영화고등학교,22,22,0,22,2,20,0,0
교육기관,교육부,부산남고등학교,교육부 부산광역시교육청 부산남고등학교,50,36,14,36,36,0,0,0
교육기관,교육부,부산남일고등학교,교육부 부산광역시교육청 부산남일고등학교,37,37,0,37,30,5,2,0
교육기관,교육부,부산대저고등학교,교육부 부산광역시교육청 부산대저고등학교,34,34,0,34,0,34,0,0
교육기관,교육부,부산대학교사범대학부설고등학교,교육부 부산광역시교육청 부산대학교사범대학부설고등학교,52,52,0,52,52,0,0,0
교육기관,교육부,부산동고등학교,교육부 부산광역시교육청 부산동고등학교,26,26,0,26,12,14,0,0
교육기관,교육부,부산동성고등학교,교육부 부산광역시교육청 부산동성고등학교,39,39,0,39,0,39,0,0
교육기관,교육부,부산동암학교,교육부 부산광역시교육청 부산동암학교,16,16,0,16,8,8,0,0
교육기관,교육부,부산동여자고등학교,교육부 부산광역시교육청 부산동여자고등학교,40,38,2,38,16,22,0,0
교육기관,교육부,부산두레학교,교육부 부산광역시교육청 부산두레학교,39,39,0,39,0,39,0,0
교육기관,교육부,부산디지털고등학교,교육부 부산광역시교육청 부산디지털고등학교,51,51,0,51,44,7,0,0
교육기관,교육부,부산마케팅고등학교,교육부 부산광역시교육청 부산마케팅고등학교,25,25,0,25,0,25,0,0
교육기관,교육부,부산맹학교,교육부 부산광역시교육청 부산맹학교,24,24,0,24,6,17,1,0
교육기관,교육부,부산문화여자고등학교,교육부 부산광역시교육청 부산문화여자고등학교,16,16,0,16,0,16,0,0
교육기관,교육부,부산배화학교,교육부 부산광역시교육청 부산배화학교,20,20,0,20,0,20,0,0
교육기관,교육부,부산백양고등학교,교육부 부산광역시교육청 부산백양고등학교,32,32,0,32,12,20,0,0
교육기관,교육부,부산보건고등학교,교육부 부산광역시교육청 부산보건고등학교,68,68,0,68,0,68,0,0
교육기관,교육부,부산산업학교,교육부 부산광역시교육청 부산산업학교,21,21,0,21,11,10,0,0
교육기관,교육부,부산서여자고등학교,교육부 부산광역시교육청 부산서여자고등학교,23,23,0,23,23,0,0,0
교육기관,교육부,부산성우학교,교육부 부산광역시교육청 부산성우학교,18,18,0,18,0,18,0,0
교육기관,교육부,부산센텀여자고등학교,교육부 부산광역시교육청 부산센텀여자고등학교,39,39,0,39,0,39,0,0
교육기관,교육부,부산소프트웨어마이스터고등학교,교육부 부산광역시교육청 부산소프트웨어마이스터고등학교,82,82,0,82,41,41,0,0
교육기관,교육부,부산솔빛학교,교육부 부산광역시교육청 부산솔빛학교,16,16,0,16,0,16,0,0
교육기관,교육부,부산여자고등학교,교육부 부산광역시교육청 부산여자고등학교,41,39,2,39,39,0,0,0
교육기관,교육부,부산여자상업고등학교,교육부 부산광역시교육청 부산여자상업고등학교,37,37,0,37,3,34,0,0
교육기관,교육부,부산영상예술고등학교,교육부 부산광역시교육청 부산영상예술고등학교,37,37,0,37,0,37,0,0
교육기관,교육부,부산예술고등학교,교육부 부산광역시교육청 부산예술고등학교,47,47,0,47,47,0,0,0
교육기관,교육부,부산외국어고등학교,교육부 부산광역시교육청 부산외국어고등학교,21,21,0,21,0,21,0,0
교육기관,교육부,부산은애학교,교육부 부산광역시교육청 부산은애학교,24,24,0,24,10,14,0,0
교육기관,교육부,부산일과학고등학교,교육부 부산광역시교육청 부산일과학고등학교,92,89,3,89,7,80,1,1
교육기관,교육부,부산자동차고등학교,교육부 부산광역시교육청 부산자동차고등학교,69,68,1,68,0,68,0,0
교육기관,교육부,부산장안고등학교,교육부 부산광역시교육청 부산장안고등학교,22,22,0,22,19,3,0,0
교육기관,교육부,부산전자공업고등학교,교육부 부산광역시교육청 부산전자공업고등학교,90,90,0,90,0,90,0,0
교육기관,교육부,부산정보고등학교,교육부 부산광역시교육청 부산정보고등학교,62,62,0,62,61,0,0,1
교육기관,교육부,부산정보관광고등학교,교육부 부산광역시교육청 부산정보관광고등학교,40,40,0,40,34,6,0,0
교육기관,교육부,부산중앙고등학교,교육부 부산광역시교육청 부산중앙고등학교,45,45,0,45,45,0,0,0
교육기관,교육부,부산중앙여자고등학교,교육부 부산광역시교육청 부산중앙여자고등학교,16,16,0,16,16,0,0,0
교육기관,교육부,부산진고등학교,교육부 부산광역시교육청 부산진고등학교,54,54,0,54,29,25,0,0
교육기관,교육부,부산진여자고등학교,교육부 부산광역시교육청 부산진여자고등학교,47,47,0,47,25,22,0,0
교육기관,교육부,부산진여자상업고등학교,교육부 부산광역시교육청 부산진여자상업고등학교,21,21,0,21,16,5,0,0
교육기관,교육부,부산천사의학교,교육부 부산광역시교육청 부산천사의학교,8,4,4,4,0,4,0,0
교육기관,교육부,부산체육고등학교,교육부 부산광역시교육청 부산체육고등학교,144,144,0,144,144,0,0,0
교육기관,교육부,부산컴퓨터과학고등학교,교육부 부산광역시교육청 부산컴퓨터과학고등학교,71,71,0,71,71,0,0,0
교육기관,교육부,부산한솔학교,교육부 부산광역시교육청 부산한솔학교,62,62,0,62,62,0,0,0
교육기관,교육부,부산해마루학교,교육부 부산광역시교육청 부산해마루학교,64,64,0,64,0,64,0,0
교육기관,교육부,부산혜남학교,교육부 부산광역시교육청 부산혜남학교,14,14,0,14,11,3,0,0
교육기관,교육부,부산혜성학교,교육부 부산광역시교육청 부산혜성학교,27,27,0,27,0,27,0,0
교육기관,교육부,부산혜송학교,교육부 부산광역시교육청 부산혜송학교,16,16,0,16,14,2,0,0
교육기관,교육부,부산혜원학교,교육부 부산광역시교육청 부산혜원학교,14,14,0,14,0,14,0,0
교육기관,교육부,부일외국어고등학교,교육부 부산광역시교육청 부일외국어고등학교,21,21,0,21,0,21,0,0
교육기관,교육부,부일전자디자인고등학교,교육부 부산광역시교육청 부일전자디자인고등학교,35,35,0,35,29,6,0,0
교육기관,교육부,부흥고등학교,교육부 부산광역시교육청 부흥고등학교,37,37,0,37,37,0,0,0
교육기관,교육부,분포고등학교,교육부 부산광역시교육청 분포고등학교,38,38,0,38,0,38,0,0
교육기관,교육부,브니엘고등학교,교육부 부산광역시교육청 브니엘고등학교,27,27,0,27,0,27,0,0
교육기관,교육부,브니엘여자고등학교,교육부 부산광역시교육청 브니엘여자고등학교,21,21,0,21,0,21,0,0
교육기관,교육부,브니엘예술고등학교,교육부 부산광역시교육청 브니엘예술고등학교,41,41,0,41,0,41,0,0
교육기관,교육부,사상고등학교,교육부 부산광역시교육청 사상고등학교,51,51,0,51,15,36,0,0
교육기관,교육부,사직여자고등학교,교육부 부산광역시교육청 사직여자고등학교,37,37,0,37,30,7,0,0
교육기관,교육부,삼성여자고등학교,교육부 부산광역시교육청 삼성여자고등학교,19,19,0,19,0,19,0,0
교육기관,교육부,삼정고등학교,교육부 부산광역시교육청 삼정고등학교,34,34,0,34,0,34,0,0
교육기관,교육부,서부산공업고등학교,교육부 부산광역시교육청 서부산공업고등학교,64,62,2,62,47,12,3,0
교육기관,교육부,성도고등학교,교육부 부산광역시교육청 성도고등학교,90,90,0,90,0,90,0,0
교육기관,교육부,성모여자고등학교,교육부 부산광역시교육청 성모여자고등학교,21,17,4,17,0,17,0,0
교육기관,교육부,성일여자고등학교,교육부 부산광역시교육청 성일여자고등학교,42,41,1,41,41,0,0,0
교육기관,교육부,성지고등학교,교육부 부산광역시교육청 성지고등학교,22,22,0,22,6,16,0,0
교육기관,교육부,세연고등학교,교육부 부산광역시교육청 세연고등학교,73,72,1,72,24,48,0,0
교육기관,교육부,세정고등학교,교육부 부산광역시교육청 세정고등학교,30,30,0,30,15,12,2,1
교육기관,교육부,센텀고등학교,교육부 부산광역시교육청 센텀고등학교,54,54,0,54,0,54,0,0
교육기관,교육부,신도고등학교,교육부 부산광역시교육청 신도고등학교,62,62,0,62,19,40,1,2
교육기관,교육부,신정고등학교,교육부 부산광역시교육청 신정고등학교,32,32,0,32,0,32,0,0
교육기관,교육부,양운고등학교,교육부 부산광역시교육청 양운고등학교,45,45,0,45,3,42,0,0
교육기관,교육부,양정고등학교,교육부 부산광역시교육청 양정고등학교,55,55,0,55,0,55,0,0
교육기관,교육부,연제고등학교,교육부 부산광역시교육청 연제고등학교,75,75,0,75,56,19,0,0
교육기관,교육부,영도여자고등학교,교육부 부산광역시교육청 영도여자고등학교,49,49,0,49,49,0,0,0
교육기관,교육부,영산고등학교,교육부 부산광역시교육청 영산고등학교,68,68,0,68,68,0,0,0
교육기관,교육부,예문여자고등학교,교육부 부산광역시교육청 예문여자고등학교,48,48,0,48,44,4,0,0
교육기관,교육부,용인고등학교,교육부 부산광역시교육청 용인고등학교,107,107,0,107,50,57,0,0
교육기관,교육부,이사벨고등학교,교육부 부산광역시교육청 이사벨고등학교,81,76,5,76,0,76,0,0
교육기관,교육부,장안제일고등학교,교육부 부산광역시교육청 장안제일고등학교,30,12,18,12,0,12,0,0
교육기관,교육부,정관고등학교,교육부 부산광역시교육청 정관고등학교,67,67,0,67,22,45,0,0
교육기관,교육부,주례여자고등학교,교육부 부산광역시교육청 주례여자고등학교,34,32,2,32,0,32,0,0
교육기관,교육부,지산고등학교,교육부 부산광역시교육청 지산고등학교,22,22,0,22,22,0,0,0
교육기관,교육부,충렬고등학교,교육부 부산광역시교육청 충렬고등학교,32,32,0,32,0,32,0,0
교육기관,교육부,학력인정국제금융고등학교,교육부 부산광역시교육청 학력인정국제금융고등학교,6,5,1,5,0,5,0,0
교육기관,교육부,학력인정부경보건고등학교,교육부 부산광역시교육청 학력인정부경보건고등학교,23,23,0,23,23,0,0,0
교육기관,교육부,학력인정부산경호고등학교,교육부 부산광역시교육청 학력인정부산경호고등학교,22,22,0,22,9,13,0,0
교육기관,교육부,학력인정부산미용고등학교,교육부 부산광역시교육청 학력인정부산미용고등학교,24,24,0,24,20,2,2,0
교육기관,교육부,학력인정부산예원고등학교,교육부 부산광역시교육청 학력인정부산예원고등학교,33,33,0,33,28,5,0,0
교육기관,교육부,학력인정부산조리고등학교,교육부 부산광역시교육청 학력인정부산조리고등학교,16,16,0,16,14,1,0,1
교육기관,교육부,학산여자고등학교,교육부 부산광역시교육청 학산여자고등학교,41,39,2,39,4,26,9,0
교육기관,교육부,한국조형예술고등학교,교육부 부산광역시교육청 한국조형예술고등학교,55,55,0,55,32,17,6,0
교육기관,교육부,한얼고등학교,교육부 부산광역시교육청 한얼고등학교,128,128,0,128,32,96,0,0
교육기관,교육부,해강고등학교,교육부 부산광역시교육청 해강고등학교,78,78,0,78,78,0,0,0
교육기관,교육부,해동고등학교,교육부 부산광역시교육청 해동고등학교,17,17,0,17,0,17,0,0
교육기관,교육부,해운대고등학교,교육부 부산광역시교육청 해운대고등학교,52,52,0,52,0,52,0,0
교육기관,교육부,해운대공업고등학교,교육부 부산광역시교육청 해운대공업고등학교,34,31,3,31,15,16,0,0
교육기관,교육부,해운대관광고등학교,교육부 부산광역시교육청 해운대관광고등학교,23,23,0,23,12,9,2,0
교육기관,교육부,해운대여자고등학교,교육부 부산광역시교육청 해운대여자고등학교,40,40,0,40,40,0,0,0
교육기관,교육부,혜광고등학교,교육부 부산광역시교육청 혜광고등학교,32,32,0,32,10,20,1,1
교육기관,교육부,혜화여자고등학교,교육부 부산광역시교육청 혜화여자고등학교,16,16,0,16,4,12,0,0
교육기관,교육부,화명고등학교,교육부 부산광역시교육청 화명고등학교,37,37,0,37,0,37,0,0
교육기관,교육부,대구광역시교육청,교육부 대구광역시교육청,169,105,64,105,25,80,0,0
교육기관,교육부,강동고등학교,교육부 대구광역시교육청 강동고등학교,50,28,22,28,28,0,0,0
교육기관,교육부,강북고등학교,교육부 대구광역시교육청 강북고등학교,45,42,3,42,0,42,0,0
교육기관,교육부,경덕여자고등학교,교육부 대구광역시교육청 경덕여자고등학교,15,15,0,15,15,0,0,0
교육기관,교육부,경명여자고등학교,교육부 대구광역시교육청 경명여자고등학교,16,16,0,16,0,16,0,0
교육기관,교육부,경북고등학교,교육부 대구광역시교육청 경북고등학교,28,27,1,27,17,10,0,0
교육기관,교육부,경북공업고등학교,교육부 대구광역시교육청 경북공업고등학교,27,27,0,27,20,7,0,0
교육기관,교육부,경북기계공업고등학교,교육부 대구광역시교육청 경북기계공업고등학교,62,62,0,62,10,52,0,0
교육기관,교육부,경북기계공업고등학교부설대구문화예술산업학교,교육부 대구광역시교육청 경북기계공업고등학교부설대구문화예술산업학교,8,8,0,8,1,7,0,0
교육기관,교육부,경북여자고등학교,교육부 대구광역시교육청 경북여자고등학교,50,27,23,27,27,0,0,0
교육기관,교육부,경북여자상업고등학교,교육부 대구광역시교육청 경북여자상업고등학교,32,32,0,32,32,0,0,0
교육기관,교육부,경북예술고등학교,교육부 대구광역시교육청 경북예술고등학교,46,45,1,45,0,45,0,0
교육기관,교육부,경상고등학교,교육부 대구광역시교육청 경상고등학교,33,21,12,21,21,0,0,0
교육기관,교육부,경상공업고등학교,교육부 대구광역시교육청 경상공업고등학교,25,25,0,25,0,25,0,0
교육기관,교육부,경상여자고등학교,교육부 대구광역시교육청 경상여자고등학교,34,34,0,34,25,9,0,0
교육기관,교육부,경신고등학교,교육부 대구광역시교육청 경신고등학교,50,50,0,50,25,25,0,0
교육기관,교육부,경원고등학교,교육부 대구광역시교육청 경원고등학교,33,32,1,32,0,32,0,0
교육기관,교육부,경일여자고등학교,교육부 대구광역시교육청 경일여자고등학교,50,50,0,50,45,5,0,0
교육기관,교육부,경화여자고등학교,교육부 대구광역시교육청 경화여자고등학교,15,15,0,15,10,5,0,0
교육기관,교육부,계성고등학교,교육부 대구광역시교육청 계성고등학교,104,104,0,104,0,104,0,0
교육기관,교육부,구암고등학교,교육부 대구광역시교육청 구암고등학교,57,57,0,57,33,24,0,0
교육기관,교육부,능인고등학교,교육부 대구광역시교육청 능인고등학교,55,55,0,55,12,43,0,0
교육기관,교육부,다사고등학교,교육부 대구광역시교육청 다사고등학교,75,75,0,75,21,54,0,0
교육기관,교육부,달구벌고등학교,교육부 대구광역시교육청 달구벌고등학교,48,48,0,48,0,48,0,0
교육기관,교육부,달서고등학교,교육부 대구광역시교육청 달서고등학교,33,26,7,26,11,15,0,0
교육기관,교육부,달성고등학교,교육부 대구광역시교육청 달성고등학교,62,62,0,62,52,10,0,0
교육기관,교육부,대건고등학교,교육부 대구광역시교육청 대건고등학교,70,70,0,70,19,51,0,0
교육기관,교육부,대곡고등학교,교육부 대구광역시교육청 대곡고등학교,24,24,0,24,24,0,0,0
교육기관,교육부,대구2.28기념학생도서관,교육부 대구광역시교육청 대구2.28기념학생도서관,41,41,0,41,0,41,0,0
교육기관,교육부,대구고등학교,교육부 대구광역시교육청 대구고등학교,65,65,0,65,9,56,0,0
교육기관,교육부,대구공업고등학교,교육부 대구광역시교육청 대구공업고등학교,42,42,0,42,42,0,0,0
교육기관,교육부,대구공업고등학교테크노폴리스캠퍼스,교육부 대구광역시교육청 대구공업고등학교테크노폴리스캠퍼스,15,15,0,15,0,15,0,0
교육기관,교육부,대구과학고등학교,교육부 대구광역시교육청 대구과학고등학교,99,99,0,99,0,99,0,0
교육기관,교육부,대구과학기술고등학교,교육부 대구광역시교육청 대구과학기술고등학교,68,67,1,67,25,42,0,0
교육기관,교육부,대구관광고등학교,교육부 대구광역시교육청 대구관광고등학교,51,51,0,51,0,51,0,0
교육기관,교육부,대구광명학교,교육부 대구광역시교육청 대구광명학교,28,28,0,28,20,8,0,0
교육기관,교육부,대구광역시교육연수원,교육부 대구광역시교육청 대구광역시교육연수원,44,44,0,44,22,22,0,0
교육기관,교육부,대구광역시남부교육지원청,교육부 대구광역시교육청 대구광역시남부교육지원청,10,10,0,10,0,10,0,0
교육기관,교육부,경상중학교,교육부 대구광역시교육청 대구광역시남부교육지원청 경상중학교,43,42,1,42,2,40,0,0
교육기관,교육부,경암중학교,교육부 대구광역시교육청 대구광역시남부교육지원청 경암중학교,20,20,0,20,9,11,0,0
교육기관,교육부,경일여자중학교,교육부 대구광역시교육청 대구광역시남부교육지원청 경일여자중학교,37,36,1,36,17,19,0,0
교육기관,교육부,경혜여자중학교,교육부 대구광역시교육청 대구광역시남부교육지원청 경혜여자중학교,16,16,0,16,15,1,0,0
교육기관,교육부,구남중학교,교육부 대구광역시교육청 대구광역시남부교육지원청 구남중학교,25,25,0,25,21,4,0,0
교육기관,교육부,남대구초등학교,교육부 대구광역시교육청 대구광역시남부교육지원청 남대구초등학교,21,21,0,21,21,0,0,0
교육기관,교육부,대건중학교,교육부 대구광역시교육청 대구광역시남부교육지원청 대건중학교,72,72,0,72,32,40,0,0
교육기관,교육부,대곡중학교,교육부 대구광역시교육청 대구광역시남부교육지원청 대곡중학교,24,24,0,24,20,4,0,0
교육기관,교육부,대구감삼초등학교,교육부 대구광역시교육청 대구광역시남부교육지원청 대구감삼초등학교,27,27,0,27,27,0,0,0
교육기관,교육부,대구감천초등학교,교육부 대구광역시교육청 대구광역시남부교육지원청 대구감천초등학교,16,16,0,16,16,0,0,0
교육기관,교육부,대구경상유치원,교육부 대구광역시교육청 대구광역시남부교육지원청 대구경상유치원,30,30,0,30,28,2,0,0
교육기관,교육부,대구남덕초등학교,교육부 대구광역시교육청 대구광역시남부교육지원청 대구남덕초등학교,31,31,0,31,15,16,0,0
교육기관,교육부,대구남도초등학교,교육부 대구광역시교육청 대구광역시남부교육지원청 대구남도초등학교,34,34,0,34,34,0,0,0
교육기관,교육부,대구남명초등학교,교육부 대구광역시교육청 대구광역시남부교육지원청 대구남명초등학교,25,25,0,25,25,0,0,0
교육기관,교육부,대구남부초등학교,교육부 대구광역시교육청 대구광역시남부교육지원청 대구남부초등학교,23,23,0,23,23,0,0,0
교육기관,교육부,대구남송초등학교,교육부 대구광역시교육청 대구광역시남부교육지원청 대구남송초등학교,15,15,0,15,0,15,0,0
교육기관,교육부,대구내당초등학교,교육부 대구광역시교육청 대구광역시남부교육지원청 대구내당초등학교,30,30,0,30,15,15,0,0
교육기관,교육부,대구노전초등학교,교육부 대구광역시교육청 대구광역시남부교육지원청 대구노전초등학교,18,18,0,18,18,0,0,0
교육기관,교육부,대구대곡초등학교,교육부 대구광역시교육청 대구광역시남부교육지원청 대구대곡초등학교,32,32,0,32,21,11,0,0
교육기관,교육부,대구대남초등학교,교육부 대구광역시교육청 대구광역시남부교육지원청 대구대남초등학교,21,21,0,21,21,0,0,0
교육기관,교육부,대구대덕초등학교,교육부 대구광역시교육청 대구광역시남부교육지원청 대구대덕초등학교,43,43,0,43,28,15,0,0
교육기관,교육부,대구대명초등학교,교육부 대구광역시교육청 대구광역시남부교육지원청 대구대명초등학교,22,22,0,22,16,6,0,0
교육기관,교육부,대구대봉초등학교,교육부 대구광역시교육청 대구광역시남부교육지원청 대구대봉초등학교,24,24,0,24,12,12,0,0
교육기관,교육부,대구대서초등학교,교육부 대구광역시교육청 대구광역시남부교육지원청 대구대서초등학교,23,23,0,23,23,0,0,0
교육기관,교육부,대구대진초등학교,교육부 대구광역시교육청 대구광역시남부교육지원청 대구대진초등학교,16,16,0,16,16,0,0,0
교육기관,교육부,대구덕인초등학교,교육부 대구광역시교육청 대구광역시남부교육지원청 대구덕인초등학교,19,19,0,19,19,0,0,0
교육기관,교육부,대구도원초등학교,교육부 대구광역시교육청 대구광역시남부교육지원청 대구도원초등학교,21,20,1,20,14,6,0,0
교육기관,교육부,대구본리초등학교,교육부 대구광역시교육청 대구광역시남부교육지원청 대구본리초등학교,24,24,0,24,18,6,0,0
교육기관,교육부,대구봉덕초등학교,교육부 대구광역시교육청 대구광역시남부교육지원청 대구봉덕초등학교,23,23,0,23,23,0,0,0
교육기관,교육부,대구상원유치원,교육부 대구광역시교육청 대구광역시남부교육지원청 대구상원유치원,33,6,27,6,6,0,0,0
교육기관,교육부,대구상원초등학교,교육부 대구광역시교육청 대구광역시남부교육지원청 대구상원초등학교,24,24,0,24,24,0,0,0
교육기관,교육부,대구상인초등학교,교육부 대구광역시교육청 대구광역시남부교육지원청 대구상인초등학교,34,34,0,34,17,17,0,0
교육기관,교육부,대구선원초등학교,교육부 대구광역시교육청 대구광역시남부교육지원청 대구선원초등학교,22,22,0,22,0,22,0,0
교육기관,교육부,대구성곡초등학교,교육부 대구광역시교육청 대구광역시남부교육지원청 대구성곡초등학교,18,18,0,18,18,0,0,0
교육기관,교육부,대구성남초등학교,교육부 대구광역시교육청 대구광역시남부교육지원청 대구성남초등학교,27,27,0,27,27,0,0,0
교육기관,교육부,대구성당초등학교,교육부 대구광역시교육청 대구광역시남부교육지원청 대구성당초등학교,37,37,0,37,0,37,0,0
교육기관,교육부,대구성명초등학교,교육부 대구광역시교육청 대구광역시남부교육지원청 대구성명초등학교,21,21,0,21,21,0,0,0
교육기관,교육부,대구성산초등학교,교육부 대구광역시교육청 대구광역시남부교육지원청 대구성산초등학교,18,18,0,18,18,0,0,0
교육기관,교육부,대구성서초등학교,교육부 대구광역시교육청 대구광역시남부교육지원청 대구성서초등학교,21,21,0,21,21,0,0,0
교육기관,교육부,대구성지초등학교,교육부 대구광역시교육청 대구광역시남부교육지원청 대구성지초등학교,28,28,0,28,28,0,0,0
교육기관,교육부,대구송일초등학교,교육부 대구광역시교육청 대구광역시남부교육지원청 대구송일초등학교,23,23,0,23,0,23,0,0
교육기관,교육부,대구송현초등학교,교육부 대구광역시교육청 대구광역시남부교육지원청 대구송현초등학교,20,15,5,15,15,0,0,0
교육기관,교육부,대구신당초등학교,교육부 대구광역시교육청 대구광역시남부교육지원청 대구신당초등학교,16,16,0,16,16,0,0,0
교육기관,교육부,대구신서초등학교,교육부 대구광역시교육청 대구광역시남부교육지원청 대구신서초등학교,15,15,0,15,15,0,0,0
교육기관,교육부,대구신월초등학교,교육부 대구광역시교육청 대구광역시남부교육지원청 대구신월초등학교,26,26,0,26,26,0,0,0
교육기관,교육부,대구신흥초등학교,교육부 대구광역시교육청 대구광역시남부교육지원청 대구신흥초등학교,26,26,0,26,26,0,0,0
교육기관,교육부,대구영선초등학교,교육부 대구광역시교육청 대구광역시남부교육지원청 대구영선초등학교,21,21,0,21,0,21,0,0
교육기관,교육부,대구와룡초등학교,교육부 대구광역시교육청 대구광역시남부교육지원청 대구와룡초등학교,30,30,0,30,30,0,0,0
교육기관,교육부,대구용산초등학교,교육부 대구광역시교육청 대구광역시남부교육지원청 대구용산초등학교,24,24,0,24,19,5,0,0
교육기관,교육부,대구용전초등학교,교육부 대구광역시교육청 대구광역시남부교육지원청 대구용전초등학교,16,16,0,16,8,8,0,0
교육기관,교육부,대구용천초등학교,교육부 대구광역시교육청 대구광역시남부교육지원청 대구용천초등학교,30,30,0,30,30,0,0,0
교육기관,교육부,대구월곡초등학교,교육부 대구광역시교육청 대구광역시남부교육지원청 대구월곡초등학교,30,30,0,30,30,0,0,0
교육기관,교육부,대구월배유치원,교육부 대구광역시교육청 대구광역시남부교육지원청 대구월배유치원,40,2,38,2,0,2,0,0
교육기관,교육부,대구월배초등학교,교육부 대구광역시교육청 대구광역시남부교육지원청 대구월배초등학교,21,21,0,21,8,13,0,0
교육기관,교육부,대구월서초등학교,교육부 대구광역시교육청 대구광역시남부교육지원청 대구월서초등학교,31,31,0,31,31,0,0,0
교육기관,교육부,대구월성초등학교,교육부 대구광역시교육청 대구광역시남부교육지원청 대구월성초등학교,27,27,0,27,27,0,0,0
교육기관,교육부,대구월암초등학교,교육부 대구광역시교육청 대구광역시남부교육지원청 대구월암초등학교,23,23,0,23,6,17,0,0
교육기관,교육부,대구월촌초등학교,교육부 대구광역시교육청 대구광역시남부교육지원청 대구월촌초등학교,22,22,0,22,22,0,0,0
교육기관,교육부,대구유천초등학교,교육부 대구광역시교육청 대구광역시남부교육지원청 대구유천초등학교,19,19,0,19,0,19,0,0
교육기관,교육부,대구이곡초등학교,교육부 대구광역시교육청 대구광역시남부교육지원청 대구이곡초등학교,20,20,0,20,20,0,0,0
교육기관,교육부,대구장기초등학교,교육부 대구광역시교육청 대구광역시남부교육지원청 대구장기초등학교,21,21,0,21,21,0,0,0
교육기관,교육부,대구장동초등학교,교육부 대구광역시교육청 대구광역시남부교육지원청 대구장동초등학교,16,16,0,16,16,0,0,0
교육기관,교육부,대구장산초등학교,교육부 대구광역시교육청 대구광역시남부교육지원청 대구장산초등학교,29,29,0,29,0,29,0,0
교육기관,교육부,대구장성초등학교,교육부 대구광역시교육청 대구광역시남부교육지원청 대구장성초등학교,16,16,0,16,0,16,0,0
교육기관,교육부,대구조암초등학교,교육부 대구광역시교육청 대구광역시남부교육지원청 대구조암초등학교,20,20,0,20,20,0,0,0
교육기관,교육부,대구죽전초등학교,교육부 대구광역시교육청 대구광역시남부교육지원청 대구죽전초등학교,20,20,0,20,20,0,0,0
교육기관,교육부,대구중학교,교육부 대구광역시교육청 대구광역시남부교육지원청 대구중학교,13,13,0,13,13,0,0,0
교육기관,교육부,대구진월초등학교,교육부 대구광역시교육청 대구광역시남부교육지원청 대구진월초등학교,28,28,0,28,26,2,0,0
교육기관,교육부,대구진천초등학교,교육부 대구광역시교육청 대구광역시남부교육지원청 대구진천초등학교,18,18,0,18,18,0,0,0
교육기관,교육부,대구파호초등학교,교육부 대구광역시교육청 대구광역시남부교육지원청 대구파호초등학교,30,26,4,26,26,0,0,0
교육기관,교육부,대구학산초등학교,교육부 대구광역시교육청 대구광역시남부교육지원청 대구학산초등학교,26,26,0,26,26,0,0,0
교육기관,교육부,대구한샘초등학교,교육부 대구광역시교육청 대구광역시남부교육지원청 대구한샘초등학교,34,34,0,34,24,10,0,0
교육기관,교육부,대구한솔초등학교,교육부 대구광역시교육청 대구광역시남부교육지원청 대구한솔초등학교,27,27,0,27,10,17,0,0
교육기관,교육부,대구한실초등학교,교육부 대구광역시교육청 대구광역시남부교육지원청 대구한실초등학교,48,48,0,48,0,48,0,0
교육기관,교육부,대구호산초등학교,교육부 대구광역시교육청 대구광역시남부교육지원청 대구호산초등학교,22,22,0,22,22,0,0,0
교육기관,교육부,대구효명초등학교,교육부 대구광역시교육청 대구광역시남부교육지원청 대구효명초등학교,21,21,0,21,5,16,0,0
교육기관,교육부,대명중학교,교육부 대구광역시교육청 대구광역시남부교육지원청 대명중학교,17,17,0,17,9,8,0,0
교육기관,교육부,대서중학교,교육부 대구광역시교육청 대구광역시남부교육지원청 대서중학교,34,34,0,34,0,34,0,0
교육기관,교육부,대진중학교,교육부 대구광역시교육청 대구광역시남부교육지원청 대진중학교,47,46,1,46,40,6,0,0
교육기관,교육부,도원중학교,교육부 대구광역시교육청 대구광역시남부교육지원청 도원중학교,29,29,0,29,28,1,0,0
교육기관,교육부,상서중학교,교육부 대구광역시교육청 대구광역시남부교육지원청 상서중학교,15,15,0,15,15,0,0,0
교육기관,교육부,상원중학교,교육부 대구광역시교육청 대구광역시남부교육지원청 상원중학교,56,55,1,55,55,0,0,0
교육기관,교육부,상인중학교,교육부 대구광역시교육청 대구광역시남부교육지원청 상인중학교,48,48,0,48,48,0,0,0
교육기관,교육부,새본리중학교,교육부 대구광역시교육청 대구광역시남부교육지원청 새본리중학교,53,53,0,53,33,20,0,0
교육기관,교육부,성곡중학교,교육부 대구광역시교육청 대구광역시남부교육지원청 성곡중학교,15,15,0,15,15,0,0,0
교육기관,교육부,성당중학교,교육부 대구광역시교육청 대구광역시남부교육지원청 성당중학교,21,21,0,21,14,7,0,0
교육기관,교육부,성산중학교,교육부 대구광역시교육청 대구광역시남부교육지원청 성산중학교,14,14,0,14,3,11,0,0
교육기관,교육부,성서중학교,교육부 대구광역시교육청 대구광역시남부교육지원청 성서중학교,34,34,0,34,0,34,0,0
교육기관,교육부,성지중학교,교육부 대구광역시교육청 대구광역시남부교육지원청 성지중학교,35,35,0,35,35,0,0,0
교육기관,교육부,송현여자중학교,교육부 대구광역시교육청 대구광역시남부교육지원청 송현여자중학교,12,12,0,12,9,3,0,0
교육기관,교육부,신당중학교,교육부 대구광역시교육청 대구광역시남부교육지원청 신당중학교,33,33,0,33,33,0,0,0
교육기관,교육부,영남중학교,교육부 대구광역시교육청 대구광역시남부교육지원청 영남중학교,50,48,2,48,10,38,0,0
교육기관,교육부,와룡중학교,교육부 대구광역시교육청 대구광역시남부교육지원청 와룡중학교,22,13,9,13,8,5,0,0
교육기관,교육부,용산중학교,교육부 대구광역시교육청 대구광역시남부교육지원청 용산중학교,40,13,27,13,0,13,0,0
교육기관,교육부,원화중학교,교육부 대구광역시교육청 대구광역시남부교육지원청 원화중학교,16,16,0,16,16,0,0,0
교육기관,교육부,월배중학교,교육부 대구광역시교육청 대구광역시남부교육지원청 월배중학교,31,31,0,31,0,31,0,0
교육기관,교육부,월서중학교,교육부 대구광역시교육청 대구광역시남부교육지원청 월서중학교,36,35,1,35,12,23,0,0
교육기관,교육부,월암중학교,교육부 대구광역시교육청 대구광역시남부교육지원청 월암중학교,48,48,0,48,28,20,0,0
교육기관,교육부,이곡중학교,교육부 대구광역시교육청 대구광역시남부교육지원청 이곡중학교,30,30,0,30,22,8,0,0
교육기관,교육부,조암중학교,교육부 대구광역시교육청 대구광역시남부교육지원청 조암중학교,34,34,0,34,0,34,0,0
교육기관,교육부,학산중학교,교육부 대구광역시교육청 대구광역시남부교육지원청 학산중학교,48,46,2,46,0,46,0,0
교육기관,교육부,협성경복중학교,교육부 대구광역시교육청 대구광역시남부교육지원청 협성경복중학교,47,46,1,46,0,46,0,0
교육기관,교육부,효성중학교,교육부 대구광역시교육청 대구광역시남부교육지원청 효성중학교,65,65,0,65,25,40,0,0
교육기관,교육부,효성초등학교,교육부 대구광역시교육청 대구광역시남부교육지원청 효성초등학교,65,65,0,65,65,0,0,0
교육기관,교육부,대구광역시달성교육지원청,교육부 대구광역시교육청 대구광역시달성교육지원청,36,36,0,36,0,36,0,0
교육기관,교육부,가창중학교,교육부 대구광역시교육청 대구광역시달성교육지원청 가창중학교,27,27,0,27,0,27,0,0
교육기관,교육부,경서중학교,교육부 대구광역시교육청 대구광역시달성교육지원청 경서중학교,50,49,1,49,49,0,0,0
교육기관,교육부,구지세현유치원,교육부 대구광역시교육청 대구광역시달성교육지원청 구지세현유치원,72,16,56,16,0,16,0,0
교육기관,교육부,구지중학교,교육부 대구광역시교육청 대구광역시달성교육지원청 구지중학교,38,38,0,38,38,0,0,0
교육기관,교육부,논공중학교,교육부 대구광역시교육청 대구광역시달성교육지원청 논공중학교,23,23,0,23,0,23,0,0
교육기관,교육부,다사중학교,교육부 대구광역시교육청 대구광역시달성교육지원청 다사중학교,52,50,2,50,12,38,0,0
교육기관,교육부,달서중학교,교육부 대구광역시교육청 대구광역시달성교육지원청 달서중학교,9,9,0,9,2,7,0,0
교육기관,교육부,달성중학교,교육부 대구광역시교육청 대구광역시달성교육지원청 달성중학교,61,61,0,61,32,29,0,0
교육기관,교육부,대구가창초등학교,교육부 대구광역시교육청 대구광역시달성교육지원청 대구가창초등학교,18,17,1,17,0,17,0,0
교육기관,교육부,대구강림초등학교,교육부 대구광역시교육청 대구광역시달성교육지원청 대구강림초등학교,25,25,0,25,16,9,0,0
교육기관,교육부,대구구지초등학교,교육부 대구광역시교육청 대구광역시달성교육지원청 대구구지초등학교,28,28,0,28,28,0,0,0
교육기관,교육부,대구금계초등학교,교육부 대구광역시교육청 대구광역시달성교육지원청 대구금계초등학교,22,22,0,22,22,0,0,0
교육기관,교육부,대구금포초등학교,교육부 대구광역시교육청 대구광역시달성교육지원청 대구금포초등학교,17,17,0,17,15,2,0,0
교육기관,교육부,대구남동초등학교,교육부 대구광역시교육청 대구광역시달성교육지원청 대구남동초등학교,16,16,0,16,15,1,0,0
교육기관,교육부,대구논공초등학교,교육부 대구광역시교육청 대구광역시달성교육지원청 대구논공초등학교,14,14,0,14,14,0,0,0
교육기관,교육부,대구다사초등학교,교육부 대구광역시교육청 대구광역시달성교육지원청 대구다사초등학교,19,19,0,19,17,2,0,0
교육기관,교육부,대구대실유치원,교육부 대구광역시교육청 대구광역시달성교육지원청 대구대실유치원,32,5,27,5,0,5,0,0
교육기관,교육부,대구대실초등학교,교육부 대구광역시교육청 대구광역시달성교육지원청 대구대실초등학교,33,33,0,33,19,14,0,0
교육기관,교육부,대구도림초등학교,교육부 대구광역시교육청 대구광역시달성교육지원청 대구도림초등학교,24,24,0,24,24,0,0,0
교육기관,교육부,대구동곡초등학교,교육부 대구광역시교육청 대구광역시달성교육지원청 대구동곡초등학교,19,19,0,19,19,0,0,0
교육기관,교육부,대구매곡초등학교,교육부 대구광역시교육청 대구광역시달성교육지원청 대구매곡초등학교,24,24,0,24,22,2,0,0
교육기관,교육부,대구명곡초등학교,교육부 대구광역시교육청 대구광역시달성교육지원청 대구명곡초등학교,18,18,0,18,0,18,0,0
교육기관,교육부,대구반송초등학교,교육부 대구광역시교육청 대구광역시달성교육지원청 대구반송초등학교,17,17,0,17,17,0,0,0
교육기관,교육부,대구북동초등학교,교육부 대구광역시교육청 대구광역시달성교육지원청 대구북동초등학교,31,31,0,31,0,31,0,0
교육기관,교육부,대구비슬유치원,교육부 대구광역시교육청 대구광역시달성교육지원청 대구비슬유치원,40,6,34,6,0,6,0,0
교육기관,교육부,대구비슬초등학교,교육부 대구광역시교육청 대구광역시달성교육지원청 대구비슬초등학교,35,35,0,35,31,4,0,0
교육기관,교육부,대구서동유치원,교육부 대구광역시교육청 대구광역시달성교육지원청 대구서동유치원,24,1,23,1,0,1,0,0
교육기관,교육부,대구서동초등학교,교육부 대구광역시교육청 대구광역시달성교육지원청 대구서동초등학교,36,36,0,36,36,0,0,0
교육기관,교육부,대구서재초등학교,교육부 대구광역시교육청 대구광역시달성교육지원청 대구서재초등학교,20,20,0,20,0,20,0,0
교육기관,교육부,대구세천유치원,교육부 대구광역시교육청 대구광역시달성교육지원청 대구세천유치원,33,8,25,8,0,8,0,0
교육기관,교육부,대구세천초등학교,교육부 대구광역시교육청 대구광역시달성교육지원청 대구세천초등학교,34,34,0,34,31,3,0,0
교육기관,교육부,대구세현초등학교,교육부 대구광역시교육청 대구광역시달성교육지원청 대구세현초등학교,29,29,0,29,29,0,0,0
교육기관,교육부,대구옥빛유치원,교육부 대구광역시교육청 대구광역시달성교육지원청 대구옥빛유치원,31,2,29,2,0,2,0,0
교육기관,교육부,대구옥포초등학교,교육부 대구광역시교육청 대구광역시달성교육지원청 대구옥포초등학교,16,16,0,16,16,0,0,0
교육기관,교육부,대구왕선초등학교,교육부 대구광역시교육청 대구광역시달성교육지원청 대구왕선초등학교,19,19,0,19,19,0,0,0
교육기관,교육부,대구용계초등학교,교육부 대구광역시교육청 대구광역시달성교육지원청 대구용계초등학교,20,20,0,20,0,20,0,0
교육기관,교육부,대구유가유치원,교육부 대구광역시교육청 대구광역시달성교육지원청 대구유가유치원,24,2,22,2,0,2,0,0
교육기관,교육부,대구유가초등학교,교육부 대구광역시교육청 대구광역시달성교육지원청 대구유가초등학교,48,48,0,48,48,0,0,0
교육기관,교육부,대구죽곡초등학교,교육부 대구광역시교육청 대구광역시달성교육지원청 대구죽곡초등학교,18,18,0,18,18,0,0,0
교육기관,교육부,대구천내초등학교,교육부 대구광역시교육청 대구광역시달성교육지원청 대구천내초등학교,27,27,0,27,27,0,0,0
교육기관,교육부,대구포산유치원,교육부 대구광역시교육청 대구광역시달성교육지원청 대구포산유치원,31,13,18,13,13,0,0,0
교육기관,교육부,대구포산초등학교,교육부 대구광역시교육청 대구광역시달성교육지원청 대구포산초등학교,28,28,0,28,28,0,0,0
교육기관,교육부,대구하빈초등학교,교육부 대구광역시교육청 대구광역시달성교육지원청 대구하빈초등학교,19,19,0,19,19,0,0,0
교육기관,교육부,대구현풍초등학교,교육부 대구광역시교육청 대구광역시달성교육지원청 대구현풍초등학교,17,17,0,17,17,0,0,0
교육기관,교육부,대구화남초등학교,교육부 대구광역시교육청 대구광역시달성교육지원청 대구화남초등학교,24,24,0,24,12,12,0,0
교육기관,교육부,대구화동초등학교,교육부 대구광역시교육청 대구광역시달성교육지원청 대구화동초등학교,15,15,0,15,10,5,0,0
교육기관,교육부,대구화원초등학교,교육부 대구광역시교육청 대구광역시달성교육지원청 대구화원초등학교,26,26,0,26,0,26,0,0
교육기관,교육부,북동중학교,교육부 대구광역시교육청 대구광역시달성교육지원청 북동중학교,35,35,0,35,17,18,0,0
교육기관,교육부,서동중학교,교육부 대구광역시교육청 대구광역시달성교육지원청 서동중학교,41,41,0,41,41,0,0,0
교육기관,교육부,서재중학교,교육부 대구광역시교육청 대구광역시달성교육지원청 서재중학교,16,14,2,14,0,14,0,0
교육기관,교육부,심인중학교,교육부 대구광역시교육청 대구광역시달성교육지원청 심인중학교,48,48,0,48,14,34,0,0
교육기관,교육부,왕선중학교,교육부 대구광역시교육청 대구광역시달성교육지원청 왕선중학교,42,42,0,42,0,42,0,0
교육기관,교육부,유가중학교,교육부 대구광역시교육청 대구광역시달성교육지원청 유가중학교,45,44,1,44,5,39,0,0
교육기관,교육부,천내중학교,교육부 대구광역시교육청 대구광역시달성교육지원청 천내중학교,25,25,0,25,20,5,0,0
교육기관,교육부,포산중학교,교육부 대구광역시교육청 대구광역시달성교육지원청 포산중학교,37,37,0,37,37,0,0,0
교육기관,교육부,한울안중학교,교육부 대구광역시교육청 대구광역시달성교육지원청 한울안중학교,43,42,1,42,20,22,0,0
교육기관,교육부,현풍중학교,교육부 대구광역시교육청 대구광역시달성교육지원청 현풍중학교,28,28,0,28,28,0,0,0
교육기관,교육부,화원꽃뜰유치원,교육부 대구광역시교육청 대구광역시달성교육지원청 화원꽃뜰유치원,16,16,0,16,0,16,0,0
교육기관,교육부,화원중학교,교육부 대구광역시교육청 대구광역시달성교육지원청 화원중학교,26,25,1,25,18,7,0,0
교육기관,교육부,대구광역시동부교육지원청,교육부 대구광역시교육청 대구광역시동부교육지원청,17,17,0,17,0,17,0,0
교육기관,교육부,강동중학교,교육부 대구광역시교육청 대구광역시동부교육지원청 강동중학교,36,36,0,36,34,2,0,0
교육기관,교육부,경구중학교,교육부 대구광역시교육청 대구광역시동부교육지원청 경구중학교,8,8,0,8,4,4,0,0
교육기관,교육부,경신중학교,교육부 대구광역시교육청 대구광역시동부교육지원청 경신중학교,40,40,0,40,8,32,0,0
교육기관,교육부,계성중학교,교육부 대구광역시교육청 대구광역시동부교육지원청 계성중학교,20,20,0,20,0,20,0,0
교육기관,교육부,계성초등학교,교육부 대구광역시교육청 대구광역시동부교육지원청 계성초등학교,14,14,0,14,2,12,0,0
교육기관,교육부,고산중학교,교육부 대구광역시교육청 대구광역시동부교육지원청 고산중학교,39,39,0,39,39,0,0,0
교육기관,교육부,공산중학교,교육부 대구광역시교육청 대구광역시동부교육지원청 공산중학교,24,23,1,23,23,0,0,0
교육기관,교육부,노변중학교,교육부 대구광역시교육청 대구광역시동부교육지원청 노변중학교,55,55,0,55,52,3,0,0
교육기관,교육부,능인중학교,교육부 대구광역시교육청 대구광역시동부교육지원청 능인중학교,20,18,2,18,8,10,0,0
교육기관,교육부,대구강동초등학교,교육부 대구광역시교육청 대구광역시동부교육지원청 대구강동초등학교,20,20,0,20,20,0,0,0
교육기관,교육부,대구경동초등학교,교육부 대구광역시교육청 대구광역시동부교육지원청 대구경동초등학교,32,32,0,32,32,0,0,0
교육기관,교육부,대구고산초등학교,교육부 대구광역시교육청 대구광역시동부교육지원청 대구고산초등학교,27,27,0,27,25,2,0,0
교육기관,교육부,대구공산초등학교,교육부 대구광역시교육청 대구광역시동부교육지원청 대구공산초등학교,11,11,0,11,11,0,0,0
교육기관,교육부,대구남산초등학교,교육부 대구광역시교육청 대구광역시동부교육지원청 대구남산초등학교,28,28,0,28,28,0,0,0
교육기관,교육부,대구노변초등학교,교육부 대구광역시교육청 대구광역시동부교육지원청 대구노변초등학교,14,14,0,14,14,0,0,0
교육기관,교육부,대구대청초등학교,교육부 대구광역시교육청 대구광역시동부교육지원청 대구대청초등학교,31,31,0,31,31,0,0,0
교육기관,교육부,대구덕성초등학교,교육부 대구광역시교육청 대구광역시동부교육지원청 대구덕성초등학교,21,21,0,21,21,0,0,0
교육기관,교육부,대구동덕초등학교,교육부 대구광역시교육청 대구광역시동부교육지원청 대구동덕초등학교,14,13,1,13,10,3,0,0
교육기관,교육부,대구동도초등학교,교육부 대구광역시교육청 대구광역시동부교육지원청 대구동도초등학교,45,45,0,45,45,0,0,0
교육기관,교육부,대구동문초등학교,교육부 대구광역시교육청 대구광역시동부교육지원청 대구동문초등학교,8,8,0,8,8,0,0,0
교육기관,교육부,대구동부중학교,교육부 대구광역시교육청 대구광역시동부교육지원청 대구동부중학교,54,53,1,53,47,6,0,0
교육기관,교육부,대구동부초등학교,교육부 대구광역시교육청 대구광역시동부교육지원청 대구동부초등학교,16,16,0,16,14,2,0,0
교육기관,교육부,대구동산초등학교,교육부 대구광역시교육청 대구광역시동부교육지원청 대구동산초등학교,21,21,0,21,19,2,0,0
교육기관,교육부,대구동성초등학교,교육부 대구광역시교육청 대구광역시동부교육지원청 대구동성초등학교,21,21,0,21,18,3,0,0
교육기관,교육부,대구동신초등학교,교육부 대구광역시교육청 대구광역시동부교육지원청 대구동신초등학교,20,18,2,18,18,0,0,0
교육기관,교육부,대구동원초등학교,교육부 대구광역시교육청 대구광역시동부교육지원청 대구동원초등학교,28,28,0,28,24,4,0,0
교육기관,교육부,대구동인초등학교,교육부 대구광역시교육청 대구광역시동부교육지원청 대구동인초등학교,19,19,0,19,19,0,0,0
교육기관,교육부,대구동일초등학교,교육부 대구광역시교육청 대구광역시동부교육지원청 대구동일초등학교,18,18,0,18,18,0,0,0
교육기관,교육부,대구동중학교,교육부 대구광역시교육청 대구광역시동부교육지원청 대구동중학교,52,52,0,52,27,25,0,0
교육기관,교육부,대구동천초등학교,교육부 대구광역시교육청 대구광역시동부교육지원청 대구동천초등학교,38,38,0,38,38,0,0,0
교육기관,교육부,대구동촌초등학교,교육부 대구광역시교육청 대구광역시동부교육지원청 대구동촌초등학교,23,23,0,23,1,22,0,0
교육기관,교육부,대구동호초등학교,교육부 대구광역시교육청 대구광역시동부교육지원청 대구동호초등학교,19,19,0,19,19,0,0,0
교육기관,교육부,대구두산초등학교,교육부 대구광역시교육청 대구광역시동부교육지원청 대구두산초등학교,21,21,0,21,21,0,0,0
교육기관,교육부,대구만촌초등학교,교육부 대구광역시교육청 대구광역시동부교육지원청 대구만촌초등학교,17,17,0,17,17,0,0,0
교육기관,교육부,대구매동초등학교,교육부 대구광역시교육청 대구광역시동부교육지원청 대구매동초등학교,17,17,0,17,17,0,0,0
교육기관,교육부,대구매호초등학교,교육부 대구광역시교육청 대구광역시동부교육지원청 대구매호초등학교,22,22,0,22,22,0,0,0
교육기관,교육부,대구명덕초등학교,교육부 대구광역시교육청 대구광역시동부교육지원청 대구명덕초등학교,20,20,0,20,20,0,0,0
교육기관,교육부,대구반야월초등학교,교육부 대구광역시교육청 대구광역시동부교육지원청 대구반야월초등학교,24,24,0,24,0,24,0,0
교육기관,교육부,대구방촌초등학교,교육부 대구광역시교육청 대구광역시동부교육지원청 대구방촌초등학교,18,18,0,18,18,0,0,0
교육기관,교육부,대구범물초등학교,교육부 대구광역시교육청 대구광역시동부교육지원청 대구범물초등학교,23,23,0,23,23,0,0,0
교육기관,교육부,대구범어초등학교,교육부 대구광역시교육청 대구광역시동부교육지원청 대구범어초등학교,22,22,0,22,20,2,0,0
교육기관,교육부,대구범일초등학교,교육부 대구광역시교육청 대구광역시동부교육지원청 대구범일초등학교,34,34,0,34,34,0,0,0
교육기관,교육부,대구복명초등학교,교육부 대구광역시교육청 대구광역시동부교육지원청 대구복명초등학교,23,18,5,18,0,18,0,0
교육기관,교육부,대구봉무초등학교,교육부 대구광역시교육청 대구광역시동부교육지원청 대구봉무초등학교,27,27,0,27,27,0,0,0
교육기관,교육부,대구불로초등학교,교육부 대구광역시교육청 대구광역시동부교육지원청 대구불로초등학교,20,20,0,20,20,0,0,0
교육기관,교육부,대구사월초등학교,교육부 대구광역시교육청 대구광역시동부교육지원청 대구사월초등학교,24,24,0,24,0,24,0,0
교육기관,교육부,대구삼덕초등학교,교육부 대구광역시교육청 대구광역시동부교육지원청 대구삼덕초등학교,19,19,0,19,19,0,0,0
교육기관,교육부,대구삼육초등학교,교육부 대구광역시교육청 대구광역시동부교육지원청 대구삼육초등학교,28,28,0,28,20,8,0,0
교육기관,교육부,대구새론유치원,교육부 대구광역시교육청 대구광역시동부교육지원청 대구새론유치원,14,3,11,3,0,3,0,0
교육기관,교육부,대구새론초등학교,교육부 대구광역시교육청 대구광역시동부교육지원청 대구새론초등학교,31,31,0,31,31,0,0,0
교육기관,교육부,대구서촌초등학교,교육부 대구광역시교육청 대구광역시동부교육지원청 대구서촌초등학교,18,18,0,18,14,4,0,0
교육기관,교육부,대구성동초등학교,교육부 대구광역시교육청 대구광역시동부교육지원청 대구성동초등학교,31,31,0,31,0,31,0,0
교육기관,교육부,대구송정초등학교,교육부 대구광역시교육청 대구광역시동부교육지원청 대구송정초등학교,19,19,0,19,16,3,0,0
교육기관,교육부,대구수성초등학교,교육부 대구광역시교육청 대구광역시동부교육지원청 대구수성초등학교,21,21,0,21,21,0,0,0
교육기관,교육부,대구수창초등학교,교육부 대구광역시교육청 대구광역시동부교육지원청 대구수창초등학교,16,16,0,16,12,4,0,0
교육기관,교육부,대구숙천유치원,교육부 대구광역시교육청 대구광역시동부교육지원청 대구숙천유치원,31,5,26,5,0,5,0,0
교육기관,교육부,대구숙천초등학교,교육부 대구광역시교육청 대구광역시동부교육지원청 대구숙천초등학교,22,22,0,22,22,0,0,0
교육기관,교육부,대구시지초등학교,교육부 대구광역시교육청 대구광역시동부교육지원청 대구시지초등학교,33,33,0,33,33,0,0,0
교육기관,교육부,대구신매초등학교,교육부 대구광역시교육청 대구광역시동부교육지원청 대구신매초등학교,32,32,0,32,32,0,0,0
교육기관,교육부,대구신성초등학교,교육부 대구광역시교육청 대구광역시동부교육지원청 대구신성초등학교,34,34,0,34,0,34,0,0
교육기관,교육부,대구신천초등학교,교육부 대구광역시교육청 대구광역시동부교육지원청 대구신천초등학교,40,40,0,40,40,0,0,0
교육기관,교육부,대구아양초등학교,교육부 대구광역시교육청 대구광역시동부교육지원청 대구아양초등학교,17,17,0,17,17,0,0,0
교육기관,교육부,대구안일초등학교,교육부 대구광역시교육청 대구광역시동부교육지원청 대구안일초등학교,25,25,0,25,20,5,0,0
교육기관,교육부,대구용지초등학교,교육부 대구광역시교육청 대구광역시동부교육지원청 대구용지초등학교,30,30,0,30,30,0,0,0
교육기관,교육부,대구용호초등학교,교육부 대구광역시교육청 대구광역시동부교육지원청 대구용호초등학교,21,21,0,21,0,21,0,0
교육기관,교육부,대구욱수초등학교,교육부 대구광역시교육청 대구광역시동부교육지원청 대구욱수초등학교,23,23,0,23,23,0,0,0
교육기관,교육부,대구율금초등학교,교육부 대구광역시교육청 대구광역시동부교육지원청 대구율금초등학교,22,22,0,22,22,0,0,0
교육기관,교육부,대구율빛유치원,교육부 대구광역시교육청 대구광역시동부교육지원청 대구율빛유치원,29,12,17,12,4,8,0,0
교육기관,교육부,대구율원초등학교,교육부 대구광역시교육청 대구광역시동부교육지원청 대구율원초등학교,35,35,0,35,35,0,0,0
교육기관,교육부,대구율하초등학교,교육부 대구광역시교육청 대구광역시동부교육지원청 대구율하초등학교,16,16,0,16,16,0,0,0
교육기관,교육부,대구입석초등학교,교육부 대구광역시교육청 대구광역시동부교육지원청 대구입석초등학교,14,14,0,14,14,0,0,0
교육기관,교육부,대구제일중학교,교육부 대구광역시교육청 대구광역시동부교육지원청 대구제일중학교,22,22,0,22,22,0,0,0
교육기관,교육부,대구종로초등학교,교육부 대구광역시교육청 대구광역시동부교육지원청 대구종로초등학교,24,24,0,24,20,4,0,0
교육기관,교육부,대구중앙중학교,교육부 대구광역시교육청 대구광역시동부교육지원청 대구중앙중학교,41,41,0,41,0,41,0,0
교육기관,교육부,대구중앙초등학교,교육부 대구광역시교육청 대구광역시동부교육지원청 대구중앙초등학교,34,34,0,34,34,0,0,0
교육기관,교육부,대구지묘초등학교,교육부 대구광역시교육청 대구광역시동부교육지원청 대구지묘초등학교,19,19,0,19,19,0,0,0
교육기관,교육부,대구지봉초등학교,교육부 대구광역시교육청 대구광역시동부교육지원청 대구지봉초등학교,25,24,1,24,24,0,0,0
교육기관,교육부,대구지산초등학교,교육부 대구광역시교육청 대구광역시동부교육지원청 대구지산초등학교,16,16,0,16,0,16,0,0
교육기관,교육부,대구청림초등학교,교육부 대구광역시교육청 대구광역시동부교육지원청 대구청림초등학교,17,17,0,17,17,0,0,0
교육기관,교육부,대구초등학교,교육부 대구광역시교육청 대구광역시동부교육지원청 대구초등학교,13,13,0,13,13,0,0,0
교육기관,교육부,대구파동초등학교,교육부 대구광역시교육청 대구광역시동부교육지원청 대구파동초등학교,16,16,0,16,12,4,0,0
교육기관,교육부,대구팔공유치원,교육부 대구광역시교육청 대구광역시동부교육지원청 대구팔공유치원,45,41,4,41,41,0,0,0
교육기관,교육부,대구팔공중학교,교육부 대구광역시교육청 대구광역시동부교육지원청 대구팔공중학교,0,0,0,0,0,0,0,0
교육기관,교육부,대구팔공초등학교,교육부 대구광역시교육청 대구광역시동부교육지원청 대구팔공초등학교,80,80,0,80,53,27,0,0
교육기관,교육부,대구해서초등학교,교육부 대구광역시교육청 대구광역시동부교육지원청 대구해서초등학교,31,31,0,31,31,0,0,0
교육기관,교육부,대구해안초등학교,교육부 대구광역시교육청 대구광역시동부교육지원청 대구해안초등학교,17,17,0,17,17,0,0,0
교육기관,교육부,대구황금유치원,교육부 대구광역시교육청 대구광역시동부교육지원청 대구황금유치원,32,32,0,32,32,0,0,0
교육기관,교육부,대구황금초등학교,교육부 대구광역시교육청 대구광역시동부교육지원청 대구황금초등학교,32,32,0,32,32,0,0,0
교육기관,교육부,대구효동초등학교,교육부 대구광역시교육청 대구광역시동부교육지원청 대구효동초등학교,19,19,0,19,19,0,0,0
교육기관,교육부,대구효목초등학교,교육부 대구광역시교육청 대구광역시동부교육지원청 대구효목초등학교,24,24,0,24,24,0,0,0
교육기관,교육부,대구효신초등학교,교육부 대구광역시교육청 대구광역시동부교육지원청 대구효신초등학교,17,17,0,17,17,0,0,0
교육기관,교육부,대륜중학교,교육부 대구광역시교육청 대구광역시동부교육지원청 대륜중학교,14,12,2,12,0,12,0,0
교육기관,교육부,덕원중학교,교육부 대구광역시교육청 대구광역시동부교육지원청 덕원중학교,28,26,2,26,0,26,0,0
교육기관,교육부,덕화중학교,교육부 대구광역시교육청 대구광역시동부교육지원청 덕화중학교,30,30,0,30,28,2,0,0
교육기관,교육부,동대구초등학교,교육부 대구광역시교육청 대구광역시동부교육지원청 동대구초등학교,34,34,0,34,0,34,0,0
교육기관,교육부,동도중학교,교육부 대구광역시교육청 대구광역시동부교육지원청 동도중학교,42,42,0,42,42,0,0,0
교육기관,교육부,동원중학교,교육부 대구광역시교육청 대구광역시동부교육지원청 동원중학교,32,32,0,32,13,19,0,0
교육기관,교육부,동촌중학교,교육부 대구광역시교육청 대구광역시동부교육지원청 동촌중학교,36,35,1,35,35,0,0,0
교육기관,교육부,들안길초등학교,교육부 대구광역시교육청 대구광역시동부교육지원청 들안길초등학교,27,27,0,27,6,21,0,0
교육기관,교육부,매호중학교,교육부 대구광역시교육청 대구광역시동부교육지원청 매호중학교,40,40,0,40,1,39,0,0
교육기관,교육부,범물중학교,교육부 대구광역시교육청 대구광역시동부교육지원청 범물중학교,40,40,0,40,0,40,0,0
교육기관,교육부,범일중학교,교육부 대구광역시교육청 대구광역시동부교육지원청 범일중학교,34,34,0,34,10,24,0,0
교육기관,교육부,불로중학교,교육부 대구광역시교육청 대구광역시동부교육지원청 불로중학교,33,33,0,33,12,21,0,0
교육기관,교육부,새론중학교,교육부 대구광역시교육청 대구광역시동부교육지원청 새론중학교,46,46,0,46,0,46,0,0
교육기관,교육부,성명여자중학교,교육부 대구광역시교육청 대구광역시동부교육지원청 성명여자중학교,35,26,9,26,0,26,0,0
교육기관,교육부,소선여자중학교,교육부 대구광역시교육청 대구광역시동부교육지원청 소선여자중학교,36,36,0,36,24,12,0,0
교육기관,교육부,수성중학교,교육부 대구광역시교육청 대구광역시동부교육지원청 수성중학교,27,27,0,27,0,27,0,0
교육기관,교육부,시지중학교,교육부 대구광역시교육청 대구광역시동부교육지원청 시지중학교,18,18,0,18,8,10,0,0
교육기관,교육부,신기중학교,교육부 대구광역시교육청 대구광역시동부교육지원청 신기중학교,45,45,0,45,45,0,0,0
교육기관,교육부,신명여자중학교,교육부 대구광역시교육청 대구광역시동부교육지원청 신명여자중학교,32,31,1,31,23,8,0,0
교육기관,교육부,신아중학교,교육부 대구광역시교육청 대구광역시동부교육지원청 신아중학교,50,50,0,50,50,0,0,0
교육기관,교육부,신천가온유치원,교육부 대구광역시교육청 대구광역시동부교육지원청 신천가온유치원,18,2,16,2,2,0,0,0
교육기관,교육부,안심중학교,교육부 대구광역시교육청 대구광역시동부교육지원청 안심중학교,35,35,0,35,35,0,0,0
교육기관,교육부,영신중학교,교육부 대구광역시교육청 대구광역시동부교육지원청 영신중학교,20,20,0,20,0,20,0,0
교육기관,교육부,영신초등학교,교육부 대구광역시교육청 대구광역시동부교육지원청 영신초등학교,32,32,0,32,10,22,0,0
교육기관,교육부,오성중학교,교육부 대구광역시교육청 대구광역시동부교육지원청 오성중학교,9,9,0,9,9,0,0,0
교육기관,교육부,율원중학교,교육부 대구광역시교육청 대구광역시동부교육지원청 율원중학교,43,43,0,43,0,43,0,0
교육기관,교육부,입석중학교,교육부 대구광역시교육청 대구광역시동부교육지원청 입석중학교,38,38,0,38,0,38,0,0
교육기관,교육부,자연누리유치원,교육부 대구광역시교육청 대구광역시동부교육지원청 자연누리유치원,34,34,0,34,34,0,0,0
교육기관,교육부,정화중학교,교육부 대구광역시교육청 대구광역시동부교육지원청 정화중학교,47,47,0,47,0,47,0,0
교육기관,교육부,지산중학교,교육부 대구광역시교육청 대구광역시동부교육지원청 지산중학교,35,35,0,35,20,15,0,0
교육기관,교육부,청구중학교,교육부 대구광역시교육청 대구광역시동부교육지원청 청구중학교,22,22,0,22,0,22,0,0
교육기관,교육부,황금중학교,교육부 대구광역시교육청 대구광역시동부교육지원청 황금중학교,61,61,0,61,61,0,0,0
교육기관,교육부,대구광역시립남부도서관,교육부 대구광역시교육청 대구광역시립남부도서관,39,39,0,39,0,39,0,0
교육기관,교육부,대구광역시립달성도서관,교육부 대구광역시교육청 대구광역시립달성도서관,25,25,0,25,8,17,0,0
교육기관,교육부,대구광역시립동부도서관,교육부 대구광역시교육청 대구광역시립동부도서관,45,45,0,45,0,45,0,0
교육기관,교육부,대구광역시립두류도서관,교육부 대구광역시교육청 대구광역시립두류도서관,35,35,0,35,29,6,0,0
교육기관,교육부,대구광역시립북부도서관,교육부 대구광역시교육청 대구광역시립북부도서관,32,32,0,32,25,7,0,0
교육기관,교육부,대구광역시립서부도서관,교육부 대구광역시교육청 대구광역시립서부도서관,36,33,3,33,29,0,4,0
교육기관,교육부,대구광역시립수성도서관,교육부 대구광역시교육청 대구광역시립수성도서관,40,40,0,40,11,29,0,0
교육기관,교육부,대구광역시립중앙도서관,교육부 대구광역시교육청 대구광역시립중앙도서관,29,29,0,29,29,0,0,0
교육기관,교육부,대구광역시서부교육지원청,교육부 대구광역시교육청 대구광역시서부교육지원청,16,16,0,16,2,14,0,0
교육기관,교육부,강북중학교,교육부 대구광역시교육청 대구광역시서부교육지원청 강북중학교,27,27,0,27,20,7,0,0
교육기관,교육부,경명여자중학교,교육부 대구광역시교육청 대구광역시서부교육지원청 경명여자중학교,14,14,0,14,14,0,0,0
교육기관,교육부,경상여자중학교,교육부 대구광역시교육청 대구광역시서부교육지원청 경상여자중학교,19,18,1,18,6,12,0,0
교육기관,교육부,경운중학교,교육부 대구광역시교육청 대구광역시서부교육지원청 경운중학교,39,38,1,38,18,20,0,0
교육기관,교육부,경일중학교,교육부 대구광역시교육청 대구광역시서부교육지원청 경일중학교,22,22,0,22,11,11,0,0
교육기관,교육부,관음중학교,교육부 대구광역시교육청 대구광역시서부교육지원청 관음중학교,23,23,0,23,23,0,0,0
교육기관,교육부,관천중학교,교육부 대구광역시교육청 대구광역시서부교육지원청 관천중학교,32,31,1,31,31,0,0,0
교육기관,교육부,구암중학교,교육부 대구광역시교육청 대구광역시서부교육지원청 구암중학교,33,33,0,33,0,33,0,0
교육기관,교육부,대구강북초등학교,교육부 대구광역시교육청 대구광역시서부교육지원청 대구강북초등학교,22,22,0,22,22,0,0,0
교육기관,교육부,대구경운초등학교,교육부 대구광역시교육청 대구광역시서부교육지원청 대구경운초등학교,23,23,0,23,23,0,0,0
교육기관,교육부,대구경진초등학교,교육부 대구광역시교육청 대구광역시서부교육지원청 대구경진초등학교,24,16,8,16,0,16,0,0
교육기관,교육부,대구관남초등학교,교육부 대구광역시교육청 대구광역시서부교육지원청 대구관남초등학교,21,21,0,21,0,21,0,0
교육기관,교육부,대구관문초등학교,교육부 대구광역시교육청 대구광역시서부교육지원청 대구관문초등학교,21,21,0,21,10,11,0,0
교육기관,교육부,대구관음초등학교,교육부 대구광역시교육청 대구광역시서부교육지원청 대구관음초등학교,16,16,0,16,0,16,0,0
교육기관,교육부,대구관천초등학교,교육부 대구광역시교육청 대구광역시서부교육지원청 대구관천초등학교,23,23,0,23,23,0,0,0
교육기관,교육부,대구교동초등학교,교육부 대구광역시교육청 대구광역시서부교육지원청 대구교동초등학교,25,25,0,25,25,0,0,0
교육기관,교육부,대구구암초등학교,교육부 대구광역시교육청 대구광역시서부교육지원청 대구구암초등학교,25,25,0,25,0,25,0,0
교육기관,교육부,대구국우초등학교,교육부 대구광역시교육청 대구광역시서부교육지원청 대구국우초등학교,38,38,0,38,12,26,0,0
교육기관,교육부,대구내서초등학교,교육부 대구광역시교육청 대구광역시서부교육지원청 대구내서초등학교,28,28,0,28,28,0,0,0
교육기관,교육부,대구달산초등학교,교육부 대구광역시교육청 대구광역시서부교육지원청 대구달산초등학교,30,30,0,30,30,0,0,0
교육기관,교육부,대구달서초등학교,교육부 대구광역시교육청 대구광역시서부교육지원청 대구달서초등학교,22,22,0,22,17,5,0,0
교육기관,교육부,대구달성초등학교,교육부 대구광역시교육청 대구광역시서부교육지원청 대구달성초등학교,22,20,2,20,20,0,0,0
교육기관,교육부,대구대산초등학교,교육부 대구광역시교육청 대구광역시서부교육지원청 대구대산초등학교,28,28,0,28,28,0,0,0
교육기관,교육부,대구대성초등학교,교육부 대구광역시교육청 대구광역시서부교육지원청 대구대성초등학교,21,21,0,21,9,12,0,0
교육기관,교육부,대구대천초등학교,교육부 대구광역시교육청 대구광역시서부교육지원청 대구대천초등학교,28,28,0,28,28,0,0,0
교육기관,교육부,대구도남초등학교,교육부 대구광역시교육청 대구광역시서부교육지원청 대구도남초등학교,24,24,0,24,24,0,0,0
교육기관,교육부,대구동변초등학교,교육부 대구광역시교육청 대구광역시서부교육지원청 대구동변초등학교,21,21,0,21,19,2,0,0
교육기관,교육부,대구동평초등학교,교육부 대구광역시교육청 대구광역시서부교육지원청 대구동평초등학교,24,24,0,24,21,3,0,0
교육기관,교육부,대구두류초등학교,교육부 대구광역시교육청 대구광역시서부교육지원청 대구두류초등학교,18,18,0,18,0,18,0,0
교육기관,교육부,대구매천초등학교,교육부 대구광역시교육청 대구광역시서부교육지원청 대구매천초등학교,16,16,0,16,16,0,0,0
교육기관,교육부,대구문성초등학교,교육부 대구광역시교육청 대구광역시서부교육지원청 대구문성초등학교,25,25,0,25,0,25,0,0
교육기관,교육부,대구복현초등학교,교육부 대구광역시교육청 대구광역시서부교육지원청 대구복현초등학교,22,22,0,22,22,0,0,0
교육기관,교육부,대구북부초등학교,교육부 대구광역시교육청 대구광역시서부교육지원청 대구북부초등학교,23,23,0,23,10,13,0,0
교육기관,교육부,대구북비산초등학교,교육부 대구광역시교육청 대구광역시서부교육지원청 대구북비산초등학교,22,22,0,22,22,0,0,0
교육기관,교육부,대구북중학교,교육부 대구광역시교육청 대구광역시서부교육지원청 대구북중학교,40,39,1,39,39,0,0,0
교육기관,교육부,대구비봉초등학교,교육부 대구광역시교육청 대구광역시서부교육지원청 대구비봉초등학교,24,24,0,24,24,0,0,0
교육기관,교육부,대구비산초등학교,교육부 대구광역시교육청 대구광역시서부교육지원청 대구비산초등학교,21,21,0,21,10,11,0,0
교육기관,교육부,대구사수초등학교,교육부 대구광역시교육청 대구광역시서부교육지원청 대구사수초등학교,31,31,0,31,31,0,0,0
교육기관,교육부,대구산격초등학교,교육부 대구광역시교육청 대구광역시서부교육지원청 대구산격초등학교,20,20,0,20,18,2,0,0
교육기관,교육부,대구삼영유치원,교육부 대구광역시교육청 대구광역시서부교육지원청 대구삼영유치원,40,2,38,2,0,2,0,0
교육기관,교육부,대구삼영초등학교,교육부 대구광역시교육청 대구광역시서부교육지원청 대구삼영초등학교,41,41,0,41,41,0,0,0
교육기관,교육부,대구서도초등학교,교육부 대구광역시교육청 대구광역시서부교육지원청 대구서도초등학교,20,20,0,20,20,0,0,0
교육기관,교육부,대구서변유치원,교육부 대구광역시교육청 대구광역시서부교육지원청 대구서변유치원,14,0,14,0,0,0,0,0
교육기관,교육부,대구서변초등학교,교육부 대구광역시교육청 대구광역시서부교육지원청 대구서변초등학교,30,30,0,30,20,10,0,0
교육기관,교육부,대구서변초등학교조야분교장,교육부 대구광역시교육청 대구광역시서부교육지원청 대구서변초등학교조야분교장,12,12,0,12,12,0,0,0
교육기관,교육부,대구서부초등학교,교육부 대구광역시교육청 대구광역시서부교육지원청 대구서부초등학교,26,26,0,26,23,3,0,0
교육기관,교육부,대구서평초등학교,교육부 대구광역시교육청 대구광역시서부교육지원청 대구서평초등학교,24,24,0,24,24,0,0,0
교육기관,교육부,대구성북초등학교,교육부 대구광역시교육청 대구광역시서부교육지원청 대구성북초등학교,18,18,0,18,1,17,0,0
교육기관,교육부,대구신암초등학교,교육부 대구광역시교육청 대구광역시서부교육지원청 대구신암초등학교,29,29,0,29,5,24,0,0
교육기관,교육부,대구연경유치원,교육부 대구광역시교육청 대구광역시서부교육지원청 대구연경유치원,37,7,30,7,4,3,0,0
교육기관,교육부,대구연경초등학교,교육부 대구광역시교육청 대구광역시서부교육지원청 대구연경초등학교,31,31,0,31,0,31,0,0
교육기관,교육부,대구옥산초등학교,교육부 대구광역시교육청 대구광역시서부교육지원청 대구옥산초등학교,25,25,0,25,0,25,0,0
교육기관,교육부,대구운암초등학교,교육부 대구광역시교육청 대구광역시서부교육지원청 대구운암초등학교,18,18,0,18,0,18,0,0
교육기관,교육부,대구이현초등학교,교육부 대구광역시교육청 대구광역시서부교육지원청 대구이현초등학교,13,13,0,13,13,0,0,0
교육기관,교육부,대구인지유치원,교육부 대구광역시교육청 대구광역시서부교육지원청 대구인지유치원,45,45,0,45,45,0,0,0
교육기관,교육부,대구인지초등학교,교육부 대구광역시교육청 대구광역시서부교육지원청 대구인지초등학교,22,22,0,22,22,0,0,0
교육기관,교육부,대구일중학교,교육부 대구광역시교육청 대구광역시서부교육지원청 대구일중학교,35,35,0,35,35,0,0,0
교육기관,교육부,대구중리초등학교,교육부 대구광역시교육청 대구광역시서부교육지원청 대구중리초등학교,28,28,0,28,28,0,0,0
교육기관,교육부,대구체육중학교,교육부 대구광역시교육청 대구광역시서부교육지원청 대구체육중학교,22,22,0,22,0,22,0,0
교육기관,교육부,대구칠곡초등학교,교육부 대구광역시교육청 대구광역시서부교육지원청 대구칠곡초등학교,34,34,0,34,0,34,0,0
교육기관,교육부,대구칠성초등학교,교육부 대구광역시교육청 대구광역시서부교육지원청 대구칠성초등학교,17,17,0,17,17,0,0,0
교육기관,교육부,대구침산초등학교,교육부 대구광역시교육청 대구광역시서부교육지원청 대구침산초등학교,25,25,0,25,0,25,0,0
교육기관,교육부,대구태암초등학교,교육부 대구광역시교육청 대구광역시서부교육지원청 대구태암초등학교,23,23,0,23,23,0,0,0
교육기관,교육부,대구태전초등학교,교육부 대구광역시교육청 대구광역시서부교육지원청 대구태전초등학교,26,26,0,26,26,0,0,0
교육기관,교육부,대구태현초등학교,교육부 대구광역시교육청 대구광역시서부교육지원청 대구태현초등학교,33,33,0,33,0,33,0,0
교육기관,교육부,대구팔달초등학교,교육부 대구광역시교육청 대구광역시서부교육지원청 대구팔달초등학교,16,16,0,16,16,0,0,0
교육기관,교육부,대구평리초등학교,교육부 대구광역시교육청 대구광역시서부교육지원청 대구평리초등학교,28,28,0,28,26,2,0,0
교육기관,교육부,대구학남초등학교,교육부 대구광역시교육청 대구광역시서부교육지원청 대구학남초등학교,24,15,9,15,0,15,0,0
교육기관,교육부,대구학정초등학교,교육부 대구광역시교육청 대구광역시서부교육지원청 대구학정초등학교,33,33,0,33,17,16,0,0
교육기관,교육부,대구함지초등학교,교육부 대구광역시교육청 대구광역시서부교육지원청 대구함지초등학교,22,21,1,21,21,0,0,0
교육기관,교육부,대평중학교,교육부 대구광역시교육청 대구광역시서부교육지원청 대평중학교,16,16,0,16,16,0,0,0
교육기관,교육부,동변중학교,교육부 대구광역시교육청 대구광역시서부교육지원청 동변중학교,44,44,0,44,44,0,0,0
교육기관,교육부,동평중학교,교육부 대구광역시교육청 대구광역시서부교육지원청 동평중학교,22,22,0,22,17,5,0,0
교육기관,교육부,매천중학교,교육부 대구광역시교육청 대구광역시서부교육지원청 매천중학교,52,52,0,52,52,0,0,0
교육기관,교육부,복현중학교,교육부 대구광역시교육청 대구광역시서부교육지원청 복현중학교,35,35,0,35,12,23,0,0
교육기관,교육부,북대구초등학교,교육부 대구광역시교육청 대구광역시서부교육지원청 북대구초등학교,13,13,0,13,7,6,0,0
교육기관,교육부,사수중학교,교육부 대구광역시교육청 대구광역시서부교육지원청 사수중학교,50,49,1,49,49,0,0,0
교육기관,교육부,산격중학교,교육부 대구광역시교육청 대구광역시서부교육지원청 산격중학교,32,32,0,32,0,32,0,0
교육기관,교육부,서남중학교,교육부 대구광역시교육청 대구광역시서부교육지원청 서남중학교,24,24,0,24,24,0,0,0
교육기관,교육부,서대구중학교,교육부 대구광역시교육청 대구광역시서부교육지원청 서대구중학교,32,31,1,31,16,15,0,0
교육기관,교육부,서대구초등학교,교육부 대구광역시교육청 대구광역시서부교육지원청 서대구초등학교,16,16,0,16,16,0,0,0
교육기관,교육부,서변중학교,교육부 대구광역시교육청 대구광역시서부교육지원청 서변중학교,31,30,1,30,9,21,0,0
교육기관,교육부,성광중학교,교육부 대구광역시교육청 대구광역시서부교육지원청 성광중학교,28,28,0,28,0,28,0,0
교육기관,교육부,성화중학교,교육부 대구광역시교육청 대구광역시서부교육지원청 성화중학교,16,16,0,16,0,16,0,0
교육기관,교육부,운암중학교,교육부 대구광역시교육청 대구광역시서부교육지원청 운암중학교,32,32,0,32,27,5,0,0
교육기관,교육부,중리중학교,교육부 대구광역시교육청 대구광역시서부교육지원청 중리중학교,21,21,0,21,21,0,0,0
교육기관,교육부,칠곡중학교,교육부 대구광역시교육청 대구광역시서부교육지원청 칠곡중학교,31,31,0,31,26,5,0,0
교육기관,교육부,침산중학교,교육부 대구광역시교육청 대구광역시서부교육지원청 침산중학교,22,22,0,22,22,0,0,0
교육기관,교육부,팔달중학교,교육부 대구광역시교육청 대구광역시서부교육지원청 팔달중학교,17,17,0,17,8,9,0,0
교육기관,교육부,평리중학교,교육부 대구광역시교육청 대구광역시서부교육지원청 평리중학교,33,30,3,30,18,12,0,0
교육기관,교육부,학남중학교,교육부 대구광역시교육청 대구광역시서부교육지원청 학남중학교,40,38,2,38,38,0,0,0
교육기관,교육부,대구광역시유아교육진흥원,교육부 대구광역시교육청 대구광역시유아교육진흥원,79,79,0,79,0,79,0,0
교육기관,교육부,대구교육낙동강수련원,교육부 대구광역시교육청 대구교육낙동강수련원,122,122,0,122,0,122,0,0
교육기관,교육부,대구교육박물관,교육부 대구광역시교육청 대구교육박물관,90,90,0,90,0,90,0,0
교육기관,교육부,대구교육팔공산수련원,교육부 대구광역시교육청 대구교육팔공산수련원,119,72,47,72,12,60,0,0
교육기관,교육부,대구교육해양수련원,교육부 대구광역시교육청 대구교육해양수련원,54,54,0,54,37,17,0,0
교육기관,교육부,대구국제고등학교,교육부 대구광역시교육청 대구국제고등학교,96,42,54,42,32,10,0,0
교육기관,교육부,대구남산고등학교,교육부 대구광역시교육청 대구남산고등학교,38,38,0,38,0,38,0,0
교육기관,교육부,대구남양학교,교육부 대구광역시교육청 대구남양학교,14,14,0,14,14,0,0,0
교육기관,교육부,대구농업마이스터고등학교,교육부 대구광역시교육청 대구농업마이스터고등학교,114,113,1,113,22,91,0,0
교육기관,교육부,대구달서공업고등학교,교육부 대구광역시교육청 대구달서공업고등학교,46,46,0,46,46,0,0,0
교육기관,교육부,대구덕희학교,교육부 대구광역시교육청 대구덕희학교,28,28,0,28,28,0,0,0
교육기관,교육부,대구동부고등학교,교육부 대구광역시교육청 대구동부고등학교,66,66,0,66,66,0,0,0
교육기관,교육부,대구미래교육연구원,교육부 대구광역시교육청 대구미래교육연구원,66,16,50,16,0,16,0,0
교육기관,교육부,대구보건고등학교,교육부 대구광역시교육청 대구보건고등학교,39,39,0,39,39,0,0,0
교육기관,교육부,대구보건학교,교육부 대구광역시교육청 대구보건학교,19,18,1,18,0,18,0,0
교육기관,교육부,대구보명학교,교육부 대구광역시교육청 대구보명학교,37,37,0,37,37,0,0,0
교육기관,교육부,대구상원고등학교,교육부 대구광역시교육청 대구상원고등학교,16,16,0,16,0,16,0,0
교육기관,교육부,대구서부고등학교,교육부 대구광역시교육청 대구서부고등학교,40,40,0,40,30,10,0,0
교육기관,교육부,대구선명학교,교육부 대구광역시교육청 대구선명학교,13,13,0,13,5,8,0,0
교육기관,교육부,대구성보학교,교육부 대구광역시교육청 대구성보학교,28,28,0,28,14,14,0,0
교육기관,교육부,대구세명학교,교육부 대구광역시교육청 대구세명학교,57,57,0,57,38,19,0,0
교육기관,교육부,대구소프트웨어마이스터고등학교,교육부 대구광역시교육청 대구소프트웨어마이스터고등학교,57,57,0,57,57,0,0,0
교육기관,교육부,대구여자고등학교,교육부 대구광역시교육청 대구여자고등학교,30,25,5,25,25,0,0,0
교육기관,교육부,대구여자상업고등학교,교육부 대구광역시교육청 대구여자상업고등학교,31,31,0,31,15,16,0,0
교육기관,교육부,대구영화학교,교육부 대구광역시교육청 대구영화학교,23,23,0,23,5,16,1,1
교육기관,교육부,대구예담학교,교육부 대구광역시교육청 대구예담학교,51,13,38,13,7,6,0,0
교육기관,교육부,대구예아람학교,교육부 대구광역시교육청 대구예아람학교,70,70,0,70,35,35,0,0
교육기관,교육부,대구외국어고등학교,교육부 대구광역시교육청 대구외국어고등학교,48,48,0,48,6,42,0,0
교육기관,교육부,대구일과학고등학교,교육부 대구광역시교육청 대구일과학고등학교,61,61,0,61,20,41,0,0
교육기관,교육부,대구일마이스터고등학교,교육부 대구광역시교육청 대구일마이스터고등학교,81,81,0,81,52,29,0,0
교육기관,교육부,대구전자공업고등학교,교육부 대구광역시교육청 대구전자공업고등학교,38,38,0,38,0,38,0,0
교육기관,교육부,대구제일고등학교,교육부 대구광역시교육청 대구제일고등학교,31,23,8,23,13,10,0,0
교육기관,교육부,대구제일여자상업고등학교,교육부 대구광역시교육청 대구제일여자상업고등학교,24,24,0,24,0,24,0,0
교육기관,교육부,대구중앙고등학교,교육부 대구광역시교육청 대구중앙고등학교,82,82,0,82,82,0,0,0
교육기관,교육부,대구창의융합교육원,교육부 대구광역시교육청 대구창의융합교육원,31,31,0,31,0,31,0,0
교육기관,교육부,대구체육고등학교,교육부 대구광역시교육청 대구체육고등학교,71,71,0,71,19,52,0,0
교육기관,교육부,대구학교지원센터,교육부 대구광역시교육청 대구학교지원센터,15,15,0,15,15,0,0,0
교육기관,교육부,대구학생문화센터,교육부 대구광역시교육청 대구학생문화센터,47,47,0,47,0,47,0,0
교육기관,교육부,대구해올중고등학교,교육부 대구광역시교육청 대구해올중고등학교,54,54,0,54,0,54,0,0
교육기관,교육부,대구혜화여자고등학교,교육부 대구광역시교육청 대구혜화여자고등학교,34,0,34,0,0,0,0,0
교육기관,교육부,대륜고등학교,교육부 대구광역시교육청 대륜고등학교,41,41,0,41,0,41,0,0
교육기관,교육부,대원고등학교,교육부 대구광역시교육청 대원고등학교,23,23,0,23,3,20,0,0
교육기관,교육부,대중금속공업고등학교,교육부 대구광역시교육청 대중금속공업고등학교,54,54,0,54,0,54,0,0
교육기관,교육부,대진고등학교,교육부 대구광역시교육청 대진고등학교,68,68,0,68,13,55,0,0
교육기관,교육부,덕원고등학교,교육부 대구광역시교육청 덕원고등학교,58,58,0,58,0,58,0,0
교육기관,교육부,도원고등학교,교육부 대구광역시교육청 도원고등학교,33,33,0,33,0,33,0,0
교육기관,교육부,동문고등학교,교육부 대구광역시교육청 동문고등학교,35,35,0,35,10,25,0,0
교육기관,교육부,매천고등학교,교육부 대구광역시교육청 매천고등학교,33,33,0,33,0,33,0,0
교육기관,교육부,비슬고등학교,교육부 대구광역시교육청 비슬고등학교,38,38,0,38,0,38,0,0
교육기관,교육부,상서고등학교,교육부 대구광역시교육청 상서고등학교,34,34,0,34,0,34,0,0
교육기관,교육부,상인고등학교,교육부 대구광역시교육청 상인고등학교,36,36,0,36,36,0,0,0
교육기관,교육부,성광고등학교,교육부 대구광역시교육청 성광고등학교,71,69,2,69,0,69,0,0
교육기관,교육부,성산고등학교,교육부 대구광역시교육청 성산고등학교,19,17,2,17,0,15,1,1
교육기관,교육부,성서고등학교,교육부 대구광역시교육청 성서고등학교,23,23,0,23,15,8,0,0
교육기관,교육부,성화여자고등학교,교육부 대구광역시교육청 성화여자고등학교,14,14,0,14,0,14,0,0
교육기관,교육부,송현여자고등학교,교육부 대구광역시교육청 송현여자고등학교,39,39,0,39,16,17,3,3
교육기관,교육부,수성고등학교,교육부 대구광역시교육청 수성고등학교,32,25,7,25,9,16,0,0
교육기관,교육부,시지고등학교,교육부 대구광역시교육청 시지고등학교,36,36,0,36,23,13,0,0
교육기관,교육부,신명고등학교,교육부 대구광역시교육청 신명고등학교,94,94,0,94,0,94,0,0
교육기관,교육부,심인고등학교,교육부 대구광역시교육청 심인고등학교,99,99,0,99,99,0,0,0
교육기관,교육부,영남고등학교,교육부 대구광역시교육청 영남고등학교,40,40,0,40,30,10,0,0
교육기관,교육부,영남공업고등학교,교육부 대구광역시교육청 영남공업고등학교,64,63,1,63,0,63,0,0
교육기관,교육부,영신고등학교,교육부 대구광역시교육청 영신고등학교,86,86,0,86,0,86,0,0
교육기관,교육부,영진고등학교,교육부 대구광역시교육청 영진고등학교,54,52,2,52,42,10,0,0
교육기관,교육부,오성고등학교,교육부 대구광역시교육청 오성고등학교,24,24,0,24,14,10,0,0
교육기관,교육부,와룡고등학교,교육부 대구광역시교육청 와룡고등학교,19,18,1,18,18,0,0,0
교육기관,교육부,운암고등학교,교육부 대구광역시교육청 운암고등학교,24,24,0,24,15,9,0,0
교육기관,교육부,원화여자고등학교,교육부 대구광역시교육청 원화여자고등학교,11,11,0,11,11,0,0,0
교육기관,교육부,정동고등학교,교육부 대구광역시교육청 정동고등학교,36,35,1,35,19,16,0,0
교육기관,교육부,정화여자고등학교,교육부 대구광역시교육청 정화여자고등학교,19,19,0,19,10,9,0,0
교육기관,교육부,조일고등학교,교육부 대구광역시교육청 조일고등학교,39,39,0,39,27,12,0,0
교육기관,교육부,청구고등학교,교육부 대구광역시교육청 청구고등학교,60,60,0,60,52,8,0,0
교육기관,교육부,칠성고등학교,교육부 대구광역시교육청 칠성고등학교,36,36,0,36,0,36,0,0
교육기관,교육부,포산고등학교,교육부 대구광역시교육청 포산고등학교,78,78,0,78,0,78,0,0
교육기관,교육부,학남고등학교,교육부 대구광역시교육청 학남고등학교,43,31,12,31,31,0,0,0
교육기관,교육부,학력인정한남중미용정보고등학교,교육부 대구광역시교육청 학력인정한남중미용정보고등학교,8,8,0,8,1,7,0,0
교육기관,교육부,함지고등학교,교육부 대구광역시교육청 함지고등학교,43,43,0,43,40,3,0,0
교육기관,교육부,현풍고등학교,교육부 대구광역시교육청 현풍고등학교,137,137,0,137,37,100,0,0
교육기관,교육부,협성고등학교,교육부 대구광역시교육청 협성고등학교,43,43,0,43,27,16,0,0
교육기관,교육부,호산고등학교,교육부 대구광역시교육청 호산고등학교,44,34,10,34,25,9,0,0
교육기관,교육부,화원고등학교,교육부 대구광역시교육청 화원고등학교,39,39,0,39,12,27,0,0
교육기관,교육부,효성여자고등학교,교육부 대구광역시교육청 효성여자고등학교,55,55,0,55,32,23,0,0
교육기관,교육부,인천광역시교육청,교육부 인천광역시교육청,170,134,36,134,0,134,0,0
교육기관,교육부,가림고등학교,교육부 인천광역시교육청 가림고등학교,45,45,0,45,40,5,0,0
교육기관,교육부,가정고등학교,교육부 인천광역시교육청 가정고등학교,50,50,0,50,38,12,0,0
교육기관,교육부,가좌고등학교,교육부 인천광역시교육청 가좌고등학교,49,49,0,49,36,13,0,0
교육기관,교육부,강남영상미디어고등학교,교육부 인천광역시교육청 강남영상미디어고등학교,60,60,0,60,0,60,0,0
교육기관,교육부,강화고등학교,교육부 인천광역시교육청 강화고등학교,99,99,0,99,20,79,0,0
교육기관,교육부,강화여자고등학교,교육부 인천광역시교육청 강화여자고등학교,40,4,36,4,2,2,0,0
교육기관,교육부,검단고등학교,교육부 인천광역시교육청 검단고등학교,46,46,0,46,46,0,0,0
교육기관,교육부,계산고등학교,교육부 인천광역시교육청 계산고등학교,39,39,0,39,0,39,0,0
교육기관,교육부,계산공업고등학교,교육부 인천광역시교육청 계산공업고등학교,79,79,0,79,49,30,0,0
교육기관,교육부,계산여자고등학교,교육부 인천광역시교육청 계산여자고등학교,23,23,0,23,18,5,0,0
교육기관,교육부,계양고등학교,교육부 인천광역시교육청 계양고등학교,42,40,2,40,14,26,0,0
교육기관,교육부,광성고등학교,교육부 인천광역시교육청 광성고등학교,52,52,0,52,0,52,0,0
교육기관,교육부,교동고등학교,교육부 인천광역시교육청 교동고등학교,28,27,1,27,23,2,2,0
교육기관,교육부,남인천고등학교,교육부 인천광역시교육청 남인천고등학교,19,19,0,19,8,11,0,0
교육기관,교육부,대인고등학교,교육부 인천광역시교육청 대인고등학교,90,90,0,90,0,90,0,0
교육기관,교육부,대청고등학교,교육부 인천광역시교육청 대청고등학교,15,15,0,15,15,0,0,0
교육기관,교육부,덕신고등학교,교육부 인천광역시교육청 덕신고등학교,47,47,0,47,43,4,0,0
교육기관,교육부,덕적고등학교,교육부 인천광역시교육청 덕적고등학교,29,28,1,28,15,12,1,0
교육기관,교육부,도림고등학교,교육부 인천광역시교육청 도림고등학교,66,64,2,64,0,64,0,0
교육기관,교육부,명신여자고등학교,교육부 인천광역시교육청 명신여자고등학교,39,39,0,39,2,35,2,0
교육기관,교육부,문일여자고등학교,교육부 인천광역시교육청 문일여자고등학교,36,35,1,35,16,19,0,0
교육기관,교육부,문학정보고등학교,교육부 인천광역시교육청 문학정보고등학교,29,26,3,26,25,1,0,0
교육기관,교육부,미추홀외국어고등학교,교육부 인천광역시교육청 미추홀외국어고등학교,98,98,0,98,1,97,0,0
교육기관,교육부,미추홀학교,교육부 인천광역시교육청 미추홀학교,21,21,0,21,0,21,0,0
교육기관,교육부,박문여자고등학교,교육부 인천광역시교육청 박문여자고등학교,68,66,2,66,66,0,0,0
교육기관,교육부,백령고등학교,교육부 인천광역시교육청 백령고등학교,46,46,0,46,46,0,0,0
교육기관,교육부,백석고등학교,교육부 인천광역시교육청 백석고등학교,52,52,0,52,52,0,0,0
교육기관,교육부,부개고등학교,교육부 인천광역시교육청 부개고등학교,30,30,0,30,2,28,0,0
교육기관,교육부,부개여자고등학교,교육부 인천광역시교육청 부개여자고등학교,35,35,0,35,26,9,0,0
교육기관,교육부,부광고등학교,교육부 인천광역시교육청 부광고등학교,43,43,0,43,38,5,0,0
교육기관,교육부,부광여자고등학교,교육부 인천광역시교육청 부광여자고등학교,32,32,0,32,17,15,0,0
교육기관,교육부,부평고등학교,교육부 인천광역시교육청 부평고등학교,25,25,0,25,0,25,0,0
교육기관,교육부,부평공업고등학교,교육부 인천광역시교육청 부평공업고등학교,53,53,0,53,53,0,0,0
교육기관,교육부,산마을고등학교,교육부 인천광역시교육청 산마을고등학교,23,23,0,23,5,18,0,0
교육기관,교육부,삼산고등학교,교육부 인천광역시교육청 삼산고등학교,46,46,0,46,0,46,0,0
교육기관,교육부,서도고등학교,교육부 인천광역시교육청 서도고등학교,10,10,0,10,0,10,0,0
교육기관,교육부,서운고등학교,교육부 인천광역시교육청 서운고등학교,72,72,0,72,46,26,0,0
교육기관,교육부,서인천고등학교,교육부 인천광역시교육청 서인천고등학교,61,61,0,61,0,61,0,0
교육기관,교육부,석정여자고등학교,교육부 인천광역시교육청 석정여자고등학교,19,4,15,4,4,0,0,0
교육기관,교육부,선인고등학교,교육부 인천광역시교육청 선인고등학교,41,41,0,41,10,11,10,10
교육기관,교육부,세일고등학교,교육부 인천광역시교육청 세일고등학교,57,57,0,57,29,28,0,0
교육기관,교육부,송도고등학교,교육부 인천광역시교육청 송도고등학교,46,44,2,44,0,44,0,0
교육기관,교육부,숭덕여자고등학교,교육부 인천광역시교육청 숭덕여자고등학교,37,37,0,37,7,30,0,0
교육기관,교육부,신명여자고등학교,교육부 인천광역시교육청 신명여자고등학교,38,38,0,38,38,0,0,0
교육기관,교육부,신송고등학교,교육부 인천광역시교육청 신송고등학교,45,14,31,14,5,9,0,0
교육기관,교육부,안남고등학교,교육부 인천광역시교육청 안남고등학교,45,45,0,45,2,43,0,0
교육기관,교육부,연수고등학교,교육부 인천광역시교육청 연수고등학교,35,35,0,35,17,18,0,0
교육기관,교육부,연수여자고등학교,교육부 인천광역시교육청 연수여자고등학교,15,11,4,11,8,3,0,0
교육기관,교육부,연평고등학교,교육부 인천광역시교육청 연평고등학교,40,40,0,40,27,13,0,0
교육기관,교육부,영종국제물류고등학교,교육부 인천광역시교육청 영종국제물류고등학교,37,17,20,17,5,10,1,1
교육기관,교육부,영화국제관광고등학교,교육부 인천광역시교육청 영화국제관광고등학교,56,56,0,56,0,56,0,0
교육기관,교육부,옥련여자고등학교,교육부 인천광역시교육청 옥련여자고등학교,27,7,20,7,7,0,0,0
교육기관,교육부,인명여자고등학교,교육부 인천광역시교육청 인명여자고등학교,19,19,0,19,17,2,0,0
교육기관,교육부,인성여자고등학교,교육부 인천광역시교육청 인성여자고등학교,39,39,0,39,0,39,0,0
교육기관,교육부,인일여자고등학교,교육부 인천광역시교육청 인일여자고등학교,44,43,1,43,15,28,0,0
교육기관,교육부,인제고등학교,교육부 인천광역시교육청 인제고등학교,28,28,0,28,28,0,0,0
교육기관,교육부,인천고등학교,교육부 인천광역시교육청 인천고등학교,60,60,0,60,0,60,0,0
교육기관,교육부,인천고잔고등학교,교육부 인천광역시교육청 인천고잔고등학교,28,28,0,28,25,3,0,0
교육기관,교육부,인천공항고등학교,교육부 인천광역시교육청 인천공항고등학교,31,29,2,29,14,15,0,0
교육기관,교육부,인천과학고등학교,교육부 인천광역시교육청 인천과학고등학교,52,52,0,52,0,52,0,0
교육기관,교육부,인천과학예술영재학교,교육부 인천광역시교육청 인천과학예술영재학교,105,105,0,105,105,0,0,0
교육기관,교육부,인천광역시강화교육지원청,교육부 인천광역시교육청 인천광역시강화교육지원청,30,30,0,30,0,30,0,0
교육기관,교육부,갑룡초등학교,교육부 인천광역시교육청 인천광역시강화교육지원청 갑룡초등학교,32,32,0,32,25,7,0,0
교육기관,교육부,강남중학교,교육부 인천광역시교육청 인천광역시강화교육지원청 강남중학교,30,30,0,30,18,12,0,0
교육기관,교육부,강서중학교,교육부 인천광역시교육청 인천광역시강화교육지원청 강서중학교,17,16,1,16,5,11,0,0
교육기관,교육부,강화여자중학교,교육부 인천광역시교육청 인천광역시강화교육지원청 강화여자중학교,35,33,2,33,20,13,0,0
교육기관,교육부,강화유치원,교육부 인천광역시교육청 인천광역시강화교육지원청 강화유치원,8,0,8,0,0,0,0,0
교육기관,교육부,강화중학교,교육부 인천광역시교육청 인천광역시강화교육지원청 강화중학교,29,29,0,29,0,29,0,0
교육기관,교육부,강화초등학교,교육부 인천광역시교육청 인천광역시강화교육지원청 강화초등학교,20,20,0,20,0,20,0,0
교육기관,교육부,교동초등학교,교육부 인천광역시교육청 인천광역시강화교육지원청 교동초등학교,26,26,0,26,22,4,0,0
교육기관,교육부,길상초등학교,교육부 인천광역시교육청 인천광역시강화교육지원청 길상초등학교,15,15,0,15,15,0,0,0
교육기관,교육부,내가초등학교,교육부 인천광역시교육청 인천광역시강화교육지원청 내가초등학교,16,16,0,16,16,0,0,0
교육기관,교육부,대월초등학교,교육부 인천광역시교육청 인천광역시강화교육지원청 대월초등학교,11,11,0,11,11,0,0,0
교육기관,교육부,동광중학교,교육부 인천광역시교육청 인천광역시강화교육지원청 동광중학교,16,16,0,16,8,8,0,0
교육기관,교육부,마니산유치원,교육부 인천광역시교육청 인천광역시강화교육지원청 마니산유치원,7,7,0,7,0,7,0,0
교육기관,교육부,명신초등학교,교육부 인천광역시교육청 인천광역시강화교육지원청 명신초등학교,15,15,0,15,0,15,0,0
교육기관,교육부,불은초등학교,교육부 인천광역시교육청 인천광역시강화교육지원청 불은초등학교,9,9,0,9,9,0,0,0
교육기관,교육부,삼산초등학교,교육부 인천광역시교육청 인천광역시강화교육지원청 삼산초등학교,17,17,0,17,0,17,0,0
교육기관,교육부,삼성초등학교,교육부 인천광역시교육청 인천광역시강화교육지원청 삼성초등학교,17,17,0,17,17,0,0,0
교육기관,교육부,서도중학교,교육부 인천광역시교육청 인천광역시강화교육지원청 서도중학교,10,10,0,10,0,10,0,0
교육기관,교육부,서도초등학교,교육부 인천광역시교육청 인천광역시강화교육지원청 서도초등학교,10,10,0,10,0,10,0,0
교육기관,교육부,선원초등학교,교육부 인천광역시교육청 인천광역시강화교육지원청 선원초등학교,22,22,0,22,0,22,0,0
교육기관,교육부,송해초등학교,교육부 인천광역시교육청 인천광역시강화교육지원청 송해초등학교,16,16,0,16,8,8,0,0
교육기관,교육부,심도중학교,교육부 인천광역시교육청 인천광역시강화교육지원청 심도중학교,19,19,0,19,19,0,0,0
교육기관,교육부,양도초등학교,교육부 인천광역시교육청 인천광역시강화교육지원청 양도초등학교,17,17,0,17,1,14,1,1
교육기관,교육부,양사초등학교,교육부 인천광역시교육청 인천광역시강화교육지원청 양사초등학교,24,24,0,24,24,0,0,0
교육기관,교육부,조산초등학교,교육부 인천광역시교육청 인천광역시강화교육지원청 조산초등학교,20,20,0,20,16,4,0,0
교육기관,교육부,코끼리유치원,교육부 인천광역시교육청 인천광역시강화교육지원청 코끼리유치원,14,14,0,14,0,14,0,0
교육기관,교육부,합일초등학교,교육부 인천광역시교육청 인천광역시강화교육지원청 합일초등학교,16,16,0,16,0,16,0,0
교육기관,교육부,해명초등학교,교육부 인천광역시교육청 인천광역시강화교육지원청 해명초등학교,14,14,0,14,5,9,0,0
교육기관,교육부,화도초등학교,교육부 인천광역시교육청 인천광역시강화교육지원청 화도초등학교,16,16,0,16,16,0,0,0
교육기관,교육부,인천광역시교육청계양도서관,교육부 인천광역시교육청 인천광역시교육청계양도서관,36,36,0,36,17,15,0,4
교육기관,교육부,인천광역시교육청교육과학정보원,교육부 인천광역시교육청 인천광역시교육청교육과학정보원,62,57,5,57,0,57,0,0
교육기관,교육부,인천광역시교육청교육연수원,교육부 인천광역시교육청 인천광역시교육청교육연수원,36,36,0,36,0,36,0,0
교육기관,교육부,인천광역시교육청교직원수련원,교육부 인천광역시교육청 인천광역시교육청교직원수련원,14,14,0,14,0,14,0,0
교육기관,교육부,인천광역시교육청동아시아국제교육원,교육부 인천광역시교육청 인천광역시교육청동아시아국제교육원,34,34,0,34,0,34,0,0
교육기관,교육부,인천광역시교육청부평도서관,교육부 인천광역시교육청 인천광역시교육청부평도서관,25,25,0,25,0,25,0,0
교육기관,교육부,인천광역시교육청북구도서관,교육부 인천광역시교육청 인천광역시교육청북구도서관,59,59,0,59,59,0,0,0
교육기관,교육부,인천광역시교육청서구도서관,교육부 인천광역시교육청 인천광역시교육청서구도서관,59,59,0,59,0,59,0,0
교육기관,교육부,인천광역시교육청연수도서관,교육부 인천광역시교육청 인천광역시교육청연수도서관,52,51,1,51,51,0,0,0
교육기관,교육부,인천광역시교육청유아교육진흥원,교육부 인천광역시교육청 인천광역시교육청유아교육진흥원,49,0,49,0,0,0,0,0
교육기관,교육부,인천광역시교육청주안도서관,교육부 인천광역시교육청 인천광역시교육청주안도서관,31,31,0,31,0,31,0,0
교육기관,교육부,인천광역시교육청중앙도서관,교육부 인천광역시교육청 인천광역시교육청중앙도서관,41,41,0,41,0,41,0,0
교육기관,교육부,인천광역시교육청평생학습관,교육부 인천광역시교육청 인천광역시교육청평생학습관,52,52,0,52,0,52,0,0
교육기관,교육부,인천광역시교육청학교지원단,교육부 인천광역시교육청 인천광역시교육청학교지원단,19,0,19,0,0,0,0,0
교육기관,교육부,인천광역시교육청학생교육문화회관,교육부 인천광역시교육청 인천광역시교육청학생교육문화회관,97,90,7,90,7,83,0,0
교육기관,교육부,인천광역시교육청학생교육원,교육부 인천광역시교육청 인천광역시교육청학생교육원,55,55,0,55,0,55,0,0
교육기관,교육부,인천광역시교육청화도진도서관,교육부 인천광역시교육청 인천광역시교육청화도진도서관,20,20,0,20,15,5,0,0
교육기관,교육부,인천광역시남부교육지원청,교육부 인천광역시교육청 인천광역시남부교육지원청,20,20,0,20,0,20,0,0
교육기관,교육부,관교여자중학교,교육부 인천광역시교육청 인천광역시남부교육지원청 관교여자중학교,46,46,0,46,0,46,0,0
교육기관,교육부,관교중학교,교육부 인천광역시교육청 인천광역시남부교육지원청 관교중학교,52,50,2,50,8,42,0,0
교육기관,교육부,광성중학교,교육부 인천광역시교육청 인천광역시남부교육지원청 광성중학교,39,39,0,39,0,39,0,0
교육기관,교육부,그림나라유치원,교육부 인천광역시교육청 인천광역시남부교육지원청 그림나라유치원,13,13,0,13,12,1,0,0
교육기관,교육부,노벨유치원,교육부 인천광역시교육청 인천광역시남부교육지원청 노벨유치원,8,0,8,0,0,0,0,0
교육기관,교육부,다솜유치원,교육부 인천광역시교육청 인천광역시남부교육지원청 다솜유치원,20,20,0,20,0,17,3,0
교육기관,교육부,대청중학교,교육부 인천광역시교육청 인천광역시남부교육지원청 대청중학교,15,15,0,15,15,0,0,0
교육기관,교육부,대청초등학교,교육부 인천광역시교육청 인천광역시남부교육지원청 대청초등학교,6,6,0,6,2,4,0,0
교육기관,교육부,덕적초등학교,교육부 인천광역시교육청 인천광역시남부교육지원청 덕적초등학교,23,23,0,23,15,8,0,0
교육기관,교육부,동산중학교,교육부 인천광역시교육청 인천광역시남부교육지원청 동산중학교,28,28,0,28,0,28,0,0
교육기관,교육부,뒤나미스유치원,교육부 인천광역시교육청 인천광역시남부교육지원청 뒤나미스유치원,64,6,58,6,3,3,0,0
교육기관,교육부,무지개유치원,교육부 인천광역시교육청 인천광역시남부교육지원청 무지개유치원,20,20,0,20,16,1,3,0
교육기관,교육부,미주유치원,교육부 인천광역시교육청 인천광역시남부교육지원청 미주유치원,16,3,13,3,1,2,0,0
교육기관,교육부,밀알유치원,교육부 인천광역시교육청 인천광역시남부교육지원청 밀알유치원,14,14,0,14,2,12,0,0
교육기관,교육부,반디유치원,교육부 인천광역시교육청 인천광역시남부교육지원청 반디유치원,15,3,12,3,2,1,0,0
교육기관,교육부,백령중학교,교육부 인천광역시교육청 인천광역시남부교육지원청 백령중학교,46,46,0,46,46,0,0,0
교육기관,교육부,북포초등학교,교육부 인천광역시교육청 인천광역시남부교육지원청 북포초등학교,21,21,0,21,17,4,0,0
교육기관,교육부,산새소리유치원,교육부 인천광역시교육청 인천광역시남부교육지원청 산새소리유치원,13,13,0,13,11,2,0,0
교육기관,교육부,선화여자중학교,교육부 인천광역시교육청 인천광역시남부교육지원청 선화여자중학교,37,37,0,37,0,37,0,0
교육기관,교육부,성바오로유치원,교육부 인천광역시교육청 인천광역시남부교육지원청 성바오로유치원,24,24,0,24,14,8,0,2
교육기관,교육부,솔빛유치원,교육부 인천광역시교육청 인천광역시남부교육지원청 솔빛유치원,16,16,0,16,2,14,0,0
교육기관,교육부,솔샘유치원,교육부 인천광역시교육청 인천광역시남부교육지원청 솔샘유치원,20,3,17,3,0,3,0,0
교육기관,교육부,숭의유치원,교육부 인천광역시교육청 인천광역시남부교육지원청 숭의유치원,16,16,0,16,2,14,0,0
교육기관,교육부,신동아유치원,교육부 인천광역시교육청 인천광역시남부교육지원청 신동아유치원,8,2,6,2,2,0,0,0
교육기관,교육부,신흥여자중학교,교육부 인천광역시교육청 인천광역시남부교육지원청 신흥여자중학교,16,16,0,16,8,8,0,0
교육기관,교육부,신흥중학교,교육부 인천광역시교육청 인천광역시남부교육지원청 신흥중학교,68,68,0,68,16,52,0,0
교육기관,교육부,연흥유치원,교육부 인천광역시교육청 인천광역시남부교육지원청 연흥유치원,9,0,9,0,0,0,0,0
교육기관,교육부,영종유치원,교육부 인천광역시교육청 인천광역시남부교육지원청 영종유치원,25,25,0,25,9,13,3,0
교육기관,교육부,영종중학교,교육부 인천광역시교육청 인천광역시남부교육지원청 영종중학교,68,68,0,68,43,25,0,0
교육기관,교육부,영흥중학교,교육부 인천광역시교육청 인천광역시남부교육지원청 영흥중학교,34,34,0,34,34,0,0,0
교육기관,교육부,영흥초등학교,교육부 인천광역시교육청 인천광역시남부교육지원청 영흥초등학교,14,8,6,8,4,4,0,0
교육기관,교육부,용현여자중학교,교육부 인천광역시교육청 인천광역시남부교육지원청 용현여자중학교,26,24,2,24,24,0,0,0
교육기관,교육부,용현중학교,교육부 인천광역시교육청 인천광역시남부교육지원청 용현중학교,56,4,52,4,3,1,0,0
교육기관,교육부,용화유치원,교육부 인천광역시교육청 인천광역시남부교육지원청 용화유치원,16,6,10,6,0,6,0,0
교육기관,교육부,유원유치원,교육부 인천광역시교육청 인천광역시남부교육지원청 유원유치원,14,3,11,3,1,2,0,0
교육기관,교육부,인성여자중학교,교육부 인천광역시교육청 인천광역시남부교육지원청 인성여자중학교,39,39,0,39,32,7,0,0
교육기관,교육부,인성초등학교,교육부 인천광역시교육청 인천광역시남부교육지원청 인성초등학교,16,16,0,16,0,16,0,0
교육기관,교육부,인주중학교,교육부 인천광역시교육청 인천광역시남부교육지원청 인주중학교,62,62,0,62,21,41,0,0
교육기관,교육부,인천경원초등학교,교육부 인천광역시교육청 인천광역시남부교육지원청 인천경원초등학교,27,27,0,27,27,0,0,0
교육기관,교육부,인천공항유치원,교육부 인천광역시교육청 인천광역시남부교육지원청 인천공항유치원,5,5,0,5,5,0,0,0
교육기관,교육부,인천공항중학교,교육부 인천광역시교육청 인천광역시남부교육지원청 인천공항중학교,36,36,0,36,18,18,0,0
교육기관,교육부,인천공항초등학교,교육부 인천광역시교육청 인천광역시남부교육지원청 인천공항초등학교,20,20,0,20,20,0,0,0
교육기관,교육부,인천관교초등학교,교육부 인천광역시교육청 인천광역시남부교육지원청 인천관교초등학교,22,22,0,22,0,22,0,0
교육기관,교육부,인천남부초등학교,교육부 인천광역시교육청 인천광역시남부교육지원청 인천남부초등학교,19,19,0,19,19,0,0,0
교육기관,교육부,인천남중학교,교육부 인천광역시교육청 인천광역시남부교육지원청 인천남중학교,44,44,0,44,29,15,0,0
교육기관,교육부,인천도화초등학교,교육부 인천광역시교육청 인천광역시남부교육지원청 인천도화초등학교,34,34,0,34,24,10,0,0
교육기관,교육부,인천동명초등학교,교육부 인천광역시교육청 인천광역시남부교육지원청 인천동명초등학교,22,22,0,22,0,22,0,0
교육기관,교육부,인천만석초등학교,교육부 인천광역시교육청 인천광역시남부교육지원청 인천만석초등학교,16,16,0,16,16,0,0,0
교육기관,교육부,인천문학초등학교,교육부 인천광역시교육청 인천광역시남부교육지원청 인천문학초등학교,25,25,0,25,18,0,0,7
교육기관,교육부,인천백학초등학교,교육부 인천광역시교육청 인천광역시남부교육지원청 인천백학초등학교,18,18,0,18,0,18,0,0
교육기관,교육부,인천삼목초등학교,교육부 인천광역시교육청 인천광역시남부교육지원청 인천삼목초등학교,17,17,0,17,12,5,0,0
교육기관,교육부,인천서림초등학교,교육부 인천광역시교육청 인천광역시남부교육지원청 인천서림초등학교,22,22,0,22,0,22,0,0
교육기관,교육부,인천서화초등학교,교육부 인천광역시교육청 인천광역시남부교육지원청 인천서화초등학교,41,41,0,41,25,16,0,0
교육기관,교육부,인천석암초등학교,교육부 인천광역시교육청 인천광역시남부교육지원청 인천석암초등학교,25,25,0,25,25,0,0,0
교육기관,교육부,인천송림초등학교,교육부 인천광역시교육청 인천광역시남부교육지원청 인천송림초등학교,22,22,0,22,18,4,0,0
교육기관,교육부,인천송월초등학교,교육부 인천광역시교육청 인천광역시남부교육지원청 인천송월초등학교,31,31,0,31,16,15,0,0
교육기관,교육부,인천송현초등학교,교육부 인천광역시교육청 인천광역시남부교육지원청 인천송현초등학교,31,31,0,31,31,0,0,0
교육기관,교육부,인천숭의초등학교,교육부 인천광역시교육청 인천광역시남부교육지원청 인천숭의초등학교,19,19,0,19,19,0,0,0
교육기관,교육부,인천승학초등학교,교육부 인천광역시교육청 인천광역시남부교육지원청 인천승학초등학교,14,14,0,14,14,0,0,0
교육기관,교육부,인천신광초등학교,교육부 인천광역시교육청 인천광역시남부교육지원청 인천신광초등학교,24,24,0,24,24,0,0,0
교육기관,교육부,인천신선초등학교,교육부 인천광역시교육청 인천광역시남부교육지원청 인천신선초등학교,14,14,0,14,0,14,0,0
교육기관,교육부,인천신흥초등학교,교육부 인천광역시교육청 인천광역시남부교육지원청 인천신흥초등학교,26,25,1,25,25,0,0,0
교육기관,교육부,인천연안초등학교,교육부 인천광역시교육청 인천광역시남부교육지원청 인천연안초등학교,19,19,0,19,3,16,0,0
교육기관,교육부,인천연학초등학교,교육부 인천광역시교육청 인천광역시남부교육지원청 인천연학초등학교,16,16,0,16,0,16,0,0
교육기관,교육부,인천영종초등학교,교육부 인천광역시교육청 인천광역시남부교육지원청 인천영종초등학교,43,43,0,43,43,0,0,0
교육기관,교육부,인천영종초등학교금산분교장,교육부 인천광역시교육청 인천광역시남부교육지원청 인천영종초등학교금산분교장,11,11,0,11,11,0,0,0
교육기관,교육부,인천용유초등학교,교육부 인천광역시교육청 인천광역시남부교육지원청 인천용유초등학교,12,12,0,12,12,0,0,0
교육기관,교육부,인천용일초등학교,교육부 인천광역시교육청 인천광역시남부교육지원청 인천용일초등학교,20,20,0,20,20,0,0,0
교육기관,교육부,인천용정초등학교,교육부 인천광역시교육청 인천광역시남부교육지원청 인천용정초등학교,20,20,0,20,10,10,0,0
교육기관,교육부,인천용학초등학교,교육부 인천광역시교육청 인천광역시남부교육지원청 인천용학초등학교,37,37,0,37,0,37,0,0
교육기관,교육부,인천용현남초등학교,교육부 인천광역시교육청 인천광역시남부교육지원청 인천용현남초등학교,25,25,0,25,18,7,0,0
교육기관,교육부,인천용현초등학교,교육부 인천광역시교육청 인천광역시남부교육지원청 인천용현초등학교,25,25,0,25,24,1,0,0
교육기관,교육부,인천운남초등학교,교육부 인천광역시교육청 인천광역시남부교육지원청 인천운남초등학교,24,24,0,24,0,24,0,0
교육기관,교육부,인천인주초등학교,교육부 인천광역시교육청 인천광역시남부교육지원청 인천인주초등학교,16,16,0,16,8,8,0,0
교육기관,교육부,인천재능대학교부속유치원,교육부 인천광역시교육청 인천광역시남부교육지원청 인천재능대학교부속유치원,32,7,25,7,0,7,0,0
교육기관,교육부,인천재능중학교,교육부 인천광역시교육청 인천광역시남부교육지원청 인천재능중학교,18,18,0,18,18,0,0,0
교육기관,교육부,인천주안남초등학교,교육부 인천광역시교육청 인천광역시남부교육지원청 인천주안남초등학교,16,16,0,16,5,11,0,0
교육기관,교육부,인천주안북초등학교,교육부 인천광역시교육청 인천광역시남부교육지원청 인천주안북초등학교,19,19,0,19,19,0,0,0
교육기관,교육부,인천주안초등학교,교육부 인천광역시교육청 인천광역시남부교육지원청 인천주안초등학교,70,38,32,38,31,7,0,0
교육기관,교육부,인천중산초등학교,교육부 인천광역시교육청 인천광역시남부교육지원청 인천중산초등학교,37,37,0,37,28,9,0,0
교육기관,교육부,인천창영초등학교,교육부 인천광역시교육청 인천광역시남부교육지원청 인천창영초등학교,23,23,0,23,22,1,0,0
교육기관,교육부,인천하늘중학교,교육부 인천광역시교육청 인천광역시남부교육지원청 인천하늘중학교,64,64,0,64,64,0,0,0
교육기관,교육부,인천하늘초등학교,교육부 인천광역시교육청 인천광역시남부교육지원청 인천하늘초등학교,22,22,0,22,22,0,0,0
교육기관,교육부,인천학산초등학교,교육부 인천광역시교육청 인천광역시남부교육지원청 인천학산초등학교,21,21,0,21,7,12,0,2
교육기관,교육부,인천학익초등학교,교육부 인천광역시교육청 인천광역시남부교육지원청 인천학익초등학교,25,25,0,25,25,0,0,0
교육기관,교육부,인하대학교사범대학부속중학교,교육부 인천광역시교육청 인천광역시남부교육지원청 인하대학교사범대학부속중학교,33,33,0,33,29,4,0,0
교육기관,교육부,인화여자중학교,교육부 인천광역시교육청 인천광역시남부교육지원청 인화여자중학교,37,37,0,37,37,0,0,0
교육기관,교육부,자유유치원,교육부 인천광역시교육청 인천광역시남부교육지원청 자유유치원,16,16,0,16,7,7,1,1
교육기관,교육부,제물포여자중학교,교육부 인천광역시교육청 인천광역시남부교육지원청 제물포여자중학교,41,41,0,41,20,21,0,0
교육기관,교육부,진흥유치원,교육부 인천광역시교육청 인천광역시남부교육지원청 진흥유치원,8,8,0,8,1,7,0,0
교육기관,교육부,초롱유치원,교육부 인천광역시교육청 인천광역시남부교육지원청 초롱유치원,16,16,0,16,0,16,0,0
교육기관,교육부,한빛유치원,교육부 인천광역시교육청 인천광역시남부교육지원청 한빛유치원,15,0,15,0,0,0,0,0
교육기관,교육부,한울유치원,교육부 인천광역시교육청 인천광역시남부교육지원청 한울유치원,16,1,15,1,1,0,0,0
교육기관,교육부,해님나라유치원,교육부 인천광역시교육청 인천광역시남부교육지원청 해님나라유치원,17,17,0,17,4,13,0,0
교육기관,교육부,해승유치원,교육부 인천광역시교육청 인천광역시남부교육지원청 해승유치원,11,1,10,1,1,0,0,0
교육기관,교육부,화도진중학교,교육부 인천광역시교육청 인천광역시남부교육지원청 화도진중학교,67,65,2,65,11,52,1,1
교육기관,교육부,인천광역시동부교육지원청,교육부 인천광역시교육청 인천광역시동부교육지원청,16,16,0,16,0,16,0,0
교육기관,교육부,간석여자중학교,교육부 인천광역시교육청 인천광역시동부교육지원청 간석여자중학교,33,31,2,31,0,31,0,0
교육기관,교육부,경희유치원,교육부 인천광역시교육청 인천광역시동부교육지원청 경희유치원,26,6,20,6,6,0,0,0
교육기관,교육부,구월여자중학교,교육부 인천광역시교육청 인천광역시동부교육지원청 구월여자중학교,36,36,0,36,36,0,0,0
교육기관,교육부,구월중학교,교육부 인천광역시교육청 인천광역시동부교육지원청 구월중학교,25,25,0,25,25,0,0,0
교육기관,교육부,기암유치원,교육부 인천광역시교육청 인천광역시동부교육지원청 기암유치원,32,11,21,11,6,4,1,0
교육기관,교육부,꿈동산유치원,교육부 인천광역시교육청 인천광역시동부교육지원청 꿈동산유치원,12,1,11,1,0,0,0,1
교육기관,교육부,남동중학교,교육부 인천광역시교육청 인천광역시동부교육지원청 남동중학교,31,31,0,31,21,10,0,0
교육기관,교육부,논곡중학교,교육부 인천광역시교육청 인천광역시동부교육지원청 논곡중학교,26,26,0,26,16,10,0,0
교육기관,교육부,논현유치원,교육부 인천광역시교육청 인천광역시동부교육지원청 논현유치원,18,9,9,9,0,9,0,0
교육기관,교육부,능허대중학교,교육부 인천광역시교육청 인천광역시동부교육지원청 능허대중학교,41,41,0,41,41,0,0,0
교육기관,교육부,동심유치원,교육부 인천광역시교육청 인천광역시동부교육지원청 동심유치원,16,16,0,16,0,16,0,0
교육기관,교육부,동인천중학교,교육부 인천광역시교육청 인천광역시동부교육지원청 동인천중학교,72,72,0,72,47,25,0,0
교육기관,교육부,동화나라유치원,교육부 인천광역시교육청 인천광역시동부교육지원청 동화나라유치원,16,16,0,16,0,16,0,0
교육기관,교육부,만성중학교,교육부 인천광역시교육청 인천광역시동부교육지원청 만성중학교,34,34,0,34,8,26,0,0
교육기관,교육부,만수북중학교,교육부 인천광역시교육청 인천광역시동부교육지원청 만수북중학교,40,40,0,40,0,40,0,0
교육기관,교육부,만수여자중학교,교육부 인천광역시교육청 인천광역시동부교육지원청 만수여자중학교,47,17,30,17,17,0,0,0
교육기관,교육부,만수중학교,교육부 인천광역시교육청 인천광역시동부교육지원청 만수중학교,48,48,0,48,0,48,0,0
교육기관,교육부,만월중학교,교육부 인천광역시교육청 인천광역시동부교육지원청 만월중학교,54,54,0,54,48,6,0,0
교육기관,교육부,미예뜰유치원,교육부 인천광역시교육청 인천광역시동부교육지원청 미예뜰유치원,30,4,26,4,1,1,1,1
교육기관,교육부,바다의별유치원,교육부 인천광역시교육청 인천광역시동부교육지원청 바다의별유치원,16,5,11,5,5,0,0,0
교육기관,교육부,박문중학교,교육부 인천광역시교육청 인천광역시동부교육지원청 박문중학교,62,62,0,62,32,30,0,0
교육기관,교육부,복자유치원,교육부 인천광역시교육청 인천광역시동부교육지원청 복자유치원,24,8,16,8,5,3,0,0
교육기관,교육부,부광예능유치원,교육부 인천광역시교육청 인천광역시동부교육지원청 부광예능유치원,7,0,7,0,0,0,0,0
교육기관,교육부,부광유치원,교육부 인천광역시교육청 인천광역시동부교육지원청 부광유치원,13,13,0,13,1,12,0,0
교육기관,교육부,사랑유치원,교육부 인천광역시교육청 인천광역시동부교육지원청 사랑유치원,19,4,15,4,0,4,0,0
교육기관,교육부,상인천여자중학교,교육부 인천광역시교육청 인천광역시동부교육지원청 상인천여자중학교,35,35,0,35,11,24,0,0
교육기관,교육부,상인천중학교,교육부 인천광역시교육청 인천광역시동부교육지원청 상인천중학교,33,33,0,33,2,31,0,0
교육기관,교육부,상인천초등학교,교육부 인천광역시교육청 인천광역시동부교육지원청 상인천초등학교,18,18,0,18,14,2,2,0
교육기관,교육부,새싹유치원,교육부 인천광역시교육청 인천광역시동부교육지원청 새싹유치원,16,0,16,0,0,0,0,0
교육기관,교육부,새예지유치원,교육부 인천광역시교육청 인천광역시동부교육지원청 새예지유치원,20,4,16,4,2,2,0,0
교육기관,교육부,새하늘유치원,교육부 인천광역시교육청 인천광역시동부교육지원청 새하늘유치원,12,12,0,12,11,1,0,0
교육기관,교육부,샤인유치원,교육부 인천광역시교육청 인천광역시동부교육지원청 샤인유치원,27,0,27,0,0,0,0,0
교육기관,교육부,석정중학교,교육부 인천광역시교육청 인천광역시동부교육지원청 석정중학교,35,16,19,16,6,5,4,1
교육기관,교육부,선학중학교,교육부 인천광역시교육청 인천광역시동부교육지원청 선학중학교,70,70,0,70,0,70,0,0
교육기관,교육부,소담숲유치원,교육부 인천광역시교육청 인천광역시동부교육지원청 소담숲유치원,24,24,0,24,7,15,1,1
교육기관,교육부,송도국제유치원,교육부 인천광역시교육청 인천광역시동부교육지원청 송도국제유치원,94,94,0,94,0,94,0,0
교육기관,교육부,수피아유치원,교육부 인천광역시교육청 인천광역시동부교육지원청 수피아유치원,49,0,49,0,0,0,0,0
교육기관,교육부,숭덕여자중학교,교육부 인천광역시교육청 인천광역시동부교육지원청 숭덕여자중학교,17,17,0,17,7,10,0,0
교육기관,교육부,신도유치원,교육부 인천광역시교육청 인천광역시동부교육지원청 신도유치원,11,11,0,11,1,8,1,1
교육기관,교육부,신송중학교,교육부 인천광역시교육청 인천광역시동부교육지원청 신송중학교,90,90,0,90,85,5,0,0
교육기관,교육부,아름솔유치원,교육부 인천광역시교육청 인천광역시동부교육지원청 아름솔유치원,18,7,11,7,0,7,0,0
교육기관,교육부,아삽유치원,교육부 인천광역시교육청 인천광역시동부교육지원청 아삽유치원,9,9,0,9,1,7,1,0
교육기관,교육부,에듀피아유치원,교육부 인천광역시교육청 인천광역시동부교육지원청 에듀피아유치원,39,5,34,5,5,0,0,0
교육기관,교육부,에이스화인유치원,교육부 인천광역시교육청 인천광역시동부교육지원청 에이스화인유치원,40,40,0,40,20,20,0,0
교육기관,교육부,연성중학교,교육부 인천광역시교육청 인천광역시동부교육지원청 연성중학교,46,46,0,46,20,26,0,0
교육기관,교육부,연수유치원,교육부 인천광역시교육청 인천광역시동부교육지원청 연수유치원,16,16,0,16,1,13,1,1
교육기관,교육부,연수중학교,교육부 인천광역시교육청 인천광역시동부교육지원청 연수중학교,37,37,0,37,21,12,4,0
교육기관,교육부,연화중학교,교육부 인천광역시교육청 인천광역시동부교육지원청 연화중학교,38,37,1,37,30,7,0,0
교육기관,교육부,옥련중학교,교육부 인천광역시교육청 인천광역시동부교육지원청 옥련중학교,60,60,0,60,44,16,0,0
교육기관,교육부,온누리비전유치원,교육부 인천광역시교육청 인천광역시동부교육지원청 온누리비전유치원,11,2,9,2,1,1,0,0
교육기관,교육부,인보유치원,교육부 인천광역시교육청 인천광역시동부교육지원청 인보유치원,6,6,0,6,0,6,0,0
교육기관,교육부,인송중학교,교육부 인천광역시교육청 인천광역시동부교육지원청 인송중학교,18,18,0,18,18,0,0,0
교육기관,교육부,인천간석초등학교,교육부 인천광역시교육청 인천광역시동부교육지원청 인천간석초등학교,19,19,0,19,19,0,0,0
교육기관,교육부,인천고잔유치원,교육부 인천광역시교육청 인천광역시동부교육지원청 인천고잔유치원,16,16,0,16,0,16,0,0
교육기관,교육부,인천고잔중학교,교육부 인천광역시교육청 인천광역시동부교육지원청 인천고잔중학교,40,40,0,40,35,5,0,0
교육기관,교육부,인천고잔초등학교,교육부 인천광역시교육청 인천광역시동부교육지원청 인천고잔초등학교,33,33,0,33,14,17,2,0
교육기관,교육부,인천구월서초등학교,교육부 인천광역시교육청 인천광역시동부교육지원청 인천구월서초등학교,26,26,0,26,26,0,0,0
교육기관,교육부,인천구월유치원,교육부 인천광역시교육청 인천광역시동부교육지원청 인천구월유치원,11,11,0,11,7,4,0,0
교육기관,교육부,인천구월초등학교,교육부 인천광역시교육청 인천광역시동부교육지원청 인천구월초등학교,27,27,0,27,27,0,0,0
교육기관,교육부,인천남동초등학교,교육부 인천광역시교육청 인천광역시동부교육지원청 인천남동초등학교,20,20,0,20,19,1,0,0
교육기관,교육부,인천남촌초등학교,교육부 인천광역시교육청 인천광역시동부교육지원청 인천남촌초등학교,23,23,0,23,13,10,0,0
교육기관,교육부,인천논곡초등학교,교육부 인천광역시교육청 인천광역시동부교육지원청 인천논곡초등학교,23,23,0,23,2,21,0,0
교육기관,교육부,인천논현중학교,교육부 인천광역시교육청 인천광역시동부교육지원청 인천논현중학교,34,34,0,34,34,0,0,0
교육기관,교육부,인천논현초등학교,교육부 인천광역시교육청 인천광역시동부교육지원청 인천논현초등학교,27,27,0,27,27,0,0,0
교육기관,교육부,인천능허대초등학교,교육부 인천광역시교육청 인천광역시동부교육지원청 인천능허대초등학교,20,20,0,20,20,0,0,0
교육기관,교육부,인천담방초등학교,교육부 인천광역시교육청 인천광역시동부교육지원청 인천담방초등학교,23,23,0,23,19,4,0,0
교육기관,교육부,인천도림초등학교,교육부 인천광역시교육청 인천광역시동부교육지원청 인천도림초등학교,12,12,0,12,12,0,0,0
교육기관,교육부,인천동막초등학교,교육부 인천광역시교육청 인천광역시동부교육지원청 인천동막초등학교,18,18,0,18,15,3,0,0
교육기관,교육부,인천동방중학교,교육부 인천광역시교육청 인천광역시동부교육지원청 인천동방중학교,39,37,2,37,10,27,0,0
교육기관,교육부,인천동방초등학교,교육부 인천광역시교육청 인천광역시동부교육지원청 인천동방초등학교,20,20,0,20,2,18,0,0
교육기관,교육부,인천동부초등학교,교육부 인천광역시교육청 인천광역시동부교육지원청 인천동부초등학교,20,20,0,20,10,10,0,0
교육기관,교육부,인천동춘초등학교,교육부 인천광역시교육청 인천광역시동부교육지원청 인천동춘초등학교,28,28,0,28,28,0,0,0
교육기관,교육부,인천만수북초등학교,교육부 인천광역시교육청 인천광역시동부교육지원청 인천만수북초등학교,24,24,0,24,0,24,0,0
교육기관,교육부,인천만수초등학교,교육부 인천광역시교육청 인천광역시동부교육지원청 인천만수초등학교,18,18,0,18,16,2,0,0
교육기관,교육부,인천만월초등학교,교육부 인천광역시교육청 인천광역시동부교육지원청 인천만월초등학교,44,44,0,44,44,0,0,0
교육기관,교육부,인천먼우금초등학교,교육부 인천광역시교육청 인천광역시동부교육지원청 인천먼우금초등학교,31,31,0,31,31,0,0,0
교육기관,교육부,인천명선초등학교,교육부 인천광역시교육청 인천광역시동부교육지원청 인천명선초등학교,33,33,0,33,33,0,0,0
교육기관,교육부,인천문남초등학교,교육부 인천광역시교육청 인천광역시동부교육지원청 인천문남초등학교,29,29,0,29,20,9,0,0
교육기관,교육부,인천미송유치원,교육부 인천광역시교육청 인천광역시동부교육지원청 인천미송유치원,32,32,0,32,20,12,0,0
교육기관,교육부,인천미송중학교,교육부 인천광역시교육청 인천광역시동부교육지원청 인천미송중학교,50,50,0,50,32,18,0,0
교육기관,교육부,인천미송초등학교,교육부 인천광역시교육청 인천광역시동부교육지원청 인천미송초등학교,35,35,0,35,25,10,0,0
교육기관,교육부,인천박문초등학교,교육부 인천광역시교육청 인천광역시동부교육지원청 인천박문초등학교,21,21,0,21,2,19,0,0
교육기관,교육부,인천사리울중학교,교육부 인천광역시교육청 인천광역시동부교육지원청 인천사리울중학교,51,51,0,51,51,0,0,0
교육기관,교육부,인천사리울초등학교,교육부 인천광역시교육청 인천광역시동부교육지원청 인천사리울초등학교,26,26,0,26,16,10,0,0
교육기관,교육부,인천상아초등학교,교육부 인천광역시교육청 인천광역시동부교육지원청 인천상아초등학교,20,20,0,20,4,16,0,0
교육기관,교육부,인천새말초등학교,교육부 인천광역시교육청 인천광역시동부교육지원청 인천새말초등학교,26,26,0,26,26,0,0,0
교육기관,교육부,인천새봄초등학교,교육부 인천광역시교육청 인천광역시동부교육지원청 인천새봄초등학교,42,42,0,42,0,42,0,0
교육기관,교육부,인천서면초등학교,교육부 인천광역시교육청 인천광역시동부교육지원청 인천서면초등학교,17,17,0,17,17,0,0,0
교육기관,교육부,인천서창중학교,교육부 인천광역시교육청 인천광역시동부교육지원청 인천서창중학교,39,39,0,39,27,12,0,0
교육기관,교육부,인천서창초등학교,교육부 인천광역시교육청 인천광역시동부교육지원청 인천서창초등학교,17,17,0,17,0,17,0,0
교육기관,교육부,인천석정초등학교,교육부 인천광역시교육청 인천광역시동부교육지원청 인천석정초등학교,22,22,0,22,0,22,0,0
교육기관,교육부,인천석천초등학교,교육부 인천광역시교육청 인천광역시동부교육지원청 인천석천초등학교,32,32,0,32,32,0,0,0
교육기관,교육부,인천선학초등학교,교육부 인천광역시교육청 인천광역시동부교육지원청 인천선학초등학교,26,26,0,26,16,10,0,0
교육기관,교육부,인천성리중학교,교육부 인천광역시교육청 인천광역시동부교육지원청 인천성리중학교,49,49,0,49,49,0,0,0
교육기관,교육부,인천성리초등학교,교육부 인천광역시교육청 인천광역시동부교육지원청 인천성리초등학교,27,27,0,27,27,0,0,0
교육기관,교육부,인천소래초등학교,교육부 인천광역시교육청 인천광역시동부교육지원청 인천소래초등학교,25,25,0,25,25,0,0,0
교육기관,교육부,인천송담초등학교,교육부 인천광역시교육청 인천광역시동부교육지원청 인천송담초등학교,44,44,0,44,28,10,2,4
교육기관,교육부,인천송도꿈유치원,교육부 인천광역시교육청 인천광역시동부교육지원청 인천송도꿈유치원,36,36,0,36,5,31,0,0
교육기관,교육부,인천송도초등학교,교육부 인천광역시교육청 인천광역시동부교육지원청 인천송도초등학교,25,25,0,25,10,15,0,0
교육기관,교육부,인천송명초등학교,교육부 인천광역시교육청 인천광역시동부교육지원청 인천송명초등학교,34,34,0,34,21,5,8,0
교육기관,교육부,인천송원초등학교,교육부 인천광역시교육청 인천광역시동부교육지원청 인천송원초등학교,22,22,0,22,19,3,0,0
교육기관,교육부,인천송일초등학교,교육부 인천광역시교육청 인천광역시동부교육지원청 인천송일초등학교,65,65,0,65,45,20,0,0
교육기관,교육부,인천송천초등학교,교육부 인천광역시교육청 인천광역시동부교육지원청 인천송천초등학교,17,17,0,17,17,0,0,0
교육기관,교육부,인천신송초등학교,교육부 인천광역시교육청 인천광역시동부교육지원청 인천신송초등학교,20,20,0,20,13,7,0,0
교육기관,교육부,인천신월초등학교,교육부 인천광역시교육청 인천광역시동부교육지원청 인천신월초등학교,24,24,0,24,24,0,0,0
교육기관,교육부,인천신월초등학교병설유치원,교육부 인천광역시교육청 인천광역시동부교육지원청 인천신월초등학교병설유치원,3,2,1,2,2,0,0,0
교육기관,교육부,인천신정중학교,교육부 인천광역시교육청 인천광역시동부교육지원청 인천신정중학교,76,76,0,76,0,76,0,0
교육기관,교육부,인천신정초등학교,교육부 인천광역시교육청 인천광역시동부교육지원청 인천신정초등학교,46,46,0,46,38,8,0,0
교육기관,교육부,인천약산초등학교,교육부 인천광역시교육청 인천광역시동부교육지원청 인천약산초등학교,35,35,0,35,35,0,0,0
교육기관,교육부,인천여자중학교,교육부 인천광역시교육청 인천광역시동부교육지원청 인천여자중학교,62,62,0,62,0,62,0,0
교육기관,교육부,인천연성초등학교,교육부 인천광역시교육청 인천광역시동부교육지원청 인천연성초등학교,20,20,0,20,20,0,0,0
교육기관,교육부,인천연송초등학교,교육부 인천광역시교육청 인천광역시동부교육지원청 인천연송초등학교,27,27,0,27,27,0,0,0
교육기관,교육부,인천연수초등학교,교육부 인천광역시교육청 인천광역시동부교육지원청 인천연수초등학교,16,16,0,16,10,6,0,0
교육기관,교육부,인천연화초등학교,교육부 인천광역시교육청 인천광역시동부교육지원청 인천연화초등학교,22,22,0,22,22,0,0,0
교육기관,교육부,인천예송유치원,교육부 인천광역시교육청 인천광역시동부교육지원청 인천예송유치원,30,30,0,30,12,18,0,0
교육기관,교육부,인천예송중학교,교육부 인천광역시교육청 인천광역시동부교육지원청 인천예송중학교,88,88,0,88,0,88,0,0
교육기관,교육부,인천예송초등학교,교육부 인천광역시교육청 인천광역시동부교육지원청 인천예송초등학교,30,26,4,26,13,13,0,0
교육기관,교육부,인천옥련초등학교,교육부 인천광역시교육청 인천광역시동부교육지원청 인천옥련초등학교,23,23,0,23,21,2,0,0
교육기관,교육부,인천원동초등학교,교육부 인천광역시교육청 인천광역시동부교육지원청 인천원동초등학교,19,19,0,19,0,19,0,0
교육기관,교육부,인천은봉초등학교,교육부 인천광역시교육청 인천광역시동부교육지원청 인천은봉초등학교,27,27,0,27,27,0,0,0
교육기관,교육부,인천은송초등학교,교육부 인천광역시교육청 인천광역시동부교육지원청 인천은송초등학교,28,28,0,28,14,14,0,0
교육기관,교육부,인천인동초등학교,교육부 인천광역시교육청 인천광역시동부교육지원청 인천인동초등학교,23,23,0,23,0,23,0,0
교육기관,교육부,인천인수초등학교,교육부 인천광역시교육청 인천광역시동부교육지원청 인천인수초등학교,17,17,0,17,0,17,0,0
교육기관,교육부,인천장도초등학교,교육부 인천광역시교육청 인천광역시동부교육지원청 인천장도초등학교,16,16,0,16,6,4,4,2
교육기관,교육부,인천장서초등학교,교육부 인천광역시교육청 인천광역시동부교육지원청 인천장서초등학교,47,47,0,47,11,36,0,0
교육기관,교육부,인천장수초등학교,교육부 인천광역시교육청 인천광역시동부교육지원청 인천장수초등학교,31,31,0,31,31,0,0,0
교육기관,교육부,인천장아초등학교,교육부 인천광역시교육청 인천광역시동부교육지원청 인천장아초등학교,41,41,0,41,41,0,0,0
교육기관,교육부,인천장아초등학교병설유치원,교육부 인천광역시교육청 인천광역시동부교육지원청 인천장아초등학교병설유치원,7,2,5,2,0,2,0,0
교육기관,교육부,인천정각중학교,교육부 인천광역시교육청 인천광역시동부교육지원청 인천정각중학교,34,34,0,34,26,8,0,0
교육기관,교육부,인천정각초등학교,교육부 인천광역시교육청 인천광역시동부교육지원청 인천정각초등학교,27,27,0,27,17,10,0,0
교육기관,교육부,인천조동초등학교,교육부 인천광역시교육청 인천광역시동부교육지원청 인천조동초등학교,19,19,0,19,0,19,0,0
교육기관,교육부,인천주원초등학교,교육부 인천광역시교육청 인천광역시동부교육지원청 인천주원초등학교,20,20,0,20,0,20,0,0
교육기관,교육부,인천중앙초등학교,교육부 인천광역시교육청 인천광역시동부교육지원청 인천중앙초등학교,22,22,0,22,22,0,0,0
교육기관,교육부,인천중학교,교육부 인천광역시교육청 인천광역시동부교육지원청 인천중학교,31,31,0,31,31,0,0,0
교육기관,교육부,인천첨단초등학교,교육부 인천광역시교육청 인천광역시동부교육지원청 인천첨단초등학교,34,34,0,34,9,25,0,0
교육기관,교육부,인천청량초등학교,교육부 인천광역시교육청 인천광역시동부교육지원청 인천청량초등학교,18,18,0,18,10,8,0,0
교육기관,교육부,인천청학초등학교,교육부 인천광역시교육청 인천광역시동부교육지원청 인천청학초등학교,23,23,0,23,20,3,0,0
교육기관,교육부,인천축현초등학교,교육부 인천광역시교육청 인천광역시동부교육지원청 인천축현초등학교,23,23,0,23,23,0,0,0
교육기관,교육부,인천한빛초등학교,교육부 인천광역시교육청 인천광역시동부교육지원청 인천한빛초등학교,37,37,0,37,37,0,0,0
교육기관,교육부,인천함박초등학교,교육부 인천광역시교육청 인천광역시동부교육지원청 인천함박초등학교,20,20,0,20,20,0,0,0
교육기관,교육부,인천해송중학교,교육부 인천광역시교육청 인천광역시동부교육지원청 인천해송중학교,42,42,0,42,30,12,0,0
교육기관,교육부,인천해송초등학교,교육부 인천광역시교육청 인천광역시동부교육지원청 인천해송초등학교,24,24,0,24,18,6,0,0
교육기관,교육부,인천현송중학교,교육부 인천광역시교육청 인천광역시동부교육지원청 인천현송중학교,53,53,0,53,2,51,0,0
교육기관,교육부,인천현송초등학교,교육부 인천광역시교육청 인천광역시동부교육지원청 인천현송초등학교,42,42,0,42,25,17,0,0
교육기관,교육부,자연발도르프유치원,교육부 인천광역시교육청 인천광역시동부교육지원청 자연발도르프유치원,16,16,0,16,1,13,1,1
교육기관,교육부,조은유치원,교육부 인천광역시교육청 인천광역시동부교육지원청 조은유치원,16,16,0,16,4,12,0,0
교육기관,교육부,참조은유치원,교육부 인천광역시교육청 인천광역시동부교육지원청 참조은유치원,29,0,29,0,0,0,0,0
교육기관,교육부,청량중학교,교육부 인천광역시교육청 인천광역시동부교육지원청 청량중학교,47,47,0,47,35,12,0,0
교육기관,교육부,청학숲유치원,교육부 인천광역시교육청 인천광역시동부교육지원청 청학숲유치원,58,5,53,5,2,1,1,1
교육기관,교육부,청학중학교,교육부 인천광역시교육청 인천광역시동부교육지원청 청학중학교,59,17,42,17,10,7,0,0
교육기관,교육부,키즈월드유치원,교육부 인천광역시교육청 인천광역시동부교육지원청 키즈월드유치원,6,6,0,6,0,6,0,0
교육기관,교육부,푸른마을유치원,교육부 인천광역시교육청 인천광역시동부교육지원청 푸른마을유치원,16,16,0,16,2,14,0,0
교육기관,교육부,프라임예지유치원,교육부 인천광역시교육청 인천광역시동부교육지원청 프라임예지유치원,5,3,2,3,0,3,0,0
교육기관,교육부,하늘땅유치원,교육부 인천광역시교육청 인천광역시동부교육지원청 하늘땅유치원,30,30,0,30,0,30,0,0
교육기관,교육부,함박중학교,교육부 인천광역시교육청 인천광역시동부교육지원청 함박중학교,49,47,2,47,25,22,0,0
교육기관,교육부,해나라유치원,교육부 인천광역시교육청 인천광역시동부교육지원청 해나라유치원,12,12,0,12,2,10,0,0
교육기관,교육부,해돋이유치원,교육부 인천광역시교육청 인천광역시동부교육지원청 해돋이유치원,7,2,5,2,2,0,0,0
교육기관,교육부,해승유치원,교육부 인천광역시교육청 인천광역시동부교육지원청 해승유치원,18,18,0,18,0,18,0,0
교육기관,교육부,해와달유치원,교육부 인천광역시교육청 인천광역시동부교육지원청 해와달유치원,32,4,28,4,0,4,0,0
교육기관,교육부,행복한유치원,교육부 인천광역시교육청 인천광역시동부교육지원청 행복한유치원,18,3,15,3,1,2,0,0
교육기관,교육부,인천광역시북부교육지원청,교육부 인천광역시교육청 인천광역시북부교육지원청,15,15,0,15,7,8,0,0
교육기관,교육부,갈산중학교,교육부 인천광역시교육청 인천광역시북부교육지원청 갈산중학교,26,26,0,26,0,26,0,0
교육기관,교육부,구산중학교,교육부 인천광역시교육청 인천광역시북부교육지원청 구산중학교,42,42,0,42,0,42,0,0
교육기관,교육부,근산유치원,교육부 인천광역시교육청 인천광역시북부교육지원청 근산유치원,40,40,0,40,20,20,0,0
교육기관,교육부,꿈나라유치원,교육부 인천광역시교육청 인천광역시북부교육지원청 꿈나라유치원,11,11,0,11,0,11,0,0
교육기관,교육부,꿈나무유치원,교육부 인천광역시교육청 인천광역시북부교육지원청 꿈나무유치원,8,0,8,0,0,0,0,0
교육기관,교육부,동암중학교,교육부 인천광역시교육청 인천광역시북부교육지원청 동암중학교,25,25,0,25,21,4,0,0
교육기관,교육부,부광중학교,교육부 인천광역시교육청 인천광역시북부교육지원청 부광중학교,32,32,0,32,8,20,4,0
교육기관,교육부,부원여자중학교,교육부 인천광역시교육청 인천광역시북부교육지원청 부원여자중학교,32,29,3,29,7,22,0,0
교육기관,교육부,부원중학교,교육부 인천광역시교육청 인천광역시북부교육지원청 부원중학교,44,44,0,44,40,2,1,1
교육기관,교육부,부일여자중학교,교육부 인천광역시교육청 인천광역시북부교육지원청 부일여자중학교,15,15,0,15,5,10,0,0
교육기관,교육부,부일중학교,교육부 인천광역시교육청 인천광역시북부교육지원청 부일중학교,40,40,0,40,0,40,0,0
교육기관,교육부,부평동중학교,교육부 인천광역시교육청 인천광역시북부교육지원청 부평동중학교,45,45,0,45,45,0,0,0
교육기관,교육부,부평서여자중학교,교육부 인천광역시교육청 인천광역시북부교육지원청 부평서여자중학교,34,34,0,34,30,3,1,0
교육기관,교육부,부평서중학교,교육부 인천광역시교육청 인천광역시북부교육지원청 부평서중학교,45,45,0,45,45,0,0,0
교육기관,교육부,부평여자중학교,교육부 인천광역시교육청 인천광역시북부교육지원청 부평여자중학교,19,19,0,19,19,0,0,0
교육기관,교육부,부평중학교,교육부 인천광역시교육청 인천광역시북부교육지원청 부평중학교,40,40,0,40,40,0,0,0
교육기관,교육부,부흥중학교,교육부 인천광역시교육청 인천광역시북부교육지원청 부흥중학교,37,35,2,35,15,20,0,0
교육기관,교육부,산곡남중학교,교육부 인천광역시교육청 인천광역시북부교육지원청 산곡남중학교,31,30,1,30,12,18,0,0
교육기관,교육부,산곡여자중학교,교육부 인천광역시교육청 인천광역시북부교육지원청 산곡여자중학교,21,21,0,21,0,21,0,0
교육기관,교육부,산곡유치원,교육부 인천광역시교육청 인천광역시북부교육지원청 산곡유치원,18,18,0,18,0,18,0,0
교육기관,교육부,산곡중학교,교육부 인천광역시교육청 인천광역시북부교육지원청 산곡중학교,15,15,0,15,15,0,0,0
교육기관,교육부,삼산유치원,교육부 인천광역시교육청 인천광역시북부교육지원청 삼산유치원,14,14,0,14,10,4,0,0
교육기관,교육부,삼산중학교,교육부 인천광역시교육청 인천광역시북부교육지원청 삼산중학교,42,42,0,42,0,42,0,0
교육기관,교육부,새빛솔금유치원,교육부 인천광역시교육청 인천광역시북부교육지원청 새빛솔금유치원,16,16,0,16,0,16,0,0
교육기관,교육부,성심유치원,교육부 인천광역시교육청 인천광역시북부교육지원청 성심유치원,16,2,14,2,1,1,0,0
교육기관,교육부,숲속유치원,교육부 인천광역시교육청 인천광역시북부교육지원청 숲속유치원,13,13,0,13,7,6,0,0
교육기관,교육부,예원유치원,교육부 인천광역시교육청 인천광역시북부교육지원청 예원유치원,24,3,21,3,1,2,0,0
교육기관,교육부,은현유치원,교육부 인천광역시교육청 인천광역시북부교육지원청 은현유치원,14,4,10,4,4,0,0,0
교육기관,교육부,이든유치원,교육부 인천광역시교육청 인천광역시북부교육지원청 이든유치원,16,3,13,3,1,1,0,1
교육기관,교육부,이바유치원,교육부 인천광역시교육청 인천광역시북부교육지원청 이바유치원,14,14,0,14,0,14,0,0
교육기관,교육부,인천갈산초등학교,교육부 인천광역시교육청 인천광역시북부교육지원청 인천갈산초등학교,16,16,0,16,16,0,0,0
교육기관,교육부,인천갈월초등학교,교육부 인천광역시교육청 인천광역시북부교육지원청 인천갈월초등학교,23,23,0,23,23,0,0,0
교육기관,교육부,인천개흥초등학교,교육부 인천광역시교육청 인천광역시북부교육지원청 인천개흥초등학교,21,21,0,21,14,7,0,0
교육기관,교육부,인천구산초등학교,교육부 인천광역시교육청 인천광역시북부교육지원청 인천구산초등학교,16,16,0,16,0,16,0,0
교육기관,교육부,인천굴포초등학교,교육부 인천광역시교육청 인천광역시북부교육지원청 인천굴포초등학교,23,23,0,23,12,11,0,0
교육기관,교육부,인천금마초등학교,교육부 인천광역시교육청 인천광역시북부교육지원청 인천금마초등학교,15,15,0,15,0,15,0,0
교육기관,교육부,인천대정초등학교,교육부 인천광역시교육청 인천광역시북부교육지원청 인천대정초등학교,24,24,0,24,22,0,0,2
교육기관,교육부,인천동수초등학교,교육부 인천광역시교육청 인천광역시북부교육지원청 인천동수초등학교,25,25,0,25,0,25,0,0
교육기관,교육부,인천동암초등학교,교육부 인천광역시교육청 인천광역시북부교육지원청 인천동암초등학교,32,32,0,32,10,22,0,0
교육기관,교육부,인천마곡초등학교,교육부 인천광역시교육청 인천광역시북부교육지원청 인천마곡초등학교,18,18,0,18,18,0,0,0
교육기관,교육부,인천마장초등학교,교육부 인천광역시교육청 인천광역시북부교육지원청 인천마장초등학교,29,29,0,29,12,17,0,0
교육기관,교육부,인천미산초등학교,교육부 인천광역시교육청 인천광역시북부교육지원청 인천미산초등학교,18,18,0,18,9,9,0,0
교육기관,교육부,인천백운초등학교,교육부 인천광역시교육청 인천광역시북부교육지원청 인천백운초등학교,15,15,0,15,11,4,0,0
교육기관,교육부,인천부개서초등학교,교육부 인천광역시교육청 인천광역시북부교육지원청 인천부개서초등학교,21,21,0,21,17,4,0,0
교육기관,교육부,인천부개초등학교,교육부 인천광역시교육청 인천광역시북부교육지원청 인천부개초등학교,33,33,0,33,14,11,8,0
교육기관,교육부,인천부곡초등학교,교육부 인천광역시교육청 인천광역시북부교육지원청 인천부곡초등학교,10,10,0,10,10,0,0,0
교육기관,교육부,인천부광초등학교,교육부 인천광역시교육청 인천광역시북부교육지원청 인천부광초등학교,21,21,0,21,13,2,5,1
교육기관,교육부,인천부내초등학교,교육부 인천광역시교육청 인천광역시북부교육지원청 인천부내초등학교,29,29,0,29,7,22,0,0
교육기관,교육부,인천부마초등학교,교육부 인천광역시교육청 인천광역시북부교육지원청 인천부마초등학교,23,23,0,23,23,0,0,0
교육기관,교육부,인천부원초등학교,교육부 인천광역시교육청 인천광역시북부교육지원청 인천부원초등학교,23,23,0,23,0,23,0,0
교육기관,교육부,인천부일초등학교,교육부 인천광역시교육청 인천광역시북부교육지원청 인천부일초등학교,31,31,0,31,9,16,4,2
교육기관,교육부,인천부평남초등학교,교육부 인천광역시교육청 인천광역시북부교육지원청 인천부평남초등학교,24,4,20,4,2,1,1,0
교육기관,교육부,인천부평동초등학교,교육부 인천광역시교육청 인천광역시북부교육지원청 인천부평동초등학교,24,24,0,24,24,0,0,0
교육기관,교육부,인천부평북초등학교,교육부 인천광역시교육청 인천광역시북부교육지원청 인천부평북초등학교,15,15,0,15,12,3,0,0
교육기관,교육부,인천부평서초등학교,교육부 인천광역시교육청 인천광역시북부교육지원청 인천부평서초등학교,12,12,0,12,5,7,0,0
교육기관,교육부,인천부흥초등학교,교육부 인천광역시교육청 인천광역시북부교육지원청 인천부흥초등학교,24,24,0,24,4,20,0,0
교육기관,교육부,인천산곡남초등학교,교육부 인천광역시교육청 인천광역시북부교육지원청 인천산곡남초등학교,24,24,0,24,23,1,0,0
교육기관,교육부,인천산곡북초등학교,교육부 인천광역시교육청 인천광역시북부교육지원청 인천산곡북초등학교,22,22,0,22,22,0,0,0
교육기관,교육부,인천삼산초등학교,교육부 인천광역시교육청 인천광역시북부교육지원청 인천삼산초등학교,24,24,0,24,24,0,0,0
교육기관,교육부,인천상정중학교,교육부 인천광역시교육청 인천광역시북부교육지원청 인천상정중학교,26,24,2,24,21,3,0,0
교육기관,교육부,인천상정초등학교,교육부 인천광역시교육청 인천광역시북부교육지원청 인천상정초등학교,31,31,0,31,0,31,0,0
교육기관,교육부,인천신촌초등학교,교육부 인천광역시교육청 인천광역시북부교육지원청 인천신촌초등학교,11,11,0,11,11,0,0,0
교육기관,교육부,인천십정초등학교,교육부 인천광역시교육청 인천광역시북부교육지원청 인천십정초등학교,20,20,0,20,13,7,0,0
교육기관,교육부,인천영선초등학교,교육부 인천광역시교육청 인천광역시북부교육지원청 인천영선초등학교,19,19,0,19,19,0,0,0
교육기관,교육부,인천용마초등학교,교육부 인천광역시교육청 인천광역시북부교육지원청 인천용마초등학교,17,17,0,17,0,17,0,0
교육기관,교육부,인천일신초등학교,교육부 인천광역시교육청 인천광역시북부교육지원청 인천일신초등학교,18,18,0,18,13,5,0,0
교육기관,교육부,인천진산초등학교,교육부 인천광역시교육청 인천광역시북부교육지원청 인천진산초등학교,24,24,0,24,24,0,0,0
교육기관,교육부,인천청천초등학교,교육부 인천광역시교육청 인천광역시북부교육지원청 인천청천초등학교,11,11,0,11,8,3,0,0
교육기관,교육부,인천하정초등학교,교육부 인천광역시교육청 인천광역시북부교육지원청 인천하정초등학교,19,19,0,19,19,0,0,0
교육기관,교육부,인천한길초등학교,교육부 인천광역시교육청 인천광역시북부교육지원청 인천한길초등학교,23,23,0,23,23,0,0,0
교육기관,교육부,인천후정초등학교,교육부 인천광역시교육청 인천광역시북부교육지원청 인천후정초등학교,26,26,0,26,13,13,0,0
교육기관,교육부,인천후정초등학교병설유치원,교육부 인천광역시교육청 인천광역시북부교육지원청 인천후정초등학교병설유치원,2,2,0,2,1,1,0,0
교육기관,교육부,진산중학교,교육부 인천광역시교육청 인천광역시북부교육지원청 진산중학교,49,49,0,49,35,14,0,0
교육기관,교육부,청송유치원,교육부 인천광역시교육청 인천광역시북부교육지원청 청송유치원,7,7,0,7,3,2,1,1
교육기관,교육부,청원유치원,교육부 인천광역시교육청 인천광역시북부교육지원청 청원유치원,21,5,16,5,3,2,0,0
교육기관,교육부,청천중학교,교육부 인천광역시교육청 인천광역시북부교육지원청 청천중학교,29,29,0,29,10,19,0,0
교육기관,교육부,프렌즈유치원,교육부 인천광역시교육청 인천광역시북부교육지원청 프렌즈유치원,12,12,0,12,0,12,0,0
교육기관,교육부,한빛유치원,교육부 인천광역시교육청 인천광역시북부교육지원청 한빛유치원,16,3,13,3,3,0,0,0
교육기관,교육부,한일초등학교,교육부 인천광역시교육청 인천광역시북부교육지원청 한일초등학교,18,18,0,18,0,18,0,0
교육기관,교육부,해마루유치원,교육부 인천광역시교육청 인천광역시북부교육지원청 해마루유치원,22,0,22,0,0,0,0,0
교육기관,교육부,햇살유치원,교육부 인천광역시교육청 인천광역시북부교육지원청 햇살유치원,7,7,0,7,0,7,0,0
교육기관,교육부,홍익유치원,교육부 인천광역시교육청 인천광역시북부교육지원청 홍익유치원,12,12,0,12,12,0,0,0
교육기관,교육부,인천광역시서부교육지원청,교육부 인천광역시교육청 인천광역시서부교육지원청,20,20,0,20,0,20,0,0
교육기관,교육부,가정여자중학교,교육부 인천광역시교육청 인천광역시서부교육지원청 가정여자중학교,27,27,0,27,25,2,0,0
교육기관,교육부,가좌중학교,교육부 인천광역시교육청 인천광역시서부교육지원청 가좌중학교,31,31,0,31,9,22,0,0
교육기관,교육부,검단중학교,교육부 인천광역시교육청 인천광역시서부교육지원청 검단중학교,45,45,0,45,45,0,0,0
교육기관,교육부,검암중학교,교육부 인천광역시교육청 인천광역시서부교육지원청 검암중학교,33,33,0,33,5,28,0,0
교육기관,교육부,경서유치원,교육부 인천광역시교육청 인천광역시서부교육지원청 경서유치원,16,16,0,16,0,16,0,0
교육기관,교육부,경인무지개유치원,교육부 인천광역시교육청 인천광역시서부교육지원청 경인무지개유치원,8,1,7,1,0,1,0,0
교육기관,교육부,경인여자대학교부속유치원,교육부 인천광역시교육청 인천광역시서부교육지원청 경인여자대학교부속유치원,19,2,17,2,1,1,0,0
교육기관,교육부,계산여자중학교,교육부 인천광역시교육청 인천광역시서부교육지원청 계산여자중학교,34,34,0,34,25,8,1,0
교육기관,교육부,계산중학교,교육부 인천광역시교육청 인천광역시서부교육지원청 계산중학교,13,13,0,13,13,0,0,0
교육기관,교육부,계양유치원,교육부 인천광역시교육청 인천광역시서부교육지원청 계양유치원,15,3,12,3,0,3,0,0
교육기관,교육부,계양중학교,교육부 인천광역시교육청 인천광역시서부교육지원청 계양중학교,46,46,0,46,46,0,0,0
교육기관,교육부,노틀담유치원,교육부 인천광역시교육청 인천광역시서부교육지원청 노틀담유치원,15,6,9,6,3,3,0,0
교육기관,교육부,다은유치원,교육부 인천광역시교육청 인천광역시서부교육지원청 다은유치원,32,32,0,32,0,32,0,0
교육기관,교육부,동인천여자중학교,교육부 인천광역시교육청 인천광역시서부교육지원청 동인천여자중학교,39,39,0,39,2,37,0,0
교육기관,교육부,드림유치원,교육부 인천광역시교육청 인천광역시서부교육지원청 드림유치원,28,1,27,1,0,1,0,0
교육기관,교육부,리라유치원,교육부 인천광역시교육청 인천광역시서부교육지원청 리라유치원,45,45,0,45,0,45,0,0
교육기관,교육부,명문유치원,교육부 인천광역시교육청 인천광역시서부교육지원청 명문유치원,12,12,0,12,4,4,2,2
교육기관,교육부,명현중학교,교육부 인천광역시교육청 인천광역시서부교육지원청 명현중학교,32,0,32,0,0,0,0,0
교육기관,교육부,무지개유치원,교육부 인천광역시교육청 인천광역시서부교육지원청 무지개유치원,20,20,0,20,1,17,1,1
교육기관,교육부,백석중학교,교육부 인천광역시교육청 인천광역시서부교육지원청 백석중학교,34,34,0,34,17,17,0,0
교육기관,교육부,보나유치원,교육부 인천광역시교육청 인천광역시서부교육지원청 보나유치원,33,33,0,33,5,28,0,0
교육기관,교육부,보람유치원,교육부 인천광역시교육청 인천광역시서부교육지원청 보람유치원,16,16,0,16,1,15,0,0
교육기관,교육부,북인천여자중학교,교육부 인천광역시교육청 인천광역시서부교육지원청 북인천여자중학교,37,37,0,37,18,18,1,0
교육기관,교육부,북인천중학교,교육부 인천광역시교육청 인천광역시서부교육지원청 북인천중학교,27,25,2,25,18,3,4,0
교육기관,교육부,불로중학교,교육부 인천광역시교육청 인천광역시서부교육지원청 불로중학교,37,37,0,37,37,0,0,0
교육기관,교육부,뿌리유치원,교육부 인천광역시교육청 인천광역시서부교육지원청 뿌리유치원,12,2,10,2,1,1,0,0
교육기관,교육부,사랑나무유치원,교육부 인천광역시교육청 인천광역시서부교육지원청 사랑나무유치원,15,3,12,3,1,2,0,0
교육기관,교육부,산새소리유치원,교육부 인천광역시교육청 인천광역시서부교육지원청 산새소리유치원,24,0,24,0,0,0,0,0
교육기관,교육부,산울림유치원,교육부 인천광역시교육청 인천광역시서부교육지원청 산울림유치원,5,2,3,2,1,1,0,0
교육기관,교육부,상아유치원,교육부 인천광역시교육청 인천광역시서부교육지원청 상아유치원,14,2,12,2,1,1,0,0
교육기관,교육부,새한신유치원,교육부 인천광역시교육청 인천광역시서부교육지원청 새한신유치원,15,15,0,15,0,15,0,0
교육기관,교육부,서곶중학교,교육부 인천광역시교육청 인천광역시서부교육지원청 서곶중학교,36,36,0,36,18,10,8,0
교육기관,교육부,서운중학교,교육부 인천광역시교육청 인천광역시서부교육지원청 서운중학교,32,32,0,32,32,0,0,0
교육기관,교육부,석화유치원,교육부 인천광역시교육청 인천광역시서부교육지원청 석화유치원,14,14,0,14,2,12,0,0
교육기관,교육부,세라유치원,교육부 인천광역시교육청 인천광역시서부교육지원청 세라유치원,23,23,0,23,3,20,0,0
교육기관,교육부,신현여자중학교,교육부 인천광역시교육청 인천광역시서부교육지원청 신현여자중학교,36,36,0,36,36,0,0,0
교육기관,교육부,신현중학교,교육부 인천광역시교육청 인천광역시서부교육지원청 신현중학교,34,34,0,34,34,0,0,0
교육기관,교육부,아이사랑유치원,교육부 인천광역시교육청 인천광역시서부교육지원청 아이사랑유치원,21,0,21,0,0,0,0,0
교육기관,교육부,엔젤유치원,교육부 인천광역시교육청 인천광역시서부교육지원청 엔젤유치원,12,5,7,5,2,3,0,0
교육기관,교육부,영광유치원,교육부 인천광역시교육청 인천광역시서부교육지원청 영광유치원,19,19,0,19,5,14,0,0
교육기관,교육부,예그랑유치원,교육부 인천광역시교육청 인천광역시서부교육지원청 예그랑유치원,8,8,0,8,2,6,0,0
교육기관,교육부,예림유치원,교육부 인천광역시교육청 인천광역시서부교육지원청 예림유치원,8,0,8,0,0,0,0,0
교육기관,교육부,예빛유치원,교육부 인천광역시교육청 인천광역시서부교육지원청 예빛유치원,16,16,0,16,16,0,0,0
교육기관,교육부,예인유치원,교육부 인천광역시교육청 인천광역시서부교육지원청 예인유치원,26,26,0,26,2,23,1,0
교육기관,교육부,원당중학교,교육부 인천광역시교육청 인천광역시서부교육지원청 원당중학교,63,62,1,62,31,31,0,0
교육기관,교육부,인천가림초등학교,교육부 인천광역시교육청 인천광역시서부교육지원청 인천가림초등학교,26,26,0,26,26,0,0,0
교육기관,교육부,인천가석초등학교,교육부 인천광역시교육청 인천광역시서부교육지원청 인천가석초등학교,34,34,0,34,34,0,0,0
교육기관,교육부,인천가원초등학교,교육부 인천광역시교육청 인천광역시서부교육지원청 인천가원초등학교,38,38,0,38,38,0,0,0
교육기관,교육부,인천가정초등학교,교육부 인천광역시교육청 인천광역시서부교육지원청 인천가정초등학교,28,28,0,28,13,15,0,0
교육기관,교육부,인천가좌여자중학교,교육부 인천광역시교육청 인천광역시서부교육지원청 인천가좌여자중학교,40,40,0,40,0,40,0,0
교육기관,교육부,인천가좌초등학교,교육부 인천광역시교육청 인천광역시서부교육지원청 인천가좌초등학교,17,17,0,17,7,7,2,1
교육기관,교육부,인천가현중학교,교육부 인천광역시교육청 인천광역시서부교육지원청 인천가현중학교,39,39,0,39,0,39,0,0
교육기관,교육부,인천가현초등학교,교육부 인천광역시교육청 인천광역시서부교육지원청 인천가현초등학교,32,32,0,32,20,12,0,0
교육기관,교육부,인천간재울초등학교,교육부 인천광역시교육청 인천광역시서부교육지원청 인천간재울초등학교,33,33,0,33,0,33,0,0
교육기관,교육부,인천건지초등학교,교육부 인천광역시교육청 인천광역시서부교육지원청 인천건지초등학교,18,18,0,18,6,12,0,0
교육기관,교육부,인천검단초등학교,교육부 인천광역시교육청 인천광역시서부교육지원청 인천검단초등학교,32,32,0,32,0,32,0,0
교육기관,교육부,인천검암초등학교,교육부 인천광역시교육청 인천광역시서부교육지원청 인천검암초등학교,23,23,0,23,23,0,0,0
교육기관,교육부,인천경명초등학교,교육부 인천광역시교육청 인천광역시서부교육지원청 인천경명초등학교,38,36,2,36,20,16,0,0
교육기관,교육부,인천경서초등학교,교육부 인천광역시교육청 인천광역시서부교육지원청 인천경서초등학교,19,19,0,19,11,8,0,0
교육기관,교육부,인천경연중학교,교육부 인천광역시교육청 인천광역시서부교육지원청 인천경연중학교,27,27,0,27,27,0,0,0
교육기관,교육부,인천경연초등학교,교육부 인천광역시교육청 인천광역시서부교육지원청 인천경연초등학교,34,34,0,34,34,0,0,0
교육기관,교육부,인천계산초등학교,교육부 인천광역시교육청 인천광역시서부교육지원청 인천계산초등학교,23,23,0,23,18,5,0,0
교육기관,교육부,인천계수중학교,교육부 인천광역시교육청 인천광역시서부교육지원청 인천계수중학교,44,9,35,9,9,0,0,0
교육기관,교육부,인천계양초등학교,교육부 인천광역시교육청 인천광역시서부교육지원청 인천계양초등학교,30,30,0,30,3,27,0,0
교육기관,교육부,인천공촌초등학교,교육부 인천광역시교육청 인천광역시서부교육지원청 인천공촌초등학교,32,32,0,32,32,0,0,0
교육기관,교육부,인천귤현초등학교,교육부 인천광역시교육청 인천광역시서부교육지원청 인천귤현초등학교,15,15,0,15,0,15,0,0
교육기관,교육부,인천금곡초등학교,교육부 인천광역시교육청 인천광역시서부교육지원청 인천금곡초등학교,23,23,0,23,23,0,0,0
교육기관,교육부,인천길주초등학교,교육부 인천광역시교육청 인천광역시서부교육지원청 인천길주초등학교,18,18,0,18,14,4,0,0
교육기관,교육부,인천능내초등학교,교육부 인천광역시교육청 인천광역시서부교육지원청 인천능내초등학교,16,16,0,16,7,9,0,0
교육기관,교육부,인천단봉초등학교,교육부 인천광역시교육청 인천광역시서부교육지원청 인천단봉초등학교,35,35,0,35,0,35,0,0
교육기관,교육부,인천당산초등학교,교육부 인천광역시교육청 인천광역시서부교육지원청 인천당산초등학교,28,28,0,28,0,28,0,0
교육기관,교육부,인천당하중학교,교육부 인천광역시교육청 인천광역시서부교육지원청 인천당하중학교,51,14,37,14,14,0,0,0
교육기관,교육부,인천당하초등학교,교육부 인천광역시교육청 인천광역시서부교육지원청 인천당하초등학교,16,16,0,16,4,12,0,0
교육기관,교육부,인천도담초등학교,교육부 인천광역시교육청 인천광역시서부교육지원청 인천도담초등학교,31,31,0,31,16,15,0,0
교육기관,교육부,인천동양중학교,교육부 인천광역시교육청 인천광역시서부교육지원청 인천동양중학교,36,34,2,34,34,0,0,0
교육기관,교육부,인천마전초등학교,교육부 인천광역시교육청 인천광역시서부교육지원청 인천마전초등학교,23,23,0,23,23,0,0,0
교육기관,교육부,인천명현초등학교,교육부 인천광역시교육청 인천광역시서부교육지원청 인천명현초등학교,23,23,0,23,22,1,0,0
교육기관,교육부,인천발산초등학교,교육부 인천광역시교육청 인천광역시서부교육지원청 인천발산초등학교,16,16,0,16,0,16,0,0
교육기관,교육부,인천백석초등학교,교육부 인천광역시교육청 인천광역시서부교육지원청 인천백석초등학교,32,31,1,31,15,16,0,0
교육기관,교육부,인천병방초등학교,교육부 인천광역시교육청 인천광역시서부교육지원청 인천병방초등학교,27,27,0,27,27,0,0,0
교육기관,교육부,인천봉수초등학교,교육부 인천광역시교육청 인천광역시서부교육지원청 인천봉수초등학교,22,22,0,22,0,22,0,0
교육기관,교육부,인천봉화초등학교,교육부 인천광역시교육청 인천광역시서부교육지원청 인천봉화초등학교,28,28,0,28,21,7,0,0
교육기관,교육부,인천부평초등학교,교육부 인천광역시교육청 인천광역시서부교육지원청 인천부평초등학교,25,25,0,25,25,0,0,0
교육기관,교육부,인천부현동초등학교,교육부 인천광역시교육청 인천광역시서부교육지원청 인천부현동초등학교,18,18,0,18,8,10,0,0
교육기관,교육부,인천부현초등학교,교육부 인천광역시교육청 인천광역시서부교육지원청 인천부현초등학교,18,18,0,18,18,0,0,0
교육기관,교육부,인천불로초등학교,교육부 인천광역시교육청 인천광역시서부교육지원청 인천불로초등학교,16,16,0,16,16,0,0,0
교육기관,교육부,인천서곶초등학교,교육부 인천광역시교육청 인천광역시서부교육지원청 인천서곶초등학교,15,15,0,15,15,0,0,0
교육기관,교육부,인천서운초등학교,교육부 인천광역시교육청 인천광역시서부교육지원청 인천서운초등학교,27,27,0,27,17,6,4,0
교육기관,교육부,인천서현유치원,교육부 인천광역시교육청 인천광역시서부교육지원청 인천서현유치원,16,16,0,16,0,16,0,0
교육기관,교육부,인천석남서초등학교,교육부 인천광역시교육청 인천광역시서부교육지원청 인천석남서초등학교,20,20,0,20,3,17,0,0
교육기관,교육부,인천석남중학교,교육부 인천광역시교육청 인천광역시서부교육지원청 인천석남중학교,45,43,2,43,12,29,1,1
교육기관,교육부,인천석남초등학교,교육부 인천광역시교육청 인천광역시서부교육지원청 인천석남초등학교,26,26,0,26,18,4,2,2
교육기관,교육부,인천석남초등학교병설유치원,교육부 인천광역시교육청 인천광역시서부교육지원청 인천석남초등학교병설유치원,0,0,0,0,0,0,0,0
교육기관,교육부,인천성지초등학교,교육부 인천광역시교육청 인천광역시서부교육지원청 인천성지초등학교,17,17,0,17,17,0,0,0
교육기관,교육부,인천소양초등학교,교육부 인천광역시교육청 인천광역시서부교육지원청 인천소양초등학교,22,22,0,22,22,0,0,0
교육기관,교육부,인천신대초등학교,교육부 인천광역시교육청 인천광역시서부교육지원청 인천신대초등학교,23,23,0,23,23,0,0,0
교육기관,교육부,인천신석초등학교,교육부 인천광역시교육청 인천광역시서부교육지원청 인천신석초등학교,21,21,0,21,0,21,0,0
교육기관,교육부,인천신현북초등학교,교육부 인천광역시교육청 인천광역시서부교육지원청 인천신현북초등학교,24,24,0,24,0,24,0,0
교육기관,교육부,인천신현초등학교,교육부 인천광역시교육청 인천광역시서부교육지원청 인천신현초등학교,19,19,0,19,0,19,0,0
교육기관,교육부,인천심곡초등학교,교육부 인천광역시교육청 인천광역시서부교육지원청 인천심곡초등학교,18,18,0,18,18,0,0,0
교육기관,교육부,인천아라꿈유치원,교육부 인천광역시교육청 인천광역시서부교육지원청 인천아라꿈유치원,36,36,0,36,36,0,0,0
교육기관,교육부,인천아라중학교,교육부 인천광역시교육청 인천광역시서부교육지원청 인천아라중학교,51,49,2,49,17,23,7,2
교육기관,교육부,인천안남중학교,교육부 인천광역시교육청 인천광역시서부교육지원청 인천안남중학교,33,33,0,33,0,33,0,0
교육기관,교육부,인천안남초등학교,교육부 인천광역시교육청 인천광역시서부교육지원청 인천안남초등학교,26,26,0,26,26,0,0,0
교육기관,교육부,인천안산초등학교,교육부 인천광역시교육청 인천광역시서부교육지원청 인천안산초등학교,27,27,0,27,25,0,2,0
교육기관,교육부,인천양지초등학교,교육부 인천광역시교육청 인천광역시서부교육지원청 인천양지초등학교,21,21,0,21,0,21,0,0
교육기관,교육부,인천양촌중학교,교육부 인천광역시교육청 인천광역시서부교육지원청 인천양촌중학교,32,32,0,32,30,2,0,0
교육기관,교육부,인천양촌초등학교,교육부 인천광역시교육청 인천광역시서부교육지원청 인천양촌초등학교,18,18,0,18,18,0,0,0
교육기관,교육부,인천예일중학교,교육부 인천광역시교육청 인천광역시서부교육지원청 인천예일중학교,36,36,0,36,10,26,0,0
교육기관,교육부,인천완정초등학교,교육부 인천광역시교육청 인천광역시서부교육지원청 인천완정초등학교,16,15,1,15,15,0,0,0
교육기관,교육부,인천왕길초등학교,교육부 인천광역시교육청 인천광역시서부교육지원청 인천왕길초등학교,19,19,0,19,19,0,0,0
교육기관,교육부,인천원당초등학교,교육부 인천광역시교육청 인천광역시서부교육지원청 인천원당초등학교,30,30,0,30,5,25,0,0
교육기관,교육부,인천은지초등학교,교육부 인천광역시교육청 인천광역시서부교육지원청 인천은지초등학교,14,14,0,14,14,0,0,0
교육기관,교육부,인천이음중학교,교육부 인천광역시교육청 인천광역시서부교육지원청 인천이음중학교,57,57,0,57,17,40,0,0
교육기관,교육부,인천이음초등학교,교육부 인천광역시교육청 인천광역시서부교육지원청 인천이음초등학교,50,14,36,14,14,0,0,0
교육기관,교육부,인천작동초등학교,교육부 인천광역시교육청 인천광역시서부교육지원청 인천작동초등학교,20,20,0,20,10,10,0,0
교육기관,교육부,인천작전초등학교,교육부 인천광역시교육청 인천광역시서부교육지원청 인천작전초등학교,21,21,0,21,11,10,0,0
교육기관,교육부,인천창신초등학교,교육부 인천광역시교육청 인천광역시서부교육지원청 인천창신초등학교,13,13,0,13,7,6,0,0
교육기관,교육부,인천천마초등학교,교육부 인천광역시교육청 인천광역시서부교육지원청 인천천마초등학교,12,12,0,12,0,12,0,0
교육기관,교육부,인천청라중학교,교육부 인천광역시교육청 인천광역시서부교육지원청 인천청라중학교,63,63,0,63,62,1,0,0
교육기관,교육부,인천청람중학교,교육부 인천광역시교육청 인천광역시서부교육지원청 인천청람중학교,57,56,1,56,27,29,0,0
교육기관,교육부,인천청람초등학교,교육부 인천광역시교육청 인천광역시서부교육지원청 인천청람초등학교,45,45,0,45,0,45,0,0
교육기관,교육부,인천청일초등학교,교육부 인천광역시교육청 인천광역시서부교육지원청 인천청일초등학교,33,33,0,33,7,26,0,0
교육기관,교육부,인천청호초등학교,교육부 인천광역시교육청 인천광역시서부교육지원청 인천청호초등학교,25,25,0,25,9,16,0,0
교육기관,교육부,인천초은중학교,교육부 인천광역시교육청 인천광역시서부교육지원청 인천초은중학교,53,53,0,53,41,12,0,0
교육기관,교육부,인천초은초등학교,교육부 인천광역시교육청 인천광역시서부교육지원청 인천초은초등학교,31,31,0,31,31,0,0,0
교육기관,교육부,인천푸른빛유치원,교육부 인천광역시교육청 인천광역시서부교육지원청 인천푸른빛유치원,29,29,0,29,29,0,0,0
교육기관,교육부,인천한별초등학교,교육부 인천광역시교육청 인천광역시서부교육지원청 인천한별초등학교,44,31,13,31,0,18,13,0
교육기관,교육부,인천한별초등학교병설유치원,교육부 인천광역시교육청 인천광역시서부교육지원청 인천한별초등학교병설유치원,5,5,0,5,0,5,0,0
교육기관,교육부,인천해든초등학교,교육부 인천광역시교육청 인천광역시서부교육지원청 인천해든초등학교,58,58,0,58,0,58,0,0
교육기관,교육부,인천해서초등학교,교육부 인천광역시교육청 인천광역시서부교육지원청 인천해서초등학교,12,12,0,12,5,7,0,0
교육기관,교육부,인천해원중학교,교육부 인천광역시교육청 인천광역시서부교육지원청 인천해원중학교,62,62,0,62,54,8,0,0
교육기관,교육부,인천해원초등학교,교육부 인천광역시교육청 인천광역시서부교육지원청 인천해원초등학교,53,51,2,51,0,51,0,0
교육기관,교육부,인천화전유치원,교육부 인천광역시교육청 인천광역시서부교육지원청 인천화전유치원,6,6,0,6,0,6,0,0
교육기관,교육부,인천화전초등학교,교육부 인천광역시교육청 인천광역시서부교육지원청 인천화전초등학교,19,19,0,19,0,19,0,0
교육기관,교육부,인천효성남초등학교,교육부 인천광역시교육청 인천광역시서부교육지원청 인천효성남초등학교,16,16,0,16,4,4,4,4
교육기관,교육부,인천효성동초등학교,교육부 인천광역시교육청 인천광역시서부교육지원청 인천효성동초등학교,25,25,0,25,0,25,0,0
교육기관,교육부,인천효성서초등학교,교육부 인천광역시교육청 인천광역시서부교육지원청 인천효성서초등학교,29,0,29,0,0,0,0,0
교육기관,교육부,인천효성중학교,교육부 인천광역시교육청 인천광역시서부교육지원청 인천효성중학교,27,27,0,27,14,13,0,0
교육기관,교육부,인천효성초등학교,교육부 인천광역시교육청 인천광역시서부교육지원청 인천효성초등학교,23,23,0,23,23,0,0,0
교육기관,교육부,일영유치원,교육부 인천광역시교육청 인천광역시서부교육지원청 일영유치원,12,1,11,1,0,0,0,1
교육기관,교육부,작전중학교,교육부 인천광역시교육청 인천광역시서부교육지원청 작전중학교,30,30,0,30,28,2,0,0
교육기관,교육부,재은유치원,교육부 인천광역시교육청 인천광역시서부교육지원청 재은유치원,14,0,14,0,0,0,0,0
교육기관,교육부,제물포중학교,교육부 인천광역시교육청 인천광역시서부교육지원청 제물포중학교,33,31,2,31,0,31,0,0
교육기관,교육부,청라유치원,교육부 인천광역시교육청 인천광역시서부교육지원청 청라유치원,26,8,18,8,5,3,0,0
교육기관,교육부,큰사랑유치원,교육부 인천광역시교육청 인천광역시서부교육지원청 큰사랑유치원,21,3,18,3,1,2,0,0
교육기관,교육부,프라임청라유치원,교육부 인천광역시교육청 인천광역시서부교육지원청 프라임청라유치원,27,3,24,3,3,0,0,0
교육기관,교육부,한샘유치원,교육부 인천광역시교육청 인천광역시서부교육지원청 한샘유치원,29,1,28,1,1,0,0,0
교육기관,교육부,해나라유치원,교육부 인천광역시교육청 인천광역시서부교육지원청 해나라유치원,32,0,32,0,0,0,0,0
교육기관,교육부,인천국제고등학교,교육부 인천광역시교육청 인천국제고등학교,70,70,0,70,70,0,0,0
교육기관,교육부,인천금융고등학교,교육부 인천광역시교육청 인천금융고등학교,40,37,3,37,2,35,0,0
교육기관,교육부,인천기계공업고등학교,교육부 인천광역시교육청 인천기계공업고등학교,73,73,0,73,73,0,0,0
교육기관,교육부,인천남고등학교,교육부 인천광역시교육청 인천남고등학교,45,45,0,45,0,45,0,0
교육기관,교육부,인천남동고등학교,교육부 인천광역시교육청 인천남동고등학교,61,61,0,61,30,31,0,0
교육기관,교육부,인천논현고등학교,교육부 인천광역시교육청 인천논현고등학교,40,40,0,40,0,40,0,0
교육기관,교육부,인천대건고등학교,교육부 인천광역시교육청 인천대건고등학교,89,89,0,89,89,0,0,0
교육기관,교육부,인천대중예술고등학교,교육부 인천광역시교육청 인천대중예술고등학교,71,71,0,71,0,71,0,0
교육기관,교육부,인천디자인고등학교,교육부 인천광역시교육청 인천디자인고등학교,54,6,48,6,6,0,0,0
교육기관,교육부,인천마전고등학교,교육부 인천광역시교육청 인천마전고등학교,53,53,0,53,22,31,0,0
교육기관,교육부,인천만수고등학교,교육부 인천광역시교육청 인천만수고등학교,53,53,0,53,21,32,0,0
교육기관,교육부,인천바이오과학고등학교,교육부 인천광역시교육청 인천바이오과학고등학교,69,69,0,69,0,69,0,0
교육기관,교육부,인천보건고등학교,교육부 인천광역시교육청 인천보건고등학교,46,44,2,44,44,0,0,0
교육기관,교육부,인천부흥고등학교,교육부 인천광역시교육청 인천부흥고등학교,25,25,0,25,9,10,2,4
교육기관,교육부,인천뷰티예술고등학교,교육부 인천광역시교육청 인천뷰티예술고등학교,31,29,2,29,29,0,0,0
교육기관,교육부,인천비즈니스고등학교,교육부 인천광역시교육청 인천비즈니스고등학교,64,64,0,64,19,45,0,0
교육기관,교육부,인천산업정보학교,교육부 인천광역시교육청 인천산업정보학교,10,10,0,10,5,5,0,0
교육기관,교육부,인천상정고등학교,교육부 인천광역시교육청 인천상정고등학교,35,34,1,34,2,32,0,0
교육기관,교육부,인천생활과학고등학교,교육부 인천광역시교육청 인천생활과학고등학교,42,42,0,42,42,0,0,0
교육기관,교육부,인천서희학교,교육부 인천광역시교육청 인천서희학교,61,61,0,61,0,61,0,0
교육기관,교육부,인천성동학교,교육부 인천광역시교육청 인천성동학교,21,16,5,16,10,6,0,0
교육기관,교육부,인천세무고등학교,교육부 인천광역시교육청 인천세무고등학교,52,52,0,52,52,0,0,0
교육기관,교육부,인천세원고등학교,교육부 인천광역시교육청 인천세원고등학교,44,44,0,44,28,16,0,0
교육기관,교육부,인천소방고등학교,교육부 인천광역시교육청 인천소방고등학교,57,55,2,55,12,43,0,0
교육기관,교육부,인천송천고등학교,교육부 인천광역시교육청 인천송천고등학교,26,26,0,26,13,13,0,0
교육기관,교육부,인천신현고등학교,교육부 인천광역시교육청 인천신현고등학교,39,39,0,39,8,31,0,0
교육기관,교육부,인천아라고등학교,교육부 인천광역시교육청 인천아라고등학교,81,81,0,81,81,0,0,0
교육기관,교육부,인천여자고등학교,교육부 인천광역시교육청 인천여자고등학교,21,21,0,21,21,0,0,0
교육기관,교육부,인천여자상업고등학교,교육부 인천광역시교육청 인천여자상업고등학교,34,34,0,34,20,14,0,0
교육기관,교육부,인천연송고등학교,교육부 인천광역시교육청 인천연송고등학교,77,77,0,77,0,77,0,0
교육기관,교육부,인천연일학교,교육부 인천광역시교육청 인천연일학교,24,24,0,24,0,24,0,0
교육기관,교육부,인천영선고등학교,교육부 인천광역시교육청 인천영선고등학교,58,58,0,58,17,41,0,0
교육기관,교육부,인천영종고등학교,교육부 인천광역시교육청 인천영종고등학교,63,63,0,63,33,30,0,0
교육기관,교육부,인천영흥고등학교,교육부 인천광역시교육청 인천영흥고등학교,34,34,0,34,34,0,0,0
교육기관,교육부,인천예림학교,교육부 인천광역시교육청 인천예림학교,8,8,0,8,0,8,0,0
교육기관,교육부,인천예술고등학교,교육부 인천광역시교육청 인천예술고등학교,66,66,0,66,66,0,0,0
교육기관,교육부,인천예일고등학교,교육부 인천광역시교육청 인천예일고등학교,50,50,0,50,50,0,0,0
교육기관,교육부,인천외국어고등학교,교육부 인천광역시교육청 인천외국어고등학교,89,89,0,89,89,0,0,0
교육기관,교육부,인천원당고등학교,교육부 인천광역시교육청 인천원당고등학교,54,54,0,54,54,0,0,0
교육기관,교육부,인천은광학교,교육부 인천광역시교육청 인천은광학교,43,43,0,43,8,35,0,0
교육기관,교육부,인천인혜학교,교육부 인천광역시교육청 인천인혜학교,13,13,0,13,0,13,0,0
교육기관,교육부,인천재능고등학교,교육부 인천광역시교육청 인천재능고등학교,53,53,0,53,0,53,0,0
교육기관,교육부,인천전자마이스터고등학교,교육부 인천광역시교육청 인천전자마이스터고등학교,96,96,0,96,79,17,0,0
교육기관,교육부,인천정보과학고등학교,교육부 인천광역시교육청 인천정보과학고등학교,60,60,0,60,0,60,0,0
교육기관,교육부,인천중산고등학교,교육부 인천광역시교육청 인천중산고등학교,76,76,0,76,36,40,0,0
교육기관,교육부,인천중앙여자상업고등학교,교육부 인천광역시교육청 인천중앙여자상업고등학교,39,39,0,39,28,11,0,0
교육기관,교육부,인천진산과학고등학교,교육부 인천광역시교육청 인천진산과학고등학교,67,16,51,16,14,2,0,0
교육기관,교육부,인천청라고등학교,교육부 인천광역시교육청 인천청라고등학교,69,69,0,69,69,0,0,0
교육기관,교육부,인천청선학교,교육부 인천광역시교육청 인천청선학교,36,36,0,36,19,17,0,0
교육기관,교육부,인천청인학교,교육부 인천광역시교육청 인천청인학교,74,74,0,74,0,74,0,0
교육기관,교육부,인천체육고등학교,교육부 인천광역시교육청 인천체육고등학교,108,108,0,108,0,108,0,0
교육기관,교육부,인천초은고등학교,교육부 인천광역시교육청 인천초은고등학교,50,50,0,50,37,13,0,0
교육기관,교육부,인천포스코고등학교,교육부 인천광역시교육청 인천포스코고등학교,52,52,0,52,2,50,0,0
교육기관,교육부,인천하늘고등학교,교육부 인천광역시교육청 인천하늘고등학교,191,23,168,23,23,0,0,0
교육기관,교육부,인천한누리학교,교육부 인천광역시교육청 인천한누리학교,42,42,0,42,0,42,0,0
교육기관,교육부,인천해밀학교,교육부 인천광역시교육청 인천해밀학교,26,26,0,26,26,0,0,0
교육기관,교육부,인천해송고등학교,교육부 인천광역시교육청 인천해송고등학교,77,77,0,77,30,47,0,0
교육기관,교육부,인천해양과학고등학교,교육부 인천광역시교육청 인천해양과학고등학교,42,42,0,42,18,24,0,0
교육기관,교육부,인천해원고등학교,교육부 인천광역시교육청 인천해원고등학교,60,58,2,58,58,0,0,0
교육기관,교육부,인천혜광학교,교육부 인천광역시교육청 인천혜광학교,16,16,0,16,16,0,0,0
교육기관,교육부,인천효성고등학교,교육부 인천광역시교육청 인천효성고등학교,57,55,2,55,55,0,0,0
교육기관,교육부,인평자동차정보고등학교,교육부 인천광역시교육청 인평자동차정보고등학교,32,32,0,32,0,32,0,0
교육기관,교육부,인하대학교사범대학부속고등학교,교육부 인천광역시교육청 인하대학교사범대학부속고등학교,72,72,0,72,60,11,0,1
교육기관,교육부,인항고등학교,교육부 인천광역시교육청 인항고등학교,25,24,1,24,0,24,0,0
교육기관,교육부,인화여자고등학교,교육부 인천광역시교육청 인화여자고등학교,37,37,0,37,20,17,0,0
교육기관,교육부,작전고등학교,교육부 인천광역시교육청 작전고등학교,42,39,3,39,0,39,0,0
교육기관,교육부,작전여자고등학교,교육부 인천광역시교육청 작전여자고등학교,36,36,0,36,36,0,0,0
교육기관,교육부,정석항공과학고등학교,교육부 인천광역시교육청 정석항공과학고등학교,31,31,0,31,0,31,0,0
교육기관,교육부,제물포고등학교,교육부 인천광역시교육청 제물포고등학교,61,61,0,61,31,30,0,0
교육기관,교육부,청라달튼외국인학교,교육부 인천광역시교육청 청라달튼외국인학교,148,148,0,148,0,148,0,0
교육기관,교육부,학력인정인천생활예술고등학교,교육부 인천광역시교육청 학력인정인천생활예술고등학교,43,43,0,43,43,0,0,0
교육기관,교육부,학익고등학교,교육부 인천광역시교육청 학익고등학교,39,39,0,39,23,16,0,0
교육기관,교육부,학익여자고등학교,교육부 인천광역시교육청 학익여자고등학교,32,29,3,29,0,29,0,0
교육기관,교육부,한국글로벌셰프고등학교,교육부 인천광역시교육청 한국글로벌셰프고등학교,26,26,0,26,26,0,0,0
교육기관,교육부,한국주얼리고등학교,교육부 인천광역시교육청 한국주얼리고등학교,37,37,0,37,12,25,0,0
교육기관,교육부,광주광역시교육청,교육부 광주광역시교육청,25,25,0,25,0,25,0,0
교육기관,교육부,고려고등학교,교육부 광주광역시교육청 고려고등학교,17,17,0,17,17,0,0,0
교육기관,교육부,광덕고등학교,교육부 광주광역시교육청 광덕고등학교,27,27,0,27,0,27,0,0
교육기관,교육부,광일고등학교,교육부 광주광역시교육청 광일고등학교,16,16,0,16,8,8,0,0
교육기관,교육부,광주경신여자고등학교,교육부 광주광역시교육청 광주경신여자고등학교,35,35,0,35,0,35,0,0
교육기관,교육부,광주고등학교,교육부 광주광역시교육청 광주고등학교,52,38,14,38,21,17,0,0
교육기관,교육부,광주과학고등학교,교육부 광주광역시교육청 광주과학고등학교,59,20,39,20,20,0,0,0
교육기관,교육부,광주광역시교육연구정보원,교육부 광주광역시교육청 광주광역시교육연구정보원,20,20,0,20,0,20,0,0
교육기관,교육부,광주광역시교육연수원,교육부 광주광역시교육청 광주광역시교육연수원,51,21,30,21,0,21,0,0
교육기관,교육부,광주광역시동부교육지원청,교육부 광주광역시교육청 광주광역시동부교육지원청,12,12,0,12,0,12,0,0
교육기관,교육부,각화중학교,교육부 광주광역시교육청 광주광역시동부교육지원청 각화중학교,13,13,0,13,12,1,0,0
교육기관,교육부,건국유치원,교육부 광주광역시교육청 광주광역시동부교육지원청 건국유치원,7,7,0,7,0,7,0,0
교육기관,교육부,건국초등학교,교육부 광주광역시교육청 광주광역시동부교육지원청 건국초등학교,7,7,0,7,3,3,1,0
교육기관,교육부,경신유치원,교육부 광주광역시교육청 광주광역시동부교육지원청 경신유치원,8,8,0,8,8,0,0,0
교육기관,교육부,경양초등학교,교육부 광주광역시교육청 광주광역시동부교육지원청 경양초등학교,0,0,0,0,0,0,0,0
교육기관,교육부,고려중학교,교육부 광주광역시교육청 광주광역시동부교육지원청 고려중학교,9,9,0,9,0,9,0,0
교육기관,교육부,광주경신중학교,교육부 광주광역시교육청 광주광역시동부교육지원청 광주경신중학교,33,32,1,32,0,32,0,0
교육기관,교육부,광주계림초등학교,교육부 광주광역시교육청 광주광역시동부교육지원청 광주계림초등학교,17,17,0,17,17,0,0,0
교육기관,교육부,광주남초등학교,교육부 광주광역시교육청 광주광역시동부교육지원청 광주남초등학교,21,21,0,21,5,16,0,0
교육기관,교육부,광주동산초등학교,교육부 광주광역시교육청 광주광역시동부교육지원청 광주동산초등학교,13,13,0,13,13,0,0,0
교육기관,교육부,광주동신여자중학교,교육부 광주광역시교육청 광주광역시동부교육지원청 광주동신여자중학교,14,14,0,14,14,0,0,0
교육기관,교육부,광주동신중학교,교육부 광주광역시교육청 광주광역시동부교육지원청 광주동신중학교,24,24,0,24,18,6,0,0
교육기관,교육부,광주동운초등학교,교육부 광주광역시교육청 광주광역시동부교육지원청 광주동운초등학교,8,8,0,8,8,0,0,0
교육기관,교육부,광주동초등학교,교육부 광주광역시교육청 광주광역시동부교육지원청 광주동초등학교,20,20,0,20,2,15,0,3
교육기관,교육부,광주문화초등학교,교육부 광주광역시교육청 광주광역시동부교육지원청 광주문화초등학교,10,10,0,10,0,10,0,0
교육기관,교육부,광주북성중학교,교육부 광주광역시교육청 광주광역시동부교육지원청 광주북성중학교,15,15,0,15,0,15,0,0
교육기관,교육부,광주북초등학교,교육부 광주광역시교육청 광주광역시동부교육지원청 광주북초등학교,10,10,0,10,0,10,0,0
교육기관,교육부,광주산수초등학교,교육부 광주광역시교육청 광주광역시동부교육지원청 광주산수초등학교,10,10,0,10,10,0,0,0
교육기관,교육부,광주서림초등학교,교육부 광주광역시교육청 광주광역시동부교육지원청 광주서림초등학교,24,24,0,24,16,8,0,0
교육기관,교육부,광주서산초등학교,교육부 광주광역시교육청 광주광역시동부교육지원청 광주서산초등학교,16,16,0,16,16,0,0,0
교육기관,교육부,광주서석초등학교,교육부 광주광역시교육청 광주광역시동부교육지원청 광주서석초등학교,14,14,0,14,14,0,0,0
교육기관,교육부,광주수창초등학교,교육부 광주광역시교육청 광주광역시동부교육지원청 광주수창초등학교,15,15,0,15,4,11,0,0
교육기관,교육부,광주양산초등학교,교육부 광주광역시교육청 광주광역시동부교육지원청 광주양산초등학교,25,25,0,25,25,0,0,0
교육기관,교육부,광주용봉초등학교,교육부 광주광역시교육청 광주광역시동부교육지원청 광주용봉초등학교,17,17,0,17,8,9,0,0
교육기관,교육부,광주용산초등학교,교육부 광주광역시교육청 광주광역시동부교육지원청 광주용산초등학교,18,18,0,18,18,0,0,0
교육기관,교육부,광주우산초등학교,교육부 광주광역시교육청 광주광역시동부교육지원청 광주우산초등학교,13,13,0,13,0,13,0,0
교육기관,교육부,광주운암초등학교,교육부 광주광역시교육청 광주광역시동부교육지원청 광주운암초등학교,13,13,0,13,12,1,0,0
교육기관,교육부,광주장원초등학교,교육부 광주광역시교육청 광주광역시동부교육지원청 광주장원초등학교,12,12,0,12,0,12,0,0
교육기관,교육부,광주중앙초등학교,교육부 광주광역시교육청 광주광역시동부교육지원청 광주중앙초등학교,11,11,0,11,11,0,0,0
교육기관,교육부,광주중흥초등학교,교육부 광주광역시교육청 광주광역시동부교육지원청 광주중흥초등학교,21,21,0,21,21,0,0,0
교육기관,교육부,광주지산초등학교,교육부 광주광역시교육청 광주광역시동부교육지원청 광주지산초등학교,19,19,0,19,0,19,0,0
교육기관,교육부,광주풍향초등학교,교육부 광주광역시교육청 광주광역시동부교육지원청 광주풍향초등학교,16,16,0,16,0,16,0,0
교육기관,교육부,광주학운초등학교,교육부 광주광역시교육청 광주광역시동부교육지원청 광주학운초등학교,14,14,0,14,0,14,0,0
교육기관,교육부,광주효동초등학교,교육부 광주광역시교육청 광주광역시동부교육지원청 광주효동초등학교,13,13,0,13,0,13,0,0
교육기관,교육부,금정유치원,교육부 광주광역시교육청 광주광역시동부교육지원청 금정유치원,4,0,4,0,0,0,0,0
교육기관,교육부,금호중앙중학교,교육부 광주광역시교육청 광주광역시동부교육지원청 금호중앙중학교,13,13,0,13,5,8,0,0
교육기관,교육부,대자초등학교,교육부 광주광역시교육청 광주광역시동부교육지원청 대자초등학교,12,12,0,12,3,9,0,0
교육기관,교육부,더블유유치원,교육부 광주광역시교육청 광주광역시동부교육지원청 더블유유치원,13,13,0,13,0,13,0,0
교육기관,교육부,동강대학교부설동강유치원,교육부 광주광역시교육청 광주광역시동부교육지원청 동강대학교부설동강유치원,12,3,9,3,3,0,0,0
교육기관,교육부,동림초등학교,교육부 광주광역시교육청 광주광역시동부교육지원청 동림초등학교,15,15,0,15,12,3,0,0
교육기관,교육부,동심유치원,교육부 광주광역시교육청 광주광역시동부교육지원청 동심유치원,13,13,0,13,10,3,0,0
교육기관,교육부,두암중학교,교육부 광주광역시교육청 광주광역시동부교육지원청 두암중학교,16,16,0,16,16,0,0,0
교육기관,교육부,두암초등학교,교육부 광주광역시교육청 광주광역시동부교육지원청 두암초등학교,16,16,0,16,16,0,0,0
교육기관,교육부,라예송유치원,교육부 광주광역시교육청 광주광역시동부교육지원청 라예송유치원,16,16,0,16,0,16,0,0
교육기관,교육부,매곡초등학교,교육부 광주광역시교육청 광주광역시동부교육지원청 매곡초등학교,16,16,0,16,0,16,0,0
교육기관,교육부,무등중학교,교육부 광주광역시교육청 광주광역시동부교육지원청 무등중학교,20,13,7,13,10,3,0,0
교육기관,교육부,무등초등학교,교육부 광주광역시교육청 광주광역시동부교육지원청 무등초등학교,10,10,0,10,0,10,0,0
교육기관,교육부,문산중학교,교육부 광주광역시교육청 광주광역시동부교육지원청 문산중학교,18,18,0,18,16,2,0,0
교육기관,교육부,문산초등학교,교육부 광주광역시교육청 광주광역시동부교육지원청 문산초등학교,16,16,0,16,6,10,0,0
교육기관,교육부,문예동산유치원,교육부 광주광역시교육청 광주광역시동부교육지원청 문예동산유치원,23,23,0,23,0,23,0,0
교육기관,교육부,문우초등학교,교육부 광주광역시교육청 광주광역시동부교육지원청 문우초등학교,14,14,0,14,14,0,0,0
교육기관,교육부,문정초등학교,교육부 광주광역시교육청 광주광역시동부교육지원청 문정초등학교,11,11,0,11,11,0,0,0
교육기관,교육부,문화중학교,교육부 광주광역시교육청 광주광역시동부교육지원청 문화중학교,24,24,0,24,0,24,0,0
교육기관,교육부,문흥중앙초등학교,교육부 광주광역시교육청 광주광역시동부교육지원청 문흥중앙초등학교,14,14,0,14,7,7,0,0
교육기관,교육부,문흥중학교,교육부 광주광역시교육청 광주광역시동부교육지원청 문흥중학교,14,14,0,14,4,10,0,0
교육기관,교육부,문흥초등학교,교육부 광주광역시교육청 광주광역시동부교육지원청 문흥초등학교,11,11,0,11,8,3,0,0
교육기관,교육부,민족사관유치원,교육부 광주광역시교육청 광주광역시동부교육지원청 민족사관유치원,12,7,5,7,1,4,1,1
교육기관,교육부,본촌초등학교,교육부 광주광역시교육청 광주광역시동부교육지원청 본촌초등학교,14,14,0,14,10,4,0,0
교육기관,교육부,사범대학부설중학교,교육부 광주광역시교육청 광주광역시동부교육지원청 사범대학부설중학교,25,25,0,25,19,6,0,0
교육기관,교육부,살레시오여자중학교,교육부 광주광역시교육청 광주광역시동부교육지원청 살레시오여자중학교,12,12,0,12,0,12,0,0
교육기관,교육부,살레시오중학교,교육부 광주광역시교육청 광주광역시동부교육지원청 살레시오중학교,21,20,1,20,4,16,0,0
교육기관,교육부,삼각초등학교,교육부 광주광역시교육청 광주광역시동부교육지원청 삼각초등학교,15,15,0,15,13,2,0,0
교육기관,교육부,삼정초등학교,교육부 광주광역시교육청 광주광역시동부교육지원청 삼정초등학교,16,16,0,16,12,4,0,0
교육기관,교육부,새미르유치원,교육부 광주광역시교육청 광주광역시동부교육지원청 새미르유치원,11,11,0,11,0,11,0,0
교육기관,교육부,서강중학교,교육부 광주광역시교육청 광주광역시동부교육지원청 서강중학교,15,15,0,15,0,15,0,0
교육기관,교육부,서영대학교부설서영유치원,교육부 광주광역시교육청 광주광역시동부교육지원청 서영대학교부설서영유치원,7,7,0,7,7,0,0,0
교육기관,교육부,서일초등학교,교육부 광주광역시교육청 광주광역시동부교육지원청 서일초등학교,10,10,0,10,8,2,0,0
교육기관,교육부,선일유치원,교육부 광주광역시교육청 광주광역시동부교육지원청 선일유치원,18,18,0,18,2,14,1,1
교육기관,교육부,선정유치원,교육부 광주광역시교육청 광주광역시동부교육지원청 선정유치원,21,7,14,7,5,2,0,0
교육기관,교육부,소나무유치원,교육부 광주광역시교육청 광주광역시동부교육지원청 소나무유치원,15,15,0,15,1,14,0,0
교육기관,교육부,신광중학교,교육부 광주광역시교육청 광주광역시동부교육지원청 신광중학교,13,11,2,11,6,5,0,0
교육기관,교육부,신세계유치원,교육부 광주광역시교육청 광주광역시동부교육지원청 신세계유치원,10,10,0,10,0,10,0,0
교육기관,교육부,신용유치원,교육부 광주광역시교육청 광주광역시동부교육지원청 신용유치원,10,10,0,10,10,0,0,0
교육기관,교육부,신용중학교,교육부 광주광역시교육청 광주광역시동부교육지원청 신용중학교,24,14,10,14,9,5,0,0
교육기관,교육부,신용초등학교,교육부 광주광역시교육청 광주광역시동부교육지원청 신용초등학교,13,13,0,13,3,10,0,0
교육기관,교육부,아이림유치원,교육부 광주광역시교육청 광주광역시동부교육지원청 아이림유치원,12,12,0,12,12,0,0,0
교육기관,교육부,양산리라유치원,교육부 광주광역시교육청 광주광역시동부교육지원청 양산리라유치원,13,13,0,13,2,11,0,0
교육기관,교육부,양산중학교,교육부 광주광역시교육청 광주광역시동부교육지원청 양산중학교,18,16,2,16,11,5,0,0
교육기관,교육부,양지초등학교,교육부 광주광역시교육청 광주광역시동부교육지원청 양지초등학교,14,14,0,14,0,14,0,0
교육기관,교육부,연제초등학교,교육부 광주광역시교육청 광주광역시동부교육지원청 연제초등학교,18,18,0,18,18,0,0,0
교육기관,교육부,연화유치원,교육부 광주광역시교육청 광주광역시동부교육지원청 연화유치원,8,8,0,8,4,4,0,0
교육기관,교육부,예일유치원,교육부 광주광역시교육청 광주광역시동부교육지원청 예일유치원,6,1,5,1,0,1,0,0
교육기관,교육부,오정초등학교,교육부 광주광역시교육청 광주광역시동부교육지원청 오정초등학교,15,15,0,15,8,7,0,0
교육기관,교육부,오치초등학교,교육부 광주광역시교육청 광주광역시동부교육지원청 오치초등학교,14,14,0,14,0,14,0,0
교육기관,교육부,용두중학교,교육부 광주광역시교육청 광주광역시동부교육지원청 용두중학교,28,28,0,28,0,28,0,0
교육기관,교육부,용두초등학교,교육부 광주광역시교육청 광주광역시동부교육지원청 용두초등학교,16,16,0,16,14,2,0,0
교육기관,교육부,용봉중학교,교육부 광주광역시교육청 광주광역시동부교육지원청 용봉중학교,14,14,0,14,4,10,0,0
교육기관,교육부,용주초등학교,교육부 광주광역시교육청 광주광역시동부교육지원청 용주초등학교,13,13,0,13,0,13,0,0
교육기관,교육부,우산중학교,교육부 광주광역시교육청 광주광역시동부교육지원청 우산중학교,14,14,0,14,0,14,0,0
교육기관,교육부,운림중학교,교육부 광주광역시교육청 광주광역시동부교육지원청 운림중학교,22,22,0,22,5,17,0,0
교육기관,교육부,운암중학교,교육부 광주광역시교육청 광주광역시동부교육지원청 운암중학교,30,30,0,30,0,30,0,0
교육기관,교육부,율곡초등학교,교육부 광주광역시교육청 광주광역시동부교육지원청 율곡초등학교,11,11,0,11,0,11,0,0
교육기관,교육부,이화동산유치원,교육부 광주광역시교육청 광주광역시동부교육지원청 이화동산유치원,20,0,20,0,0,0,0,0
교육기관,교육부,이화정원유치원,교육부 광주광역시교육청 광주광역시동부교육지원청 이화정원유치원,16,4,12,4,0,4,0,0
교육기관,교육부,인양유치원,교육부 광주광역시교육청 광주광역시동부교육지원청 인양유치원,10,10,0,10,0,10,0,0
교육기관,교육부,일곡중학교,교육부 광주광역시교육청 광주광역시동부교육지원청 일곡중학교,16,15,1,15,1,14,0,0
교육기관,교육부,일곡초등학교,교육부 광주광역시교육청 광주광역시동부교육지원청 일곡초등학교,14,14,0,14,11,3,0,0
교육기관,교육부,일동중학교,교육부 광주광역시교육청 광주광역시동부교육지원청 일동중학교,13,0,13,0,0,0,0,0
교육기관,교육부,일동초등학교,교육부 광주광역시교육청 광주광역시동부교육지원청 일동초등학교,18,18,0,18,0,18,0,0
교육기관,교육부,일신중학교,교육부 광주광역시교육청 광주광역시동부교육지원청 일신중학교,16,16,0,16,16,0,0,0
교육기관,교육부,일신초등학교,교육부 광주광역시교육청 광주광역시동부교육지원청 일신초등학교,16,16,0,16,0,16,0,0
교육기관,교육부,정덕유치원,교육부 광주광역시교육청 광주광역시동부교육지원청 정덕유치원,6,6,0,6,6,0,0,0
교육기관,교육부,조선대학교여자중학교,교육부 광주광역시교육청 광주광역시동부교육지원청 조선대학교여자중학교,21,21,0,21,2,19,0,0
교육기관,교육부,지산중학교,교육부 광주광역시교육청 광주광역시동부교육지원청 지산중학교,22,22,0,22,15,7,0,0
교육기관,교육부,지한유치원,교육부 광주광역시교육청 광주광역시동부교육지원청 지한유치원,14,14,0,14,14,0,0,0
교육기관,교육부,지한초등학교,교육부 광주광역시교육청 광주광역시동부교육지원청 지한초등학교,17,17,0,17,15,2,0,0
교육기관,교육부,청담유치원,교육부 광주광역시교육청 광주광역시동부교육지원청 청담유치원,16,2,14,2,0,2,0,0
교육기관,교육부,코리아유치원,교육부 광주광역시교육청 광주광역시동부교육지원청 코리아유치원,16,16,0,16,3,12,0,1
교육기관,교육부,키즈금강유치원,교육부 광주광역시교육청 광주광역시동부교육지원청 키즈금강유치원,16,16,0,16,8,8,0,0
교육기관,교육부,키즈캐슬유치원,교육부 광주광역시교육청 광주광역시동부교육지원청 키즈캐슬유치원,19,0,19,0,0,0,0,0
교육기관,교육부,태봉초등학교,교육부 광주광역시교육청 광주광역시동부교육지원청 태봉초등학교,16,16,0,16,10,2,2,2
교육기관,교육부,푸른숲유치원,교육부 광주광역시교육청 광주광역시동부교육지원청 푸른숲유치원,16,16,0,16,12,3,0,1
교육기관,교육부,프란치스카유치원,교육부 광주광역시교육청 광주광역시동부교육지원청 프란치스카유치원,8,8,0,8,2,5,1,0
교육기관,교육부,하나유치원,교육부 광주광역시교육청 광주광역시동부교육지원청 하나유치원,16,16,0,16,2,14,0,0
교육기관,교육부,하늘동화유치원,교육부 광주광역시교육청 광주광역시동부교육지원청 하늘동화유치원,16,7,9,7,2,3,1,1
교육기관,교육부,하백초등학교,교육부 광주광역시교육청 광주광역시동부교육지원청 하백초등학교,14,14,0,14,14,0,0,0
교육기관,교육부,한나래유치원,교육부 광주광역시교육청 광주광역시동부교육지원청 한나래유치원,9,9,0,9,0,9,0,0
교육기관,교육부,한빛유치원,교육부 광주광역시교육청 광주광역시동부교육지원청 한빛유치원,8,2,6,2,2,0,0,0
교육기관,교육부,한솔유치원,교육부 광주광역시교육청 광주광역시동부교육지원청 한솔유치원,12,2,10,2,1,1,0,0
교육기관,교육부,한울초등학교,교육부 광주광역시교육청 광주광역시동부교육지원청 한울초등학교,12,12,0,12,12,0,0,0
교육기관,교육부,해성유치원,교육부 광주광역시교육청 광주광역시동부교육지원청 해성유치원,8,1,7,1,1,0,0,0
교육기관,교육부,현대유치원,교육부 광주광역시교육청 광주광역시동부교육지원청 현대유치원,24,24,0,24,12,12,0,0
교육기관,교육부,광주광역시서부교육지원청,교육부 광주광역시교육청 광주광역시서부교육지원청,26,26,0,26,12,14,0,0
교육기관,교육부,계수초등학교,교육부 광주광역시교육청 광주광역시서부교육지원청 계수초등학교,11,11,0,11,11,0,0,0
교육기관,교육부,고실중학교,교육부 광주광역시교육청 광주광역시서부교육지원청 고실중학교,37,37,0,37,12,25,0,0
교육기관,교육부,고실초등학교,교육부 광주광역시교육청 광주광역시서부교육지원청 고실초등학교,16,16,0,16,6,10,0,0
교육기관,교육부,광덕중학교,교육부 광주광역시교육청 광주광역시서부교육지원청 광덕중학교,15,15,0,15,0,15,0,0
교육기관,교육부,광림초등학교,교육부 광주광역시교육청 광주광역시서부교육지원청 광림초등학교,8,8,0,8,8,0,0,0
교육기관,교육부,광산중학교,교육부 광주광역시교육청 광주광역시서부교육지원청 광산중학교,20,20,0,20,2,18,0,0
교육기관,교육부,광주광천초등학교,교육부 광주광역시교육청 광주광역시서부교육지원청 광주광천초등학교,13,13,0,13,2,11,0,0
교육기관,교육부,광주극락초등학교,교육부 광주광역시교육청 광주광역시서부교육지원청 광주극락초등학교,12,12,0,12,9,3,0,0
교육기관,교육부,광주농성초등학교,교육부 광주광역시교육청 광주광역시서부교육지원청 광주농성초등학교,21,21,0,21,20,1,0,0
교육기관,교육부,광주대성초등학교,교육부 광주광역시교육청 광주광역시서부교육지원청 광주대성초등학교,18,18,0,18,18,0,0,0
교육기관,교육부,광주동명중학교,교육부 광주광역시교육청 광주광역시서부교육지원청 광주동명중학교,18,18,0,18,15,3,0,0
교육기관,교육부,광주무진중학교,교육부 광주광역시교육청 광주광역시서부교육지원청 광주무진중학교,22,22,0,22,22,0,0,0
교육기관,교육부,광주방림초등학교,교육부 광주광역시교육청 광주광역시서부교육지원청 광주방림초등학교,9,9,0,9,0,9,0,0
교육기관,교육부,광주백운초등학교,교육부 광주광역시교육청 광주광역시서부교육지원청 광주백운초등학교,18,18,0,18,0,18,0,0
교육기관,교육부,광주봉주초등학교,교육부 광주광역시교육청 광주광역시서부교육지원청 광주봉주초등학교,20,20,0,20,20,0,0,0
교육기관,교육부,광주삼육유치원,교육부 광주광역시교육청 광주광역시서부교육지원청 광주삼육유치원,19,19,0,19,3,16,0,0
교육기관,교육부,광주삼육초등학교,교육부 광주광역시교육청 광주광역시서부교육지원청 광주삼육초등학교,30,30,0,30,3,26,0,1
교육기관,교육부,광주상무초등학교,교육부 광주광역시교육청 광주광역시서부교육지원청 광주상무초등학교,16,16,0,16,15,0,1,0
교육기관,교육부,광주서광중학교,교육부 광주광역시교육청 광주광역시서부교육지원청 광주서광중학교,20,20,0,20,20,0,0,0
교육기관,교육부,광주서석중학교,교육부 광주광역시교육청 광주광역시서부교육지원청 광주서석중학교,23,23,0,23,9,14,0,0
교육기관,교육부,광주서초등학교,교육부 광주광역시교육청 광주광역시서부교육지원청 광주서초등학교,20,20,0,20,20,0,0,0
교육기관,교육부,광주송원중학교,교육부 광주광역시교육청 광주광역시서부교육지원청 광주송원중학교,24,24,0,24,24,0,0,0
교육기관,교육부,광주송원초등학교,교육부 광주광역시교육청 광주광역시서부교육지원청 광주송원초등학교,34,34,0,34,8,17,3,6
교육기관,교육부,광주양동초등학교,교육부 광주광역시교육청 광주광역시서부교육지원청 광주양동초등학교,19,18,1,18,18,0,0,0
교육기관,교육부,광주월산초등학교,교육부 광주광역시교육청 광주광역시서부교육지원청 광주월산초등학교,14,14,0,14,12,2,0,0
교육기관,교육부,광주제석초등학교,교육부 광주광역시교육청 광주광역시서부교육지원청 광주제석초등학교,15,15,0,15,0,15,0,0
교육기관,교육부,광주중앙유치원,교육부 광주광역시교육청 광주광역시서부교육지원청 광주중앙유치원,20,0,20,0,0,0,0,0
교육기관,교육부,광주중학교,교육부 광주광역시교육청 광주광역시서부교육지원청 광주중학교,13,13,0,13,3,10,0,0
교육기관,교육부,광주학강초등학교,교육부 광주광역시교육청 광주광역시서부교육지원청 광주학강초등학교,16,16,0,16,0,16,0,0
교육기관,교육부,광주화정중학교,교육부 광주광역시교육청 광주광역시서부교육지원청 광주화정중학교,22,0,22,0,0,0,0,0
교육기관,교육부,광주화정초등학교,교육부 광주광역시교육청 광주광역시서부교육지원청 광주화정초등학교,9,9,0,9,9,0,0,0
교육기관,교육부,광주효광중학교,교육부 광주광역시교육청 광주광역시서부교육지원청 광주효광중학교,11,11,0,11,6,5,0,0
교육기관,교육부,광주효덕초등학교,교육부 광주광역시교육청 광주광역시서부교육지원청 광주효덕초등학교,24,24,0,24,24,0,0,0
교육기관,교육부,그랜드유치원,교육부 광주광역시교육청 광주광역시서부교육지원청 그랜드유치원,20,0,20,0,0,0,0,0
교육기관,교육부,금강해피랜드유치원,교육부 광주광역시교육청 광주광역시서부교육지원청 금강해피랜드유치원,15,15,0,15,0,15,0,0
교육기관,교육부,금구중학교,교육부 광주광역시교육청 광주광역시서부교육지원청 금구중학교,15,15,0,15,4,11,0,0
교육기관,교육부,금구초등학교,교육부 광주광역시교육청 광주광역시서부교육지원청 금구초등학교,10,10,0,10,0,10,0,0
교육기관,교육부,금당중학교,교육부 광주광역시교육청 광주광역시서부교육지원청 금당중학교,28,28,0,28,28,0,0,0
교육기관,교육부,금당초등학교,교육부 광주광역시교육청 광주광역시서부교육지원청 금당초등학교,16,16,0,16,16,0,0,0
교육기관,교육부,금부초등학교,교육부 광주광역시교육청 광주광역시서부교육지원청 금부초등학교,17,17,0,17,17,0,0,0
교육기관,교육부,금호중학교,교육부 광주광역시교육청 광주광역시서부교육지원청 금호중학교,26,26,0,26,10,16,0,0
교육기관,교육부,금호초등학교,교육부 광주광역시교육청 광주광역시서부교육지원청 금호초등학교,16,16,0,16,16,0,0,0
교육기관,교육부,기쁨유치원,교육부 광주광역시교육청 광주광역시서부교육지원청 기쁨유치원,16,16,0,16,1,15,0,0
교육기관,교육부,까리따스유치원,교육부 광주광역시교육청 광주광역시서부교육지원청 까리따스유치원,29,4,25,4,3,1,0,0
교육기관,교육부,꿈그린유치원,교육부 광주광역시교육청 광주광역시서부교육지원청 꿈그린유치원,11,11,0,11,2,9,0,0
교육기관,교육부,남광유치원,교육부 광주광역시교육청 광주광역시서부교육지원청 남광유치원,9,9,0,9,2,7,0,0
교육기관,교육부,다온유치원,교육부 광주광역시교육청 광주광역시서부교육지원청 다온유치원,8,8,0,8,0,8,0,0
교육기관,교육부,대반초등학교,교육부 광주광역시교육청 광주광역시서부교육지원청 대반초등학교,12,11,1,11,0,11,0,0
교육기관,교육부,대성여자중학교,교육부 광주광역시교육청 광주광역시서부교육지원청 대성여자중학교,20,19,1,19,0,19,0,0
교육기관,교육부,대자중학교,교육부 광주광역시교육청 광주광역시서부교육지원청 대자중학교,19,19,0,19,19,0,0,0
교육기관,교육부,대촌중앙초등학교,교육부 광주광역시교육청 광주광역시서부교육지원청 대촌중앙초등학교,13,13,0,13,13,0,0,0
교육기관,교육부,대촌중학교,교육부 광주광역시교육청 광주광역시서부교육지원청 대촌중학교,10,10,0,10,10,0,0,0
교육기관,교육부,더선우유치원,교육부 광주광역시교육청 광주광역시서부교육지원청 더선우유치원,23,23,0,23,2,21,0,0
교육기관,교육부,도날드유치원,교육부 광주광역시교육청 광주광역시서부교육지원청 도날드유치원,9,2,7,2,0,2,0,0
교육기관,교육부,도산초등학교,교육부 광주광역시교육청 광주광역시서부교육지원청 도산초등학교,10,10,0,10,5,5,0,0
교육기관,교육부,동곡초등학교,교육부 광주광역시교육청 광주광역시서부교육지원청 동곡초등학교,9,9,0,9,3,6,0,0
교육기관,교육부,동성중학교,교육부 광주광역시교육청 광주광역시서부교육지원청 동성중학교,12,12,0,12,6,6,0,0
교육기관,교육부,동아여자중학교,교육부 광주광역시교육청 광주광역시서부교육지원청 동아여자중학교,31,31,0,31,0,31,0,0
교육기관,교육부,든해솔유치원,교육부 광주광역시교육청 광주광역시서부교육지원청 든해솔유치원,16,16,0,16,2,14,0,0
교육기관,교육부,리더스유치원,교육부 광주광역시교육청 광주광역시서부교육지원청 리더스유치원,25,25,0,25,25,0,0,0
교육기관,교육부,리틀윌링스유치원,교육부 광주광역시교육청 광주광역시서부교육지원청 리틀윌링스유치원,16,16,0,16,8,8,0,0
교육기관,교육부,마재초등학교,교육부 광주광역시교육청 광주광역시서부교육지원청 마재초등학교,8,8,0,8,4,4,0,0
교육기관,교육부,마지초등학교,교육부 광주광역시교육청 광주광역시서부교육지원청 마지초등학교,18,18,0,18,18,0,0,0
교육기관,교육부,만호초등학교,교육부 광주광역시교육청 광주광역시서부교육지원청 만호초등학교,20,20,0,20,10,10,0,0
교육기관,교육부,메이플유치원,교육부 광주광역시교육청 광주광역시서부교육지원청 메이플유치원,20,4,16,4,4,0,0,0
교육기관,교육부,모모유치원,교육부 광주광역시교육청 광주광역시서부교육지원청 모모유치원,10,3,7,3,2,1,0,0
교육기관,교육부,목련초등학교,교육부 광주광역시교육청 광주광역시서부교육지원청 목련초등학교,13,13,0,13,13,0,0,0
교육기관,교육부,무학초등학교,교육부 광주광역시교육청 광주광역시서부교육지원청 무학초등학교,13,13,0,13,13,0,0,0
교육기관,교육부,문성중학교,교육부 광주광역시교육청 광주광역시서부교육지원청 문성중학교,8,8,0,8,0,8,0,0
교육기관,교육부,문정누리유치원,교육부 광주광역시교육청 광주광역시서부교육지원청 문정누리유치원,13,13,0,13,13,0,0,0
교육기관,교육부,방림유치원,교육부 광주광역시교육청 광주광역시서부교육지원청 방림유치원,8,8,0,8,0,8,0,0
교육기관,교육부,별아이유치원,교육부 광주광역시교육청 광주광역시서부교육지원청 별아이유치원,12,12,0,12,6,6,0,0
교육기관,교육부,본량초등학교,교육부 광주광역시교육청 광주광역시서부교육지원청 본량초등학교,8,8,0,8,8,0,0,0
교육기관,교육부,봉산유치원,교육부 광주광역시교육청 광주광역시서부교육지원청 봉산유치원,5,5,0,5,0,5,0,0
교육기관,교육부,봉산중학교,교육부 광주광역시교육청 광주광역시서부교육지원청 봉산중학교,30,30,0,30,1,29,0,0
교육기관,교육부,봉선중학교,교육부 광주광역시교육청 광주광역시서부교육지원청 봉선중학교,23,23,0,23,0,23,0,0
교육기관,교육부,봉선초등학교,교육부 광주광역시교육청 광주광역시서부교육지원청 봉선초등학교,20,20,0,20,20,0,0,0
교육기관,교육부,불로초등학교,교육부 광주광역시교육청 광주광역시서부교육지원청 불로초등학교,12,12,0,12,12,0,0,0
교육기관,교육부,비아초등학교,교육부 광주광역시교육청 광주광역시서부교육지원청 비아초등학교,13,13,0,13,0,13,0,0
교육기관,교육부,빛고을유치원,교육부 광주광역시교육청 광주광역시서부교육지원청 빛고을유치원,8,8,0,8,0,8,0,0
교육기관,교육부,빛고을초등학교,교육부 광주광역시교육청 광주광역시서부교육지원청 빛고을초등학교,16,13,3,13,0,13,0,0
교육기관,교육부,빛여울초등학교,교육부 광주광역시교육청 광주광역시서부교육지원청 빛여울초등학교,16,16,0,16,15,1,0,0
교육기관,교육부,산들바람유치원,교육부 광주광역시교육청 광주광역시서부교육지원청 산들바람유치원,0,0,0,0,0,0,0,0
교육기관,교육부,산새소리유치원,교육부 광주광역시교육청 광주광역시서부교육지원청 산새소리유치원,12,12,0,12,0,12,0,0
교육기관,교육부,산월초등학교,교육부 광주광역시교육청 광주광역시서부교육지원청 산월초등학교,14,14,0,14,0,14,0,0
교육기관,교육부,산정중학교,교육부 광주광역시교육청 광주광역시서부교육지원청 산정중학교,35,35,0,35,12,23,0,0
교육기관,교육부,산정초등학교,교육부 광주광역시교육청 광주광역시서부교육지원청 산정초등학교,11,11,0,11,11,0,0,0
교육기관,교육부,살레시오초등학교,교육부 광주광역시교육청 광주광역시서부교육지원청 살레시오초등학교,24,24,0,24,24,0,0,0
교육기관,교육부,삼도초등학교,교육부 광주광역시교육청 광주광역시서부교육지원청 삼도초등학교,14,14,0,14,0,14,0,0
교육기관,교육부,삼성유치원,교육부 광주광역시교육청 광주광역시서부교육지원청 삼성유치원,18,4,14,4,1,1,1,1
교육기관,교육부,상일중학교,교육부 광주광역시교육청 광주광역시서부교육지원청 상일중학교,37,37,0,37,15,22,0,0
교육기관,교육부,새별초등학교,교육부 광주광역시교육청 광주광역시서부교육지원청 새별초등학교,11,11,0,11,9,2,0,0
교육기관,교육부,서광초등학교,교육부 광주광역시교육청 광주광역시서부교육지원청 서광초등학교,16,16,0,16,12,4,0,0
교육기관,교육부,선우유치원,교육부 광주광역시교육청 광주광역시서부교육지원청 선우유치원,26,26,0,26,3,22,1,0
교육기관,교육부,선운중학교,교육부 광주광역시교육청 광주광역시서부교육지원청 선운중학교,35,35,0,35,34,1,0,0
교육기관,교육부,선운초등학교,교육부 광주광역시교육청 광주광역시서부교육지원청 선운초등학교,19,19,0,19,19,0,0,0
교육기관,교육부,선창유치원,교육부 광주광역시교육청 광주광역시서부교육지원청 선창유치원,15,15,0,15,0,15,0,0
교육기관,교육부,선창초등학교,교육부 광주광역시교육청 광주광역시서부교육지원청 선창초등학교,14,14,0,14,8,4,1,1
교육기관,교육부,성균관유치원,교육부 광주광역시교육청 광주광역시서부교육지원청 성균관유치원,24,24,0,24,2,22,0,0
교육기관,교육부,성덕중학교,교육부 광주광역시교육청 광주광역시서부교육지원청 성덕중학교,17,17,0,17,13,4,0,0
교육기관,교육부,성덕초등학교,교육부 광주광역시교육청 광주광역시서부교육지원청 성덕초등학교,22,22,0,22,0,22,0,0
교육기관,교육부,성모남해유치원,교육부 광주광역시교육청 광주광역시서부교육지원청 성모남해유치원,20,20,0,20,0,20,0,0
교육기관,교육부,성진초등학교,교육부 광주광역시교육청 광주광역시서부교육지원청 성진초등학교,8,8,0,8,5,3,0,0
교육기관,교육부,세운그림유치원,교육부 광주광역시교육청 광주광역시서부교육지원청 세운그림유치원,24,4,20,4,1,1,1,1
교육기관,교육부,세종유치원,교육부 광주광역시교육청 광주광역시서부교육지원청 세종유치원,20,20,0,20,16,4,0,0
교육기관,교육부,세한유치원,교육부 광주광역시교육청 광주광역시서부교육지원청 세한유치원,8,1,7,1,0,1,0,0
교육기관,교육부,소향유치원,교육부 광주광역시교육청 광주광역시서부교육지원청 소향유치원,13,0,13,0,0,0,0,0
교육기관,교육부,송광중학교,교육부 광주광역시교육청 광주광역시서부교육지원청 송광중학교,17,17,0,17,0,17,0,0
교육기관,교육부,송우초등학교,교육부 광주광역시교육청 광주광역시서부교육지원청 송우초등학교,19,19,0,19,5,14,0,0
교육기관,교육부,송원유치원,교육부 광주광역시교육청 광주광역시서부교육지원청 송원유치원,11,2,9,2,1,1,0,0
교육기관,교육부,송정동초등학교,교육부 광주광역시교육청 광주광역시서부교육지원청 송정동초등학교,12,12,0,12,0,12,0,0
교육기관,교육부,송정서초등학교,교육부 광주광역시교육청 광주광역시서부교육지원청 송정서초등학교,15,15,0,15,0,15,0,0
교육기관,교육부,송정중앙초등학교,교육부 광주광역시교육청 광주광역시서부교육지원청 송정중앙초등학교,18,18,0,18,2,16,0,0
교육기관,교육부,송정중학교,교육부 광주광역시교육청 광주광역시서부교육지원청 송정중학교,20,20,0,20,20,0,0,0
교육기관,교육부,송정초등학교,교육부 광주광역시교육청 광주광역시서부교육지원청 송정초등학교,14,14,0,14,14,0,0,0
교육기관,교육부,송학초등학교,교육부 광주광역시교육청 광주광역시서부교육지원청 송학초등학교,12,12,0,12,0,12,0,0
교육기관,교육부,수문초등학교,교육부 광주광역시교육청 광주광역시서부교육지원청 수문초등학교,16,16,0,16,0,16,0,0
교육기관,교육부,수완중학교,교육부 광주광역시교육청 광주광역시서부교육지원청 수완중학교,27,27,0,27,27,0,0,0
교육기관,교육부,수완초등학교,교육부 광주광역시교육청 광주광역시서부교육지원청 수완초등학교,35,35,0,35,35,0,0,0
교육기관,교육부,수완하나중학교,교육부 광주광역시교육청 광주광역시서부교육지원청 수완하나중학교,23,23,0,23,2,21,0,0
교육기관,교육부,수피아여자중학교,교육부 광주광역시교육청 광주광역시서부교육지원청 수피아여자중학교,22,22,0,22,0,22,0,0
교육기관,교육부,숭의중학교,교육부 광주광역시교육청 광주광역시서부교육지원청 숭의중학교,16,16,0,16,0,16,0,0
교육기관,교육부,숲사랑유치원,교육부 광주광역시교육청 광주광역시서부교육지원청 숲사랑유치원,32,32,0,32,5,27,0,0
교육기관,교육부,슈에뜨유치원,교육부 광주광역시교육청 광주광역시서부교육지원청 슈에뜨유치원,12,0,12,0,0,0,0,0
교육기관,교육부,신가중학교,교육부 광주광역시교육청 광주광역시서부교육지원청 신가중학교,19,19,0,19,9,10,0,0
교육기관,교육부,신나는유치원,교육부 광주광역시교육청 광주광역시서부교육지원청 신나는유치원,18,18,0,18,17,1,0,0
교육기관,교육부,신미라유치원,교육부 광주광역시교육청 광주광역시서부교육지원청 신미라유치원,32,32,0,32,3,29,0,0
교육기관,교육부,신암초등학교,교육부 광주광역시교육청 광주광역시서부교육지원청 신암초등학교,22,18,4,18,18,0,0,0
교육기관,교육부,신창중학교,교육부 광주광역시교육청 광주광역시서부교육지원청 신창중학교,22,22,0,22,0,22,0,0
교육기관,교육부,신창초등학교,교육부 광주광역시교육청 광주광역시서부교육지원청 신창초등학교,16,16,0,16,16,0,0,0
교육기관,교육부,썸머힐유치원,교육부 광주광역시교육청 광주광역시서부교육지원청 썸머힐유치원,15,15,0,15,0,15,0,0
교육기관,교육부,아이사랑유치원,교육부 광주광역시교육청 광주광역시서부교육지원청 아이사랑유치원,34,34,0,34,6,28,0,0
교육기관,교육부,아이숲유치원,교육부 광주광역시교육청 광주광역시서부교육지원청 아이숲유치원,16,16,0,16,3,13,0,0
교육기관,교육부,아이원유치원,교육부 광주광역시교육청 광주광역시서부교육지원청 아이원유치원,28,28,0,28,2,24,1,1
교육기관,교육부,아이위드유치원,교육부 광주광역시교육청 광주광역시서부교육지원청 아이위드유치원,22,22,0,22,5,17,0,0
교육기관,교육부,어등초등학교,교육부 광주광역시교육청 광주광역시서부교육지원청 어등초등학교,15,14,1,14,14,0,0,0
교육기관,교육부,어룡초등학교,교육부 광주광역시교육청 광주광역시서부교육지원청 어룡초등학교,13,13,0,13,13,0,0,0
교육기관,교육부,염주초등학교,교육부 광주광역시교육청 광주광역시서부교육지원청 염주초등학교,14,14,0,14,14,0,0,0
교육기관,교육부,영천중학교,교육부 광주광역시교육청 광주광역시서부교육지원청 영천중학교,15,15,0,15,4,11,0,0
교육기관,교육부,영천초등학교,교육부 광주광역시교육청 광주광역시서부교육지원청 영천초등학교,11,11,0,11,9,0,2,0
교육기관,교육부,예닮몬테소리유치원,교육부 광주광역시교육청 광주광역시서부교육지원청 예닮몬테소리유치원,20,20,0,20,1,17,2,0
교육기관,교육부,예향유치원,교육부 광주광역시교육청 광주광역시서부교육지원청 예향유치원,10,10,0,10,0,10,0,0
교육기관,교육부,우암유치원,교육부 광주광역시교육청 광주광역시서부교육지원청 우암유치원,15,2,13,2,1,1,0,0
교육기관,교육부,운남중학교,교육부 광주광역시교육청 광주광역시서부교육지원청 운남중학교,13,9,4,9,9,0,0,0
교육기관,교육부,운남초등학교,교육부 광주광역시교육청 광주광역시서부교육지원청 운남초등학교,14,14,0,14,1,11,1,1
교육기관,교육부,운리중학교,교육부 광주광역시교육청 광주광역시서부교육지원청 운리중학교,58,58,0,58,0,58,0,0
교육기관,교육부,운리초등학교,교육부 광주광역시교육청 광주광역시서부교육지원청 운리초등학교,15,15,0,15,5,10,0,0
교육기관,교육부,운천초등학교,교육부 광주광역시교육청 광주광역시서부교육지원청 운천초등학교,16,16,0,16,16,0,0,0
교육기관,교육부,월계중학교,교육부 광주광역시교육청 광주광역시서부교육지원청 월계중학교,19,19,0,19,9,4,4,2
교육기관,교육부,월계초등학교,교육부 광주광역시교육청 광주광역시서부교육지원청 월계초등학교,22,22,0,22,0,22,0,0
교육기관,교육부,월곡중학교,교육부 광주광역시교육청 광주광역시서부교육지원청 월곡중학교,33,33,0,33,0,33,0,0
교육기관,교육부,월곡초등학교,교육부 광주광역시교육청 광주광역시서부교육지원청 월곡초등학교,14,14,0,14,1,13,0,0
교육기관,교육부,월봉중학교,교육부 광주광역시교육청 광주광역시서부교육지원청 월봉중학교,26,26,0,26,13,13,0,0
교육기관,교육부,월봉초등학교,교육부 광주광역시교육청 광주광역시서부교육지원청 월봉초등학교,16,16,0,16,16,0,0,0
교육기관,교육부,위즈캐슬유치원,교육부 광주광역시교육청 광주광역시서부교육지원청 위즈캐슬유치원,48,48,0,48,22,22,4,0
교육기관,교육부,윌링스플러스유치원,교육부 광주광역시교육청 광주광역시서부교육지원청 윌링스플러스유치원,15,0,15,0,0,0,0,0
교육기관,교육부,유덕초등학교,교육부 광주광역시교육청 광주광역시서부교육지원청 유덕초등학교,14,14,0,14,0,14,0,0
교육기관,교육부,유앤미유치원,교육부 광주광역시교육청 광주광역시서부교육지원청 유앤미유치원,27,27,0,27,1,24,1,1
교육기관,교육부,유촌초등학교,교육부 광주광역시교육청 광주광역시서부교육지원청 유촌초등학교,12,12,0,12,2,7,3,0
교육기관,교육부,은빛초등학교,교육부 광주광역시교육청 광주광역시서부교육지원청 은빛초등학교,16,16,0,16,16,0,0,0
교육기관,교육부,은송몬테소리유치원,교육부 광주광역시교육청 광주광역시서부교육지원청 은송몬테소리유치원,10,10,0,10,1,9,0,0
교육기관,교육부,인스나인유치원,교육부 광주광역시교육청 광주광역시서부교육지원청 인스나인유치원,16,3,13,3,1,1,1,0
교육기관,교육부,인애유치원,교육부 광주광역시교육청 광주광역시서부교육지원청 인애유치원,11,3,8,3,2,1,0,0
교육기관,교육부,임곡중학교,교육부 광주광역시교육청 광주광역시서부교육지원청 임곡중학교,16,16,0,16,8,8,0,0
교육기관,교육부,임곡초등학교,교육부 광주광역시교육청 광주광역시서부교육지원청 임곡초등학교,8,8,0,8,8,0,0,0
교육기관,교육부,장덕중학교,교육부 광주광역시교육청 광주광역시서부교육지원청 장덕중학교,21,21,0,21,2,19,0,0
교육기관,교육부,장덕초등학교,교육부 광주광역시교육청 광주광역시서부교육지원청 장덕초등학교,24,24,0,24,20,4,0,0
교육기관,교육부,장산초등학교,교육부 광주광역시교육청 광주광역시서부교육지원청 장산초등학교,20,20,0,20,20,0,0,0
교육기관,교육부,전남중학교,교육부 광주광역시교육청 광주광역시서부교육지원청 전남중학교,16,16,0,16,4,12,0,0
교육기관,교육부,정광중학교,교육부 광주광역시교육청 광주광역시서부교육지원청 정광중학교,20,18,2,18,0,18,0,0
교육기관,교육부,정암초등학교,교육부 광주광역시교육청 광주광역시서부교육지원청 정암초등학교,19,19,0,19,2,13,0,4
교육기관,교육부,조봉초등학교,교육부 광주광역시교육청 광주광역시서부교육지원청 조봉초등학교,12,12,0,12,0,12,0,0
교육기관,교육부,조하유치원,교육부 광주광역시교육청 광주광역시서부교육지원청 조하유치원,16,16,0,16,8,8,0,0
교육기관,교육부,주월중학교,교육부 광주광역시교육청 광주광역시서부교육지원청 주월중학교,12,5,7,5,2,3,0,0
교육기관,교육부,주월초등학교,교육부 광주광역시교육청 광주광역시서부교육지원청 주월초등학교,23,23,0,23,20,3,0,0
교육기관,교육부,지예유치원,교육부 광주광역시교육청 광주광역시서부교육지원청 지예유치원,24,6,18,6,3,3,0,0
교육기관,교육부,진남유치원,교육부 광주광역시교육청 광주광역시서부교육지원청 진남유치원,8,8,0,8,0,8,0,0
교육기관,교육부,진남중학교,교육부 광주광역시교육청 광주광역시서부교육지원청 진남중학교,9,9,0,9,7,2,0,0
교육기관,교육부,진남초등학교,교육부 광주광역시교육청 광주광역시서부교육지원청 진남초등학교,9,9,0,9,4,5,0,0
교육기관,교육부,진만초등학교,교육부 광주광역시교육청 광주광역시서부교육지원청 진만초등학교,11,11,0,11,11,0,0,0
교육기관,교육부,진월초등학교,교육부 광주광역시교육청 광주광역시서부교육지원청 진월초등학교,11,11,0,11,0,11,0,0
교육기관,교육부,진제초등학교,교육부 광주광역시교육청 광주광역시서부교육지원청 진제초등학교,13,13,0,13,13,0,0,0
교육기관,교육부,진흥중학교,교육부 광주광역시교육청 광주광역시서부교육지원청 진흥중학교,14,14,0,14,2,12,0,0
교육기관,교육부,창의유치원,교육부 광주광역시교육청 광주광역시서부교육지원청 창의유치원,13,2,11,2,2,0,0,0
교육기관,교육부,천곡중학교,교육부 광주광역시교육청 광주광역시서부교육지원청 천곡중학교,17,17,0,17,9,4,4,0
교육기관,교육부,천사유치원,교육부 광주광역시교육청 광주광역시서부교육지원청 천사유치원,0,0,0,0,0,0,0,0
교육기관,교육부,첨단중학교,교육부 광주광역시교육청 광주광역시서부교육지원청 첨단중학교,25,10,15,10,0,10,0,0
교육기관,교육부,첨단초등학교,교육부 광주광역시교육청 광주광역시서부교육지원청 첨단초등학교,14,14,0,14,11,2,1,0
교육기관,교육부,치평중학교,교육부 광주광역시교육청 광주광역시서부교육지원청 치평중학교,4,4,0,4,0,4,0,0
교육기관,교육부,치평초등학교,교육부 광주광역시교육청 광주광역시서부교육지원청 치평초등학교,18,18,0,18,10,8,0,0
교육기관,교육부,큰별유치원,교육부 광주광역시교육청 광주광역시서부교육지원청 큰별유치원,8,4,4,4,2,2,0,0
교육기관,교육부,큰별초등학교,교육부 광주광역시교육청 광주광역시서부교육지원청 큰별초등학교,17,17,0,17,0,17,0,0
교육기관,교육부,큰빛자연생태유치원,교육부 광주광역시교육청 광주광역시서부교육지원청 큰빛자연생태유치원,16,16,0,16,2,14,0,0
교육기관,교육부,큰솔유치원,교육부 광주광역시교육청 광주광역시서부교육지원청 큰솔유치원,32,10,22,10,3,7,0,0
교육기관,교육부,키즈웰유치원,교육부 광주광역시교육청 광주광역시서부교육지원청 키즈웰유치원,16,3,13,3,3,0,0,0
교육기관,교육부,평동중학교,교육부 광주광역시교육청 광주광역시서부교육지원청 평동중학교,17,17,0,17,8,8,1,0
교육기관,교육부,평동초등학교,교육부 광주광역시교육청 광주광역시서부교육지원청 평동초등학교,9,9,0,9,0,9,0,0
교육기관,교육부,풍암중학교,교육부 광주광역시교육청 광주광역시서부교육지원청 풍암중학교,14,12,2,12,8,2,1,1
교육기관,교육부,풍암초등학교,교육부 광주광역시교육청 광주광역시서부교육지원청 풍암초등학교,19,19,0,19,19,0,0,0
교육기관,교육부,풍영초등학교,교육부 광주광역시교육청 광주광역시서부교육지원청 풍영초등학교,16,16,0,16,16,0,0,0
교육기관,교육부,하남중앙초등학교,교육부 광주광역시교육청 광주광역시서부교육지원청 하남중앙초등학교,15,15,0,15,15,0,0,0
교육기관,교육부,하남중학교,교육부 광주광역시교육청 광주광역시서부교육지원청 하남중학교,24,24,0,24,19,5,0,0
교육기관,교육부,하남초등학교,교육부 광주광역시교육청 광주광역시서부교육지원청 하남초등학교,17,17,0,17,11,2,3,1
교육기관,교육부,해달유치원,교육부 광주광역시교육청 광주광역시서부교육지원청 해달유치원,19,19,0,19,3,16,0,0
교육기관,교육부,해밀유치원,교육부 광주광역시교육청 광주광역시서부교육지원청 해밀유치원,16,16,0,16,0,16,0,0
교육기관,교육부,현대리나숲유치원,교육부 광주광역시교육청 광주광역시서부교육지원청 현대리나숲유치원,16,16,0,16,2,14,0,0
교육기관,교육부,호남삼육중학교,교육부 광주광역시교육청 광주광역시서부교육지원청 호남삼육중학교,50,50,0,50,0,50,0,0
교육기관,교육부,홉스쿨유치원,교육부 광주광역시교육청 광주광역시서부교육지원청 홉스쿨유치원,46,1,45,1,1,0,0,0
교육기관,교육부,화개초등학교,교육부 광주광역시교육청 광주광역시서부교육지원청 화개초등학교,14,14,0,14,14,0,0,0
교육기관,교육부,화운유치원,교육부 광주광역시교육청 광주광역시서부교육지원청 화운유치원,8,8,0,8,0,8,0,0
교육기관,교육부,화정남초등학교,교육부 광주광역시교육청 광주광역시서부교육지원청 화정남초등학교,15,15,0,15,10,2,2,1
교육기관,교육부,효광초등학교,교육부 광주광역시교육청 광주광역시서부교육지원청 효광초등학교,27,27,0,27,0,27,0,0
교육기관,교육부,효천다솜유치원,교육부 광주광역시교육청 광주광역시서부교육지원청 효천다솜유치원,12,12,0,12,0,12,0,0
교육기관,교육부,효천중학교,교육부 광주광역시교육청 광주광역시서부교육지원청 효천중학교,36,36,0,36,0,36,0,0
교육기관,교육부,효천초등학교,교육부 광주광역시교육청 광주광역시서부교육지원청 효천초등학교,13,13,0,13,5,3,4,1
교육기관,교육부,광주광역시유아교육진흥원,교육부 광주광역시교육청 광주광역시유아교육진흥원,23,7,16,7,1,6,0,0
교육기관,교육부,광주광역시창의융합교육원,교육부 광주광역시교육청 광주광역시창의융합교육원,36,36,0,36,36,0,0,0
교육기관,교육부,광주광역시학생교육원,교육부 광주광역시교육청 광주광역시학생교육원,49,49,0,49,0,49,0,0
교육기관,교육부,광주교육시민협치진흥원설립추진단,교육부 광주광역시교육청 광주교육시민협치진흥원설립추진단,8,8,0,8,5,3,0,0
교육기관,교육부,광주대동고등학교,교육부 광주광역시교육청 광주대동고등학교,24,23,1,23,0,23,0,0
교육기관,교육부,광주동신고등학교,교육부 광주광역시교육청 광주동신고등학교,30,30,0,30,0,30,0,0
교육기관,교육부,광주동신여자고등학교,교육부 광주광역시교육청 광주동신여자고등학교,17,17,0,17,13,4,0,0
교육기관,교육부,광주서석고등학교,교육부 광주광역시교육청 광주서석고등학교,20,20,0,20,11,9,0,0
교육기관,교육부,광주석산고등학교,교육부 광주광역시교육청 광주석산고등학교,30,30,0,30,0,30,0,0
교육기관,교육부,광주선광학교,교육부 광주광역시교육청 광주선광학교,21,21,0,21,21,0,0,0
교육기관,교육부,광주선명학교,교육부 광주광역시교육청 광주선명학교,13,13,0,13,0,13,0,0
교육기관,교육부,광주선우학교,교육부 광주광역시교육청 광주선우학교,11,10,1,10,6,4,0,0
교육기관,교육부,광주세광학교,교육부 광주광역시교육청 광주세광학교,15,15,0,15,15,0,0,0
교육기관,교육부,광주송정도서관,교육부 광주광역시교육청 광주송정도서관,14,14,0,14,14,0,0,0
교육기관,교육부,광주숭일고등학교,교육부 광주광역시교육청 광주숭일고등학교,37,18,19,18,0,18,0,0
교육기관,교육부,광주여자상업고등학교,교육부 광주광역시교육청 광주여자상업고등학교,14,14,0,14,7,7,0,0
교육기관,교육부,광주예술고등학교,교육부 광주광역시교육청 광주예술고등학교,72,72,0,72,19,53,0,0
교육기관,교육부,광주인성고등학교,교육부 광주광역시교육청 광주인성고등학교,16,14,2,14,9,3,1,1
교육기관,교육부,광주자동화설비공업고등학교,교육부 광주광역시교육청 광주자동화설비공업고등학교,48,34,14,34,7,27,0,0
교육기관,교육부,광주자연과학고등학교,교육부 광주광역시교육청 광주자연과학고등학교,29,29,0,29,0,29,0,0
교육기관,교육부,광주제일고등학교,교육부 광주광역시교육청 광주제일고등학교,40,40,0,40,20,20,0,0
교육기관,교육부,광주중앙도서관,교육부 광주광역시교육청 광주중앙도서관,60,60,0,60,0,60,0,0
교육기관,교육부,광주진흥고등학교,교육부 광주광역시교육청 광주진흥고등학교,56,52,4,52,26,26,0,0
교육기관,교육부,광주체육고등학교,교육부 광주광역시교육청 광주체육고등학교,81,81,0,81,81,0,0,0
교육기관,교육부,광주푸른꿈창작학교,교육부 광주광역시교육청 광주푸른꿈창작학교,45,45,0,45,0,45,0,0
교육기관,교육부,광주학생교육문화회관,교육부 광주광역시교육청 광주학생교육문화회관,52,52,0,52,0,52,0,0
교육기관,교육부,광주학생독립운동기념회관,교육부 광주광역시교육청 광주학생독립운동기념회관,59,54,5,54,0,54,0,0
교육기관,교육부,광주학생해양수련원,교육부 광주광역시교육청 광주학생해양수련원,67,67,0,67,31,36,0,0
교육기관,교육부,국제고등학교,교육부 광주광역시교육청 국제고등학교,33,31,2,31,0,31,0,0
교육기관,교육부,금파공업고등학교,교육부 광주광역시교육청 금파공업고등학교,14,14,0,14,0,14,0,0
교육기관,교육부,금호고등학교,교육부 광주광역시교육청 금호고등학교,19,19,0,19,0,19,0,0
교육기관,교육부,금호중앙여자고등학교,교육부 광주광역시교육청 금호중앙여자고등학교,25,24,1,24,2,22,0,0
교육기관,교육부,금호평생교육관,교육부 광주광역시교육청 금호평생교육관,10,10,0,10,5,5,0,0
교육기관,교육부,대광여자고등학교,교육부 광주광역시교육청 대광여자고등학교,10,10,0,10,8,2,0,0
교육기관,교육부,대성여자고등학교,교육부 광주광역시교육청 대성여자고등학교,31,29,2,29,0,29,0,0
교육기관,교육부,돈보스코학교,교육부 광주광역시교육청 돈보스코학교,16,16,0,16,16,0,0,0
교육기관,교육부,동명고등학교,교육부 광주광역시교육청 동명고등학교,52,52,0,52,0,52,0,0
교육기관,교육부,동아여자고등학교,교육부 광주광역시교육청 동아여자고등학교,24,24,0,24,20,4,0,0
교육기관,교육부,동일미래과학고등학교,교육부 광주광역시교육청 동일미래과학고등학교,27,27,0,27,27,0,0,0
교육기관,교육부,명진고등학교,교육부 광주광역시교육청 명진고등학교,18,18,0,18,0,18,0,0
교육기관,교육부,문성고등학교,교육부 광주광역시교육청 문성고등학교,11,10,1,10,0,10,0,0
교육기관,교육부,문정여자고등학교,교육부 광주광역시교육청 문정여자고등학교,29,29,0,29,29,0,0,0
교육기관,교육부,보문고등학교,교육부 광주광역시교육청 보문고등학교,41,41,0,41,0,36,5,0
교육기관,교육부,비아고등학교,교육부 광주광역시교육청 비아고등학교,33,33,0,33,6,27,0,0
교육기관,교육부,빛고을고등학교,교육부 광주광역시교육청 빛고을고등학교,46,46,0,46,3,43,0,0
교육기관,교육부,살레시오고등학교,교육부 광주광역시교육청 살레시오고등학교,55,54,1,54,20,34,0,0
교육기관,교육부,살레시오여자고등학교,교육부 광주광역시교육청 살레시오여자고등학교,21,21,0,21,4,17,0,0
교육기관,교육부,상무고등학교,교육부 광주광역시교육청 상무고등학교,38,38,0,38,0,38,0,0
교육기관,교육부,서강고등학교,교육부 광주광역시교육청 서강고등학교,44,42,2,42,36,6,0,0
교육기관,교육부,서진여자고등학교,교육부 광주광역시교육청 서진여자고등학교,22,0,22,0,0,0,0,0
교육기관,교육부,설월여자고등학교,교육부 광주광역시교육청 설월여자고등학교,35,34,1,34,30,4,0,0
교육기관,교육부,성덕고등학교,교육부 광주광역시교육청 성덕고등학교,32,31,1,31,3,24,3,1
교육기관,교육부,송원고등학교,교육부 광주광역시교육청 송원고등학교,45,45,0,45,11,34,0,0
교육기관,교육부,송원여자상업고등학교,교육부 광주광역시교육청 송원여자상업고등학교,36,36,0,36,6,30,0,0
교육기관,교육부,수완고등학교,교육부 광주광역시교육청 수완고등학교,31,29,2,29,7,22,0,0
교육기관,교육부,숭덕고등학교,교육부 광주광역시교육청 숭덕고등학교,59,59,0,59,0,59,0,0
교육기관,교육부,용연학교,교육부 광주광역시교육청 용연학교,20,20,0,20,10,10,0,0
교육기관,교육부,운남고등학교,교육부 광주광역시교육청 운남고등학교,27,27,0,27,0,27,0,0
교육기관,교육부,은혜학교,교육부 광주광역시교육청 은혜학교,41,41,0,41,0,41,0,0
교육기관,교육부,장덕고등학교,교육부 광주광역시교육청 장덕고등학교,33,33,0,33,29,2,0,2
교육기관,교육부,전남고등학교,교육부 광주광역시교육청 전남고등학교,53,53,0,53,12,41,0,0
교육기관,교육부,전남공업고등학교,교육부 광주광역시교육청 전남공업고등학교,22,22,0,22,0,22,0,0
교육기관,교육부,전남여자고등학교,교육부 광주광역시교육청 전남여자고등학교,18,18,0,18,13,5,0,0
교육기관,교육부,조선대학교부속고등학교,교육부 광주광역시교육청 조선대학교부속고등학교,38,37,1,37,3,34,0,0
교육기관,교육부,조선대학교여자고등학교,교육부 광주광역시교육청 조선대학교여자고등학교,19,19,0,19,0,19,0,0
교육기관,교육부,체육예술인성교육과,교육부 광주광역시교육청 체육예술인성교육과,7,7,0,7,0,7,0,0
교육기관,교육부,풍암고등학교,교육부 광주광역시교육청 풍암고등학교,24,24,0,24,6,18,0,0
교육기관,교육부,호남삼육고등학교,교육부 광주광역시교육청 호남삼육고등학교,24,23,1,23,22,1,0,0
교육기관,교육부,대전광역시교육청,교육부 대전광역시교육청,79,79,0,79,79,0,0,0
교육기관,교육부,계룡디지텍고등학교,교육부 대전광역시교육청 계룡디지텍고등학교,79,79,0,79,48,31,0,0
교육기관,교육부,남대전고등학교,교육부 대전광역시교육청 남대전고등학교,12,12,0,12,0,12,0,0
교육기관,교육부,대덕고등학교,교육부 대전광역시교육청 대덕고등학교,22,22,0,22,0,22,0,0
교육기관,교육부,대덕소프트웨어마이스터고등학교,교육부 대전광역시교육청 대덕소프트웨어마이스터고등학교,55,55,0,55,25,30,0,0
교육기관,교육부,대전가오고등학교,교육부 대전광역시교육청 대전가오고등학교,16,15,1,15,15,0,0,0
교육기관,교육부,대전가원학교,교육부 대전광역시교육청 대전가원학교,14,14,0,14,3,9,1,1
교육기관,교육부,대전고등학교,교육부 대전광역시교육청 대전고등학교,89,20,69,20,20,0,0,0
교육기관,교육부,대전과학고등학교,교육부 대전광역시교육청 대전과학고등학교,96,96,0,96,0,96,0,0
교육기관,교육부,대전관저고등학교,교육부 대전광역시교육청 대전관저고등학교,32,32,0,32,30,0,2,0
교육기관,교육부,대전광역시동부교육지원청,교육부 대전광역시교육청 대전광역시동부교육지원청,27,27,0,27,0,27,0,0
교육기관,교육부,대전가양유치원,교육부 대전광역시교육청 대전광역시동부교육지원청 대전가양유치원,6,6,0,6,0,6,0,0
교육기관,교육부,대전가양중학교,교육부 대전광역시교육청 대전광역시동부교육지원청 대전가양중학교,20,20,0,20,20,0,0,0
교육기관,교육부,대전가양초등학교,교육부 대전광역시교육청 대전광역시동부교육지원청 대전가양초등학교,22,22,0,22,15,7,0,0
교육기관,교육부,대전가오중학교,교육부 대전광역시교육청 대전광역시동부교육지원청 대전가오중학교,46,46,0,46,0,46,0,0
교육기관,교육부,대전가오초등학교,교육부 대전광역시교육청 대전광역시동부교육지원청 대전가오초등학교,21,21,0,21,6,14,1,0
교육기관,교육부,대전경덕중학교,교육부 대전광역시교육청 대전광역시동부교육지원청 대전경덕중학교,19,19,0,19,0,19,0,0
교육기관,교육부,대전글꽃중학교,교육부 대전광역시교육청 대전광역시동부교육지원청 대전글꽃중학교,25,16,9,16,8,8,0,0
교육기관,교육부,대전글꽃초등학교,교육부 대전광역시교육청 대전광역시동부교육지원청 대전글꽃초등학교,24,24,0,24,17,7,0,0
교육기관,교육부,대전대동초등학교,교육부 대전광역시교육청 대전광역시동부교육지원청 대전대동초등학교,23,23,0,23,23,0,0,0
교육기관,교육부,대전대룡초등학교,교육부 대전광역시교육청 대전광역시동부교육지원청 대전대룡초등학교,12,12,0,12,12,0,0,0
교육기관,교육부,대전대문중학교,교육부 대전광역시교육청 대전광역시동부교육지원청 대전대문중학교,14,14,0,14,11,3,0,0
교육기관,교육부,대전대문초등학교,교육부 대전광역시교육청 대전광역시동부교육지원청 대전대문초등학교,15,15,0,15,15,0,0,0
교육기관,교육부,대전대성여자중학교,교육부 대전광역시교육청 대전광역시동부교육지원청 대전대성여자중학교,12,12,0,12,12,0,0,0
교육기관,교육부,대전대성중학교,교육부 대전광역시교육청 대전광역시동부교육지원청 대전대성중학교,29,29,0,29,29,0,0,0
교육기관,교육부,대전대신초등학교,교육부 대전광역시교육청 대전광역시동부교육지원청 대전대신초등학교,14,14,0,14,13,0,0,1
교육기관,교육부,대전대암초등학교,교육부 대전광역시교육청 대전광역시동부교육지원청 대전대암초등학교,13,13,0,13,13,0,0,0
교육기관,교육부,대전대양초등학교,교육부 대전광역시교육청 대전광역시동부교육지원청 대전대양초등학교,22,22,0,22,22,0,0,0
교육기관,교육부,대전대청중학교,교육부 대전광역시교육청 대전광역시동부교육지원청 대전대청중학교,39,39,0,39,39,0,0,0
교육기관,교육부,대전대화중학교,교육부 대전광역시교육청 대전광역시동부교육지원청 대전대화중학교,27,27,0,27,0,27,0,0
교육기관,교육부,대전대화초등학교,교육부 대전광역시교육청 대전광역시동부교육지원청 대전대화초등학교,16,16,0,16,16,0,0,0
교육기관,교육부,대전대흥초등학교,교육부 대전광역시교육청 대전광역시동부교육지원청 대전대흥초등학교,34,34,0,34,34,0,0,0
교육기관,교육부,대전동광초등학교,교육부 대전광역시교육청 대전광역시동부교육지원청 대전동광초등학교,20,20,0,20,17,3,0,0
교육기관,교육부,대전동도초등학교,교육부 대전광역시교육청 대전광역시동부교육지원청 대전동도초등학교,10,10,0,10,8,2,0,0
교육기관,교육부,대전동문초등학교,교육부 대전광역시교육청 대전광역시동부교육지원청 대전동문초등학교,11,11,0,11,0,11,0,0
교육기관,교육부,대전동산중학교,교육부 대전광역시교육청 대전광역시동부교육지원청 대전동산중학교,11,11,0,11,11,0,0,0
교육기관,교육부,대전동산초등학교,교육부 대전광역시교육청 대전광역시동부교육지원청 대전동산초등학교,17,17,0,17,11,4,2,0
교육기관,교육부,대전동서초등학교,교육부 대전광역시교육청 대전광역시동부교육지원청 대전동서초등학교,14,14,0,14,11,3,0,0
교육기관,교육부,대전매봉중학교,교육부 대전광역시교육청 대전광역시동부교육지원청 대전매봉중학교,13,13,0,13,11,2,0,0
교육기관,교육부,대전매봉초등학교,교육부 대전광역시교육청 대전광역시동부교육지원청 대전매봉초등학교,13,13,0,13,13,0,0,0
교육기관,교육부,대전목동초등학교,교육부 대전광역시교육청 대전광역시동부교육지원청 대전목동초등학교,12,12,0,12,12,0,0,0
교육기관,교육부,대전목상초등학교,교육부 대전광역시교육청 대전광역시동부교육지원청 대전목상초등학교,28,28,0,28,28,0,0,0
교육기관,교육부,대전목양초등학교,교육부 대전광역시교육청 대전광역시동부교육지원청 대전목양초등학교,22,22,0,22,21,1,0,0
교육기관,교육부,대전문성초등학교,교육부 대전광역시교육청 대전광역시동부교육지원청 대전문성초등학교,12,12,0,12,12,0,0,0
교육기관,교육부,대전문창유치원,교육부 대전광역시교육청 대전광역시동부교육지원청 대전문창유치원,15,15,0,15,15,0,0,0
교육기관,교육부,대전문창초등학교,교육부 대전광역시교육청 대전광역시동부교육지원청 대전문창초등학교,22,22,0,22,22,0,0,0
교육기관,교육부,대전문화여자중학교,교육부 대전광역시교육청 대전광역시동부교육지원청 대전문화여자중학교,19,19,0,19,19,0,0,0
교육기관,교육부,대전문화초등학교,교육부 대전광역시교육청 대전광역시동부교육지원청 대전문화초등학교,33,33,0,33,0,33,0,0
교육기관,교육부,대전버드내초등학교,교육부 대전광역시교육청 대전광역시동부교육지원청 대전버드내초등학교,22,22,0,22,17,1,1,3
교육기관,교육부,대전법동중학교,교육부 대전광역시교육청 대전광역시동부교육지원청 대전법동중학교,17,16,1,16,2,14,0,0
교육기관,교육부,대전법동초등학교,교육부 대전광역시교육청 대전광역시동부교육지원청 대전법동초등학교,14,14,0,14,14,0,0,0
교육기관,교육부,대전보성초등학교,교육부 대전광역시교육청 대전광역시동부교육지원청 대전보성초등학교,12,12,0,12,12,0,0,0
교육기관,교육부,대전보운초등학교,교육부 대전광역시교육청 대전광역시동부교육지원청 대전보운초등학교,8,8,0,8,7,1,0,0
교육기관,교육부,대전비래초등학교,교육부 대전광역시교육청 대전광역시동부교육지원청 대전비래초등학교,19,19,0,19,4,11,3,1
교육기관,교육부,대전산성초등학교,교육부 대전광역시교육청 대전광역시동부교육지원청 대전산성초등학교,20,20,0,20,12,5,3,0
교육기관,교육부,대전삼성초등학교,교육부 대전광역시교육청 대전광역시동부교육지원청 대전삼성초등학교,14,14,0,14,14,0,0,0
교육기관,교육부,대전새여울초등학교,교육부 대전광역시교육청 대전광역시동부교육지원청 대전새여울초등학교,10,10,0,10,10,0,0,0
교육기관,교육부,대전석교초등학교,교육부 대전광역시교육청 대전광역시동부교육지원청 대전석교초등학교,21,21,0,21,21,0,0,0
교육기관,교육부,대전석봉초등학교,교육부 대전광역시교육청 대전광역시동부교육지원청 대전석봉초등학교,11,11,0,11,11,0,0,0
교육기관,교육부,대전선화초등학교,교육부 대전광역시교육청 대전광역시동부교육지원청 대전선화초등학교,23,23,0,23,23,0,0,0
교육기관,교육부,대전성남초등학교,교육부 대전광역시교육청 대전광역시동부교육지원청 대전성남초등학교,17,17,0,17,17,0,0,0
교육기관,교육부,대전성모초등학교,교육부 대전광역시교육청 대전광역시동부교육지원청 대전성모초등학교,35,4,31,4,0,4,0,0
교육기관,교육부,대전송촌중학교,교육부 대전광역시교육청 대전광역시동부교육지원청 대전송촌중학교,40,40,0,40,2,38,0,0
교육기관,교육부,대전송촌초등학교,교육부 대전광역시교육청 대전광역시동부교육지원청 대전송촌초등학교,16,16,0,16,16,0,0,0
교육기관,교육부,대전신일중학교,교육부 대전광역시교육청 대전광역시동부교육지원청 대전신일중학교,32,32,0,32,20,10,0,2
교육기관,교육부,대전신평초등학교,교육부 대전광역시교육청 대전광역시동부교육지원청 대전신평초등학교,11,11,0,11,8,2,1,0
교육기관,교육부,대전신흥초등학교,교육부 대전광역시교육청 대전광역시동부교육지원청 대전신흥초등학교,24,24,0,24,12,12,0,0
교육기관,교육부,대전양지초등학교,교육부 대전광역시교육청 대전광역시동부교육지원청 대전양지초등학교,15,15,0,15,4,11,0,0
교육기관,교육부,대전여자중학교,교육부 대전광역시교육청 대전광역시동부교육지원청 대전여자중학교,15,15,0,15,10,5,0,0
교육기관,교육부,대전오류초등학교,교육부 대전광역시교육청 대전광역시동부교육지원청 대전오류초등학교,10,10,0,10,8,2,0,0
교육기관,교육부,대전옥계초등학교,교육부 대전광역시교육청 대전광역시동부교육지원청 대전옥계초등학교,32,32,0,32,12,20,0,0
교육기관,교육부,대전용운중학교,교육부 대전광역시교육청 대전광역시동부교육지원청 대전용운중학교,49,49,0,49,6,41,2,0
교육기관,교육부,대전용운초등학교,교육부 대전광역시교육청 대전광역시동부교육지원청 대전용운초등학교,16,16,0,16,0,16,0,0
교육기관,교육부,대전용전중학교,교육부 대전광역시교육청 대전광역시동부교육지원청 대전용전중학교,34,34,0,34,19,15,0,0
교육기관,교육부,대전용전초등학교,교육부 대전광역시교육청 대전광역시동부교육지원청 대전용전초등학교,21,21,0,21,21,0,0,0
교육기관,교육부,대전원평초등학교,교육부 대전광역시교육청 대전광역시동부교육지원청 대전원평초등학교,12,12,0,12,12,0,0,0
교육기관,교육부,대전유평초등학교,교육부 대전광역시교육청 대전광역시동부교육지원청 대전유평초등학교,13,13,0,13,13,0,0,0
교육기관,교육부,대전은어송중학교,교육부 대전광역시교육청 대전광역시동부교육지원청 대전은어송중학교,22,21,1,21,11,10,0,0
교육기관,교육부,대전은어송초등학교,교육부 대전광역시교육청 대전광역시동부교육지원청 대전은어송초등학교,22,22,0,22,22,0,0,0
교육기관,교육부,대전자양초등학교,교육부 대전광역시교육청 대전광역시동부교육지원청 대전자양초등학교,19,19,0,19,19,0,0,0
교육기관,교육부,대전중리초등학교,교육부 대전광역시교육청 대전광역시동부교육지원청 대전중리초등학교,29,29,0,29,29,0,0,0
교육기관,교육부,대전중앙중학교,교육부 대전광역시교육청 대전광역시동부교육지원청 대전중앙중학교,42,42,0,42,35,7,0,0
교육기관,교육부,대전중앙초등학교,교육부 대전광역시교육청 대전광역시동부교육지원청 대전중앙초등학교,11,11,0,11,10,1,0,0
교육기관,교육부,대전중원초등학교,교육부 대전광역시교육청 대전광역시동부교육지원청 대전중원초등학교,18,18,0,18,18,0,0,0
교육기관,교육부,대전중촌초등학교,교육부 대전광역시교육청 대전광역시동부교육지원청 대전중촌초등학교,14,14,0,14,7,7,0,0
교육기관,교육부,대전중학교,교육부 대전광역시교육청 대전광역시동부교육지원청 대전중학교,32,32,0,32,24,7,1,0
교육기관,교육부,대전천동초등학교,교육부 대전광역시교육청 대전광역시동부교육지원청 대전천동초등학교,33,33,0,33,33,0,0,0
교육기관,교육부,대전태평중학교,교육부 대전광역시교육청 대전광역시동부교육지원청 대전태평중학교,19,19,0,19,17,2,0,0
교육기관,교육부,대전태평초등학교,교육부 대전광역시교육청 대전광역시동부교육지원청 대전태평초등학교,12,12,0,12,6,2,2,2
교육기관,교육부,대전판암초등학교,교육부 대전광역시교육청 대전광역시동부교육지원청 대전판암초등학교,29,29,0,29,0,29,0,0
교육기관,교육부,대전현암초등학교,교육부 대전광역시교육청 대전광역시동부교육지원청 대전현암초등학교,16,16,0,16,15,1,0,0
교육기관,교육부,대전화정초등학교,교육부 대전광역시교육청 대전광역시동부교육지원청 대전화정초등학교,14,14,0,14,12,2,0,0
교육기관,교육부,대전흥룡초등학교,교육부 대전광역시교육청 대전광역시동부교육지원청 대전흥룡초등학교,22,22,0,22,0,22,0,0
교육기관,교육부,동대전중학교,교육부 대전광역시교육청 대전광역시동부교육지원청 동대전중학교,18,18,0,18,18,0,0,0
교육기관,교육부,동대전초등학교,교육부 대전광역시교육청 대전광역시동부교육지원청 동대전초등학교,24,24,0,24,24,0,0,0
교육기관,교육부,동명중학교,교육부 대전광역시교육청 대전광역시동부교육지원청 동명중학교,27,27,0,27,0,27,0,0
교육기관,교육부,동명초등학교,교육부 대전광역시교육청 대전광역시동부교육지원청 동명초등학교,13,13,0,13,13,0,0,0
교육기관,교육부,동신중학교,교육부 대전광역시교육청 대전광역시동부교육지원청 동신중학교,24,24,0,24,24,0,0,0
교육기관,교육부,보문중학교,교육부 대전광역시교육청 대전광역시동부교육지원청 보문중학교,19,19,0,19,6,13,0,0
교육기관,교육부,산내유치원,교육부 대전광역시교육청 대전광역시동부교육지원청 산내유치원,12,12,0,12,6,6,0,0
교육기관,교육부,산내초등학교,교육부 대전광역시교육청 대전광역시동부교육지원청 산내초등학교,25,25,0,25,25,0,0,0
교육기관,교육부,산서초등학교,교육부 대전광역시교육청 대전광역시동부교육지원청 산서초등학교,15,15,0,15,15,0,0,0
교육기관,교육부,산흥초등학교,교육부 대전광역시교육청 대전광역시동부교육지원청 산흥초등학교,14,14,0,14,8,4,1,1
교육기관,교육부,새일초등학교,교육부 대전광역시교육청 대전광역시동부교육지원청 새일초등학교,20,20,0,20,17,3,0,0
교육기관,교육부,서대전초등학교,교육부 대전광역시교육청 대전광역시동부교육지원청 서대전초등학교,20,20,0,20,8,12,0,0
교육기관,교육부,세천초등학교,교육부 대전광역시교육청 대전광역시동부교육지원청 세천초등학교,13,13,0,13,13,0,0,0
교육기관,교육부,신탄중앙중학교,교육부 대전광역시교육청 대전광역시동부교육지원청 신탄중앙중학교,23,22,1,22,22,0,0,0
교육기관,교육부,신탄진용정초등학교,교육부 대전광역시교육청 대전광역시동부교육지원청 신탄진용정초등학교,25,25,0,25,0,25,0,0
교육기관,교육부,신탄진중학교,교육부 대전광역시교육청 대전광역시동부교육지원청 신탄진중학교,16,16,0,16,0,16,0,0
교육기관,교육부,신탄진초등학교,교육부 대전광역시교육청 대전광역시동부교육지원청 신탄진초등학교,22,22,0,22,10,12,0,0
교육기관,교육부,여울누리유치원,교육부 대전광역시교육청 대전광역시동부교육지원청 여울누리유치원,4,4,0,4,0,4,0,0
교육기관,교육부,오정중학교,교육부 대전광역시교육청 대전광역시동부교육지원청 오정중학교,19,19,0,19,19,0,0,0
교육기관,교육부,와동초등학교,교육부 대전광역시교육청 대전광역시동부교육지원청 와동초등학교,23,23,0,23,13,10,0,0
교육기관,교육부,우송중학교,교육부 대전광역시교육청 대전광역시동부교육지원청 우송중학교,30,30,0,30,0,30,0,0
교육기관,교육부,장동초등학교,교육부 대전광역시교육청 대전광역시동부교육지원청 장동초등학교,13,13,0,13,13,0,0,0
교육기관,교육부,중리중학교,교육부 대전광역시교육청 대전광역시동부교육지원청 중리중학교,13,13,0,13,13,0,0,0
교육기관,교육부,중앙유치원,교육부 대전광역시교육청 대전광역시동부교육지원청 중앙유치원,8,8,0,8,0,8,0,0
교육기관,교육부,청란여자중학교,교육부 대전광역시교육청 대전광역시동부교육지원청 청란여자중학교,10,10,0,10,10,0,0,0
교육기관,교육부,충남여자중학교,교육부 대전광역시교육청 대전광역시동부교육지원청 충남여자중학교,31,29,2,29,16,13,0,0
교육기관,교육부,충남중학교,교육부 대전광역시교육청 대전광역시동부교육지원청 충남중학교,23,22,1,22,5,17,0,0
교육기관,교육부,한밭여자중학교,교육부 대전광역시교육청 대전광역시동부교육지원청 한밭여자중학교,16,16,0,16,16,0,0,0
교육기관,교육부,한밭중학교,교육부 대전광역시교육청 대전광역시동부교육지원청 한밭중학교,11,11,0,11,5,6,0,0
교육기관,교육부,호수돈여자중학교,교육부 대전광역시교육청 대전광역시동부교육지원청 호수돈여자중학교,38,37,1,37,0,37,0,0
교육기관,교육부,회덕중학교,교육부 대전광역시교육청 대전광역시동부교육지원청 회덕중학교,24,24,0,24,24,0,0,0
교육기관,교육부,회덕초등학교,교육부 대전광역시교육청 대전광역시동부교육지원청 회덕초등학교,30,30,0,30,30,0,0,0
교육기관,교육부,대전광역시서부교육지원청,교육부 대전광역시교육청 대전광역시서부교육지원청,19,19,0,19,0,19,0,0
교육기관,교육부,가수원중학교,교육부 대전광역시교육청 대전광역시서부교육지원청 가수원중학교,12,12,0,12,6,6,0,0
교육기관,교육부,가수원초등학교,교육부 대전광역시교육청 대전광역시서부교육지원청 가수원초등학교,27,27,0,27,27,0,0,0
교육기관,교육부,갈마중학교,교육부 대전광역시교육청 대전광역시서부교육지원청 갈마중학교,18,18,0,18,18,0,0,0
교육기관,교육부,구즉초등학교,교육부 대전광역시교육청 대전광역시서부교육지원청 구즉초등학교,16,16,0,16,16,0,0,0
교육기관,교육부,금성초등학교,교육부 대전광역시교육청 대전광역시서부교육지원청 금성초등학교,26,26,0,26,26,0,0,0
교육기관,교육부,기성중학교,교육부 대전광역시교육청 대전광역시서부교육지원청 기성중학교,13,13,0,13,8,4,1,0
교육기관,교육부,기성초등학교,교육부 대전광역시교육청 대전광역시서부교육지원청 기성초등학교,23,23,0,23,11,12,0,0
교육기관,교육부,남선초등학교,교육부 대전광역시교육청 대전광역시서부교육지원청 남선초등학교,13,13,0,13,13,0,0,0
교육기관,교육부,노은누리유치원,교육부 대전광역시교육청 대전광역시서부교육지원청 노은누리유치원,4,4,0,4,3,1,0,0
교육기관,교육부,대덕중학교,교육부 대전광역시교육청 대전광역시서부교육지원청 대덕중학교,24,23,1,23,20,1,1,1
교육기관,교육부,대덕초등학교,교육부 대전광역시교육청 대전광역시서부교육지원청 대덕초등학교,23,23,0,23,11,12,0,0
교육기관,교육부,대전가장초등학교,교육부 대전광역시교육청 대전광역시서부교육지원청 대전가장초등학교,26,26,0,26,23,3,0,0
교육기관,교육부,대전갈마유치원,교육부 대전광역시교육청 대전광역시서부교육지원청 대전갈마유치원,4,4,0,4,2,2,0,0
교육기관,교육부,대전갈마초등학교,교육부 대전광역시교육청 대전광역시서부교육지원청 대전갈마초등학교,22,22,0,22,22,0,0,0
교육기관,교육부,대전갑천중학교,교육부 대전광역시교육청 대전광역시서부교육지원청 대전갑천중학교,15,15,0,15,15,0,0,0
교육기관,교육부,대전갑천초등학교,교육부 대전광역시교육청 대전광역시서부교육지원청 대전갑천초등학교,13,13,0,13,13,0,0,0
교육기관,교육부,대전계산초등학교,교육부 대전광역시교육청 대전광역시서부교육지원청 대전계산초등학교,9,9,0,9,9,0,0,0
교육기관,교육부,대전관저중학교,교육부 대전광역시교육청 대전광역시서부교육지원청 대전관저중학교,16,16,0,16,14,2,0,0
교육기관,교육부,대전관저초등학교,교육부 대전광역시교육청 대전광역시서부교육지원청 대전관저초등학교,23,23,0,23,17,4,2,0
교육기관,교육부,대전관평중학교,교육부 대전광역시교육청 대전광역시서부교육지원청 대전관평중학교,36,35,1,35,35,0,0,0
교육기관,교육부,대전관평초등학교,교육부 대전광역시교육청 대전광역시서부교육지원청 대전관평초등학교,17,17,0,17,10,7,0,0
교육기관,교육부,대전괴정중학교,교육부 대전광역시교육청 대전광역시서부교육지원청 대전괴정중학교,14,14,0,14,5,5,4,0
교육기관,교육부,대전교촌초등학교,교육부 대전광역시교육청 대전광역시서부교육지원청 대전교촌초등학교,11,11,0,11,11,0,0,0
교육기관,교육부,대전구봉중학교,교육부 대전광역시교육청 대전광역시서부교육지원청 대전구봉중학교,12,12,0,12,12,0,0,0
교육기관,교육부,대전구봉초등학교,교육부 대전광역시교육청 대전광역시서부교육지원청 대전구봉초등학교,8,8,0,8,8,0,0,0
교육기관,교육부,대전금동초등학교,교육부 대전광역시교육청 대전광역시서부교육지원청 대전금동초등학교,20,20,0,20,10,10,0,0
교육기관,교육부,대전남선중학교,교육부 대전광역시교육청 대전광역시서부교육지원청 대전남선중학교,23,23,0,23,23,0,0,0
교육기관,교육부,대전내동중학교,교육부 대전광역시교육청 대전광역시서부교육지원청 대전내동중학교,10,10,0,10,7,2,1,0
교육기관,교육부,대전내동초등학교,교육부 대전광역시교육청 대전광역시서부교육지원청 대전내동초등학교,24,24,0,24,24,0,0,0
교육기관,교육부,대전노은중학교,교육부 대전광역시교육청 대전광역시서부교육지원청 대전노은중학교,20,20,0,20,20,0,0,0
교육기관,교육부,대전노은초등학교,교육부 대전광역시교육청 대전광역시서부교육지원청 대전노은초등학교,16,16,0,16,16,0,0,0
교육기관,교육부,대전느리울중학교,교육부 대전광역시교육청 대전광역시서부교육지원청 대전느리울중학교,22,22,0,22,22,0,0,0
교육기관,교육부,대전느리울초등학교,교육부 대전광역시교육청 대전광역시서부교육지원청 대전느리울초등학교,22,22,0,22,12,10,0,0
교육기관,교육부,대전대신중학교,교육부 대전광역시교육청 대전광역시서부교육지원청 대전대신중학교,8,8,0,8,8,0,0,0
교육기관,교육부,대전대정초등학교,교육부 대전광역시교육청 대전광역시서부교육지원청 대전대정초등학교,18,18,0,18,18,0,0,0
교육기관,교육부,대전덕명중학교,교육부 대전광역시교육청 대전광역시서부교육지원청 대전덕명중학교,32,31,1,31,31,0,0,0
교육기관,교육부,대전도마중학교,교육부 대전광역시교육청 대전광역시서부교육지원청 대전도마중학교,24,20,4,20,16,4,0,0
교육기관,교육부,대전도마초등학교,교육부 대전광역시교육청 대전광역시서부교육지원청 대전도마초등학교,33,33,0,33,21,10,2,0
교육기관,교육부,대전도솔유치원,교육부 대전광역시교육청 대전광역시서부교육지원청 대전도솔유치원,0,0,0,0,0,0,0,0
교육기관,교육부,대전도솔초등학교,교육부 대전광역시교육청 대전광역시서부교육지원청 대전도솔초등학교,9,9,0,9,9,0,0,0
교육기관,교육부,대전도안중학교,교육부 대전광역시교육청 대전광역시서부교육지원청 대전도안중학교,28,27,1,27,0,27,0,0
교육기관,교육부,대전도안초등학교,교육부 대전광역시교육청 대전광역시서부교육지원청 대전도안초등학교,16,16,0,16,16,0,0,0
교육기관,교육부,대전동화중학교,교육부 대전광역시교육청 대전광역시서부교육지원청 대전동화중학교,32,15,17,15,0,15,0,0
교육기관,교육부,대전동화초등학교,교육부 대전광역시교육청 대전광역시서부교육지원청 대전동화초등학교,15,15,0,15,10,5,0,0
교육기관,교육부,대전두리중학교,교육부 대전광역시교육청 대전광역시서부교육지원청 대전두리중학교,32,31,1,31,0,31,0,0
교육기관,교육부,대전두리초등학교,교육부 대전광역시교육청 대전광역시서부교육지원청 대전두리초등학교,25,25,0,25,25,0,0,0
교육기관,교육부,대전둔산중학교,교육부 대전광역시교육청 대전광역시서부교육지원청 대전둔산중학교,22,21,1,21,10,9,1,1
교육기관,교육부,대전둔산초등학교,교육부 대전광역시교육청 대전광역시서부교육지원청 대전둔산초등학교,24,24,0,24,24,0,0,0
교육기관,교육부,대전둔원중학교,교육부 대전광역시교육청 대전광역시서부교육지원청 대전둔원중학교,11,11,0,11,7,4,0,0
교육기관,교육부,대전둔원초등학교,교육부 대전광역시교육청 대전광역시서부교육지원청 대전둔원초등학교,23,23,0,23,23,0,0,0
교육기관,교육부,대전둔천초등학교,교육부 대전광역시교육청 대전광역시서부교육지원청 대전둔천초등학교,21,21,0,21,21,0,0,0
교육기관,교육부,대전만년중학교,교육부 대전광역시교육청 대전광역시서부교육지원청 대전만년중학교,18,18,0,18,18,0,0,0
교육기관,교육부,대전만년초등학교,교육부 대전광역시교육청 대전광역시서부교육지원청 대전만년초등학교,11,11,0,11,11,0,0,0
교육기관,교육부,대전문정중학교,교육부 대전광역시교육청 대전광역시서부교육지원청 대전문정중학교,31,31,0,31,0,31,0,0
교육기관,교육부,대전문정초등학교,교육부 대전광역시교육청 대전광역시서부교육지원청 대전문정초등학교,26,26,0,26,17,9,0,0
교육기관,교육부,대전문지중학교,교육부 대전광역시교육청 대전광역시서부교육지원청 대전문지중학교,24,24,0,24,24,0,0,0
교육기관,교육부,대전반석초등학교,교육부 대전광역시교육청 대전광역시서부교육지원청 대전반석초등학교,20,20,0,20,0,20,0,0
교육기관,교육부,대전배울초등학교,교육부 대전광역시교육청 대전광역시서부교육지원청 대전배울초등학교,14,14,0,14,5,3,3,3
교육기관,교육부,대전백운초등학교,교육부 대전광역시교육청 대전광역시서부교육지원청 대전백운초등학교,20,20,0,20,0,20,0,0
교육기관,교육부,대전버드내중학교,교육부 대전광역시교육청 대전광역시서부교육지원청 대전버드내중학교,22,22,0,22,22,0,0,0
교육기관,교육부,대전변동중학교,교육부 대전광역시교육청 대전광역시서부교육지원청 대전변동중학교,22,22,0,22,22,0,0,0
교육기관,교육부,대전변동초등학교,교육부 대전광역시교육청 대전광역시서부교육지원청 대전변동초등학교,28,28,0,28,0,28,0,0
교육기관,교육부,대전복수초등학교,교육부 대전광역시교육청 대전광역시서부교육지원청 대전복수초등학교,16,16,0,16,16,0,0,0
교육기관,교육부,대전봉명중학교,교육부 대전광역시교육청 대전광역시서부교육지원청 대전봉명중학교,55,55,0,55,41,14,0,0
교육기관,교육부,대전봉명초등학교,교육부 대전광역시교육청 대전광역시서부교육지원청 대전봉명초등학교,22,22,0,22,15,7,0,0
교육기관,교육부,대전봉산중학교,교육부 대전광역시교육청 대전광역시서부교육지원청 대전봉산중학교,17,16,1,16,0,16,0,0
교육기관,교육부,대전봉산초등학교,교육부 대전광역시교육청 대전광역시서부교육지원청 대전봉산초등학교,18,18,0,18,18,0,0,0
교육기관,교육부,대전봉우중학교,교육부 대전광역시교육청 대전광역시서부교육지원청 대전봉우중학교,15,15,0,15,15,0,0,0
교육기관,교육부,대전삼육중학교,교육부 대전광역시교육청 대전광역시서부교육지원청 대전삼육중학교,37,37,0,37,36,1,0,0
교육기관,교육부,대전삼육초등학교,교육부 대전광역시교육청 대전광역시서부교육지원청 대전삼육초등학교,43,43,0,43,4,39,0,0
교육기관,교육부,대전삼천중학교,교육부 대전광역시교육청 대전광역시서부교육지원청 대전삼천중학교,13,12,1,12,6,6,0,0
교육기관,교육부,대전삼천초등학교,교육부 대전광역시교육청 대전광역시서부교육지원청 대전삼천초등학교,24,24,0,24,24,0,0,0
교육기관,교육부,대전상대초등학교,교육부 대전광역시교육청 대전광역시서부교육지원청 대전상대초등학교,28,28,0,28,28,0,0,0
교육기관,교육부,대전상원초등학교,교육부 대전광역시교육청 대전광역시서부교육지원청 대전상원초등학교,23,23,0,23,22,1,0,0
교육기관,교육부,대전상지초등학교,교육부 대전광역시교육청 대전광역시서부교육지원청 대전상지초등학교,14,14,0,14,14,0,0,0
교육기관,교육부,대전새미래중학교,교육부 대전광역시교육청 대전광역시서부교육지원청 대전새미래중학교,16,16,0,16,16,0,0,0
교육기관,교육부,대전새미래초등학교,교육부 대전광역시교육청 대전광역시서부교육지원청 대전새미래초등학교,9,9,0,9,9,0,0,0
교육기관,교육부,대전샘머리초등학교,교육부 대전광역시교육청 대전광역시서부교육지원청 대전샘머리초등학교,21,21,0,21,21,0,0,0
교육기관,교육부,대전서부초등학교,교육부 대전광역시교육청 대전광역시서부교육지원청 대전서부초등학교,37,37,0,37,33,4,0,0
교육기관,교육부,대전서원초등학교,교육부 대전광역시교육청 대전광역시서부교육지원청 대전서원초등학교,17,17,0,17,17,0,0,0
교육기관,교육부,대전서중학교,교육부 대전광역시교육청 대전광역시서부교육지원청 대전서중학교,13,13,0,13,1,8,4,0
교육기관,교육부,대전선암초등학교,교육부 대전광역시교육청 대전광역시서부교육지원청 대전선암초등학교,10,10,0,10,5,5,0,0
교육기관,교육부,대전선유초등학교,교육부 대전광역시교육청 대전광역시서부교육지원청 대전선유초등학교,15,15,0,15,15,0,0,0
교육기관,교육부,대전성룡초등학교,교육부 대전광역시교육청 대전광역시서부교육지원청 대전성룡초등학교,11,11,0,11,0,11,0,0
교육기관,교육부,대전성천초등학교,교육부 대전광역시교육청 대전광역시서부교육지원청 대전성천초등학교,15,15,0,15,10,5,0,0
교육기관,교육부,대전송강중학교,교육부 대전광역시교육청 대전광역시서부교육지원청 대전송강중학교,32,32,0,32,9,23,0,0
교육기관,교육부,대전송강초등학교,교육부 대전광역시교육청 대전광역시서부교육지원청 대전송강초등학교,22,22,0,22,22,0,0,0
교육기관,교육부,대전송림초등학교,교육부 대전광역시교육청 대전광역시서부교육지원청 대전송림초등학교,16,16,0,16,16,0,0,0
교육기관,교육부,대전수미초등학교,교육부 대전광역시교육청 대전광역시서부교육지원청 대전수미초등학교,15,15,0,15,15,0,0,0
교육기관,교육부,대전수정초등학교,교육부 대전광역시교육청 대전광역시서부교육지원청 대전수정초등학교,17,16,1,16,16,0,0,0
교육기관,교육부,대전신계중학교,교육부 대전광역시교육청 대전광역시서부교육지원청 대전신계중학교,28,28,0,28,21,7,0,0
교육기관,교육부,대전신계초등학교,교육부 대전광역시교육청 대전광역시서부교육지원청 대전신계초등학교,13,13,0,13,13,0,0,0
교육기관,교육부,대전어울림유치원,교육부 대전광역시교육청 대전광역시서부교육지원청 대전어울림유치원,0,0,0,0,0,0,0,0
교육기관,교육부,대전어은중학교,교육부 대전광역시교육청 대전광역시서부교육지원청 대전어은중학교,15,15,0,15,10,5,0,0
교육기관,교육부,대전어은초등학교,교육부 대전광역시교육청 대전광역시서부교육지원청 대전어은초등학교,16,16,0,16,16,0,0,0
교육기관,교육부,대전외삼중학교,교육부 대전광역시교육청 대전광역시서부교육지원청 대전외삼중학교,32,31,1,31,30,1,0,0
교육기관,교육부,대전용산초등학교,교육부 대전광역시교육청 대전광역시서부교육지원청 대전용산초등학교,18,18,0,18,18,0,0,0
교육기관,교육부,대전원신흥유치원,교육부 대전광역시교육청 대전광역시서부교육지원청 대전원신흥유치원,4,4,0,4,1,1,1,1
교육기관,교육부,대전원신흥중학교,교육부 대전광역시교육청 대전광역시서부교육지원청 대전원신흥중학교,20,0,20,0,0,0,0,0
교육기관,교육부,대전원신흥초등학교,교육부 대전광역시교육청 대전광역시서부교육지원청 대전원신흥초등학교,9,9,0,9,9,0,0,0
교육기관,교육부,대전원신흥초등학교복용분교장,교육부 대전광역시교육청 대전광역시서부교육지원청 대전원신흥초등학교복용분교장,11,11,0,11,11,0,0,0
교육기관,교육부,대전원앙초등학교,교육부 대전광역시교육청 대전광역시서부교육지원청 대전원앙초등학교,17,17,0,17,17,0,0,0
교육기관,교육부,대전월평중학교,교육부 대전광역시교육청 대전광역시서부교육지원청 대전월평중학교,17,17,0,17,9,5,2,1
교육기관,교육부,대전월평초등학교,교육부 대전광역시교육청 대전광역시서부교육지원청 대전월평초등학교,20,20,0,20,20,0,0,0
교육기관,교육부,대전유천초등학교,교육부 대전광역시교육청 대전광역시서부교육지원청 대전유천초등학교,21,21,0,21,21,0,0,0
교육기관,교육부,대전자운중학교,교육부 대전광역시교육청 대전광역시서부교육지원청 대전자운중학교,37,37,0,37,22,15,0,0
교육기관,교육부,대전자운초등학교,교육부 대전광역시교육청 대전광역시서부교육지원청 대전자운초등학교,13,13,0,13,13,0,0,0
교육기관,교육부,대전장대중학교,교육부 대전광역시교육청 대전광역시서부교육지원청 대전장대중학교,20,20,0,20,11,9,0,0
교육기관,교육부,대전장대초등학교,교육부 대전광역시교육청 대전광역시서부교육지원청 대전장대초등학교,14,14,0,14,14,0,0,0
교육기관,교육부,대전전민중학교,교육부 대전광역시교육청 대전광역시서부교육지원청 대전전민중학교,28,28,0,28,28,0,0,0
교육기관,교육부,대전전민초등학교,교육부 대전광역시교육청 대전광역시서부교육지원청 대전전민초등학교,17,17,0,17,7,8,1,1
교육기관,교육부,대전정림중학교,교육부 대전광역시교육청 대전광역시서부교육지원청 대전정림중학교,17,17,0,17,15,2,0,0
교육기관,교육부,대전정림초등학교,교육부 대전광역시교육청 대전광역시서부교육지원청 대전정림초등학교,22,22,0,22,12,10,0,0
교육기관,교육부,대전죽동초등학교,교육부 대전광역시교육청 대전광역시서부교육지원청 대전죽동초등학교,11,11,0,11,11,0,0,0
교육기관,교육부,대전지족중학교,교육부 대전광역시교육청 대전광역시서부교육지원청 대전지족중학교,24,24,0,24,24,0,0,0
교육기관,교육부,대전지족초등학교,교육부 대전광역시교육청 대전광역시서부교육지원청 대전지족초등학교,13,13,0,13,0,13,0,0
교육기관,교육부,대전탄방중학교,교육부 대전광역시교육청 대전광역시서부교육지원청 대전탄방중학교,40,40,0,40,40,0,0,0
교육기관,교육부,대전탄방초등학교,교육부 대전광역시교육청 대전광역시서부교육지원청 대전탄방초등학교,16,16,0,16,16,0,0,0
교육기관,교육부,대전하기중학교,교육부 대전광역시교육청 대전광역시서부교육지원청 대전하기중학교,27,27,0,27,0,27,0,0
교육기관,교육부,대전하기초등학교,교육부 대전광역시교육청 대전광역시서부교육지원청 대전하기초등학교,15,15,0,15,8,7,0,0
교육기관,교육부,대전호수초등학교,교육부 대전광역시교육청 대전광역시서부교육지원청 대전호수초등학교,12,12,0,12,12,0,0,0
교육기관,교육부,덕송초등학교,교육부 대전광역시교육청 대전광역시서부교육지원청 덕송초등학교,12,12,0,12,12,0,0,0
교육기관,교육부,동방여자중학교,교육부 대전광역시교육청 대전광역시서부교육지원청 동방여자중학교,10,10,0,10,10,0,0,0
교육기관,교육부,문지유치원,교육부 대전광역시교육청 대전광역시서부교육지원청 문지유치원,4,4,0,4,4,0,0,0
교육기관,교육부,문지초등학교,교육부 대전광역시교육청 대전광역시서부교육지원청 문지초등학교,19,19,0,19,10,9,0,0
교육기관,교육부,봉암초등학교,교육부 대전광역시교육청 대전광역시서부교육지원청 봉암초등학교,16,16,0,16,16,0,0,0
교육기관,교육부,성덕중학교,교육부 대전광역시교육청 대전광역시서부교육지원청 성덕중학교,32,32,0,32,32,0,0,0
교육기관,교육부,외삼초등학교,교육부 대전광역시교육청 대전광역시서부교육지원청 외삼초등학교,16,16,0,16,16,0,0,0
교육기관,교육부,유성중학교,교육부 대전광역시교육청 대전광역시서부교육지원청 유성중학교,45,45,0,45,19,26,0,0
교육기관,교육부,유성초등학교,교육부 대전광역시교육청 대전광역시서부교육지원청 유성초등학교,14,14,0,14,13,1,0,0
교육기관,교육부,진잠중학교,교육부 대전광역시교육청 대전광역시서부교육지원청 진잠중학교,27,27,0,27,27,0,0,0
교육기관,교육부,진잠초등학교,교육부 대전광역시교육청 대전광역시서부교육지원청 진잠초등학교,22,22,0,22,14,8,0,0
교육기관,교육부,학하초등학교,교육부 대전광역시교육청 대전광역시서부교육지원청 학하초등학교,8,8,0,8,8,0,0,0
교육기관,교육부,한밭초등학교,교육부 대전광역시교육청 대전광역시서부교육지원청 한밭초등학교,23,23,0,23,23,0,0,0
교육기관,교육부,흥도초등학교,교육부 대전광역시교육청 대전광역시서부교육지원청 흥도초등학교,16,16,0,16,10,6,0,0
교육기관,교육부,대전괴정고등학교,교육부 대전광역시교육청 대전괴정고등학교,16,14,2,14,12,2,0,0
교육기관,교육부,대전교육과학연구원,교육부 대전광역시교육청 대전교육과학연구원,13,13,0,13,13,0,0,0
교육기관,교육부,대전교육연수원,교육부 대전광역시교육청 대전교육연수원,29,29,0,29,0,29,0,0
교육기관,교육부,대전교육정보원,교육부 대전광역시교육청 대전교육정보원,64,33,31,33,0,33,0,0
교육기관,교육부,대전구봉고등학교,교육부 대전광역시교육청 대전구봉고등학교,25,25,0,25,25,0,0,0
교육기관,교육부,대전국제통상고등학교,교육부 대전광역시교육청 대전국제통상고등학교,60,59,1,59,59,0,0,0
교육기관,교육부,대전노은고등학교,교육부 대전광역시교육청 대전노은고등학교,16,16,0,16,16,0,0,0
교육기관,교육부,대전대성고등학교,교육부 대전광역시교육청 대전대성고등학교,69,69,0,69,61,8,0,0
교육기관,교육부,대전대성여자고등학교 ,교육부 대전광역시교육청 대전대성여자고등학교 ,26,26,0,26,13,11,1,1
교육기관,교육부,대전대신고등학교,교육부 대전광역시교육청 대전대신고등학교,46,46,0,46,46,0,0,0
교육기관,교육부,대전도시과학고등학교,교육부 대전광역시교육청 대전도시과학고등학교,58,58,0,58,0,58,0,0
교육기관,교육부,대전도안고등학교,교육부 대전광역시교육청 대전도안고등학교,45,45,0,45,27,18,0,0
교육기관,교육부,대전동산고등학교,교육부 대전광역시교육청 대전동산고등학교,35,34,1,34,0,34,0,0
교육기관,교육부,대전동신과학고등학교,교육부 대전광역시교육청 대전동신과학고등학교,31,30,1,30,0,30,0,0
교육기관,교육부,대전둔산여자고등학교,교육부 대전광역시교육청 대전둔산여자고등학교,16,16,0,16,7,9,0,0
교육기관,교육부,대전둔원고등학교,교육부 대전광역시교육청 대전둔원고등학교,9,9,0,9,9,0,0,0
교육기관,교육부,대전만년고등학교,교육부 대전광역시교육청 대전만년고등학교,29,28,1,28,23,5,0,0
교육기관,교육부,대전맹학교,교육부 대전광역시교육청 대전맹학교,26,26,0,26,0,26,0,0
교육기관,교육부,대전반석고등학교,교육부 대전광역시교육청 대전반석고등학교,40,40,0,40,40,0,0,0
교육기관,교육부,대전복수고등학교,교육부 대전광역시교육청 대전복수고등학교,32,32,0,32,32,0,0,0
교육기관,교육부,대전산업정보고등학교,교육부 대전광역시교육청 대전산업정보고등학교,250,250,0,250,164,86,0,0
교육기관,교육부,대전생활과학고등학교,교육부 대전광역시교육청 대전생활과학고등학교,89,16,73,16,6,8,1,1
교육기관,교육부,대전성모여자고등학교,교육부 대전광역시교육청 대전성모여자고등학교,50,48,2,48,48,0,0,0
교육기관,교육부,대전성세재활학교,교육부 대전광역시교육청 대전성세재활학교,32,32,0,32,16,16,0,0
교육기관,교육부,대전송촌고등학교,교육부 대전광역시교육청 대전송촌고등학교,38,38,0,38,0,38,0,0
교육기관,교육부,대전여자고등학교,교육부 대전광역시교육청 대전여자고등학교,48,47,1,47,29,18,0,0
교육기관,교육부,대전여자상업고등학교,교육부 대전광역시교육청 대전여자상업고등학교,66,66,0,66,10,56,0,0
교육기관,교육부,대전예술고등학교,교육부 대전광역시교육청 대전예술고등학교,32,32,0,32,0,32,0,0
교육기관,교육부,대전예지고등학교,교육부 대전광역시교육청 대전예지고등학교,13,13,0,13,2,6,1,4
교육기관,교육부,대전외국어고등학교,교육부 대전광역시교육청 대전외국어고등학교,39,39,0,39,33,6,0,0
교육기관,교육부,대전외국인학교,교육부 대전광역시교육청 대전외국인학교,234,234,0,234,0,234,0,0
교육기관,교육부,대전용산고등학교,교육부 대전광역시교육청 대전용산고등학교,15,13,2,13,5,8,0,0
교육기관,교육부,대전원명학교,교육부 대전광역시교육청 대전원명학교,28,28,0,28,28,0,0,0
교육기관,교육부,대전유아교육진흥원,교육부 대전광역시교육청 대전유아교육진흥원,38,38,0,38,10,28,0,0
교육기관,교육부,대전이문고등학교,교육부 대전광역시교육청 대전이문고등학교,58,58,0,58,58,0,0,0
교육기관,교육부,대전전민고등학교,교육부 대전광역시교육청 대전전민고등학교,34,33,1,33,15,18,0,0
교육기관,교육부,대전전자디자인고등학교,교육부 대전광역시교육청 대전전자디자인고등학교,55,55,0,55,55,0,0,0
교육기관,교육부,대전제일고등학교,교육부 대전광역시교육청 대전제일고등학교,27,27,0,27,0,27,0,0
교육기관,교육부,대전중앙고등학교,교육부 대전광역시교육청 대전중앙고등학교,34,34,0,34,34,0,0,0
교육기관,교육부,대전지족고등학교,교육부 대전광역시교육청 대전지족고등학교,27,27,0,27,14,13,0,0
교육기관,교육부,대전체육고등학교,교육부 대전광역시교육청 대전체육고등학교,69,68,1,68,68,0,0,0
교육기관,교육부,대전특수교육원,교육부 대전광역시교육청 대전특수교육원,16,16,0,16,0,16,0,0
교육기관,교육부,대전평생학습관,교육부 대전광역시교육청 대전평생학습관,24,23,1,23,10,13,0,0
교육기관,교육부,대전학생교육문화원,교육부 대전광역시교육청 대전학생교육문화원,48,48,0,48,0,48,0,0
교육기관,교육부,대전학생해양수련원,교육부 대전광역시교육청 대전학생해양수련원,34,34,0,34,0,34,0,0
교육기관,교육부,대전한빛고등학교,교육부 대전광역시교육청 대전한빛고등학교,96,96,0,96,80,16,0,0
교육기관,교육부,대전해든학교,교육부 대전광역시교육청 대전해든학교,23,23,0,23,0,23,0,0
교육기관,교육부,대전혜광학교,교육부 대전광역시교육청 대전혜광학교,25,25,0,25,3,22,0,0
교육기관,교육부,동대전고등학교,교육부 대전광역시교육청 동대전고등학교,31,31,0,31,0,31,0,0
교육기관,교육부,동방고등학교,교육부 대전광역시교육청 동방고등학교,48,48,0,48,0,48,0,0
교육기관,교육부,동아마이스터고등학교,교육부 대전광역시교육청 동아마이스터고등학교,34,34,0,34,0,34,0,0
교육기관,교육부,명석고등학교,교육부 대전광역시교육청 명석고등학교,46,46,0,46,0,46,0,0
교육기관,교육부,보문고등학교,교육부 대전광역시교육청 보문고등학교,37,37,0,37,28,9,0,0
교육기관,교육부,새소리음악고등학교,교육부 대전광역시교육청 새소리음악고등학교,21,21,0,21,0,21,0,0
교육기관,교육부,서대전고등학교,교육부 대전광역시교육청 서대전고등학교,32,31,1,31,0,31,0,0
교육기관,교육부,서대전여자고등학교,교육부 대전광역시교육청 서대전여자고등학교,20,18,2,18,18,0,0,0
교육기관,교육부,서일고등학교,교육부 대전광역시교육청 서일고등학교,32,29,3,29,9,20,0,0
교육기관,교육부,서일여자고등학교,교육부 대전광역시교육청 서일여자고등학교,19,19,0,19,19,0,0,0
교육기관,교육부,신탄진고등학교,교육부 대전광역시교육청 신탄진고등학교,16,14,2,14,2,10,1,1
교육기관,교육부,우송고등학교,교육부 대전광역시교육청 우송고등학교,34,34,0,34,0,34,0,0
교육기관,교육부,유성고등학교,교육부 대전광역시교육청 유성고등학교,14,13,1,13,1,12,0,0
교육기관,교육부,유성생명과학고등학교,교육부 대전광역시교육청 유성생명과학고등학교,37,37,0,37,37,0,0,0
교육기관,교육부,유성여자고등학교,교육부 대전광역시교육청 유성여자고등학교,20,17,3,17,10,4,1,2
교육기관,교육부,중일고등학교,교육부 대전광역시교육청 중일고등학교,24,24,0,24,4,20,0,0
교육기관,교육부,청란여자고등학교,교육부 대전광역시교육청 청란여자고등학교,10,10,0,10,10,0,0,0
교육기관,교육부,충남고등학교,교육부 대전광역시교육청 충남고등학교,24,22,2,22,0,22,0,0
교육기관,교육부,충남기계공업고등학교,교육부 대전광역시교육청 충남기계공업고등학교,50,50,0,50,50,0,0,0
교육기관,교육부,충남여자고등학교,교육부 대전광역시교육청 충남여자고등학교,29,28,1,28,28,0,0,0
교육기관,교육부,학력인정대전시립중고등학교원,교육부 대전광역시교육청 학력인정대전시립중고등학교원,22,9,13,9,9,0,0,0
교육기관,교육부,한밭고등학교,교육부 대전광역시교육청 한밭고등학교,21,21,0,21,0,21,0,0
교육기관,교육부,한밭교육박물관,교육부 대전광역시교육청 한밭교육박물관,26,26,0,26,0,26,0,0
교육기관,교육부,호수돈여자고등학교,교육부 대전광역시교육청 호수돈여자고등학교,25,24,1,24,16,6,2,0
교육기관,교육부,울산광역시교육청,교육부 울산광역시교육청,55,55,0,55,0,55,0,0
교육기관,교육부,강동고등학교,교육부 울산광역시교육청 강동고등학교,37,37,0,37,13,24,0,0
교육기관,교육부,남목고등학교,교육부 울산광역시교육청 남목고등학교,51,51,0,51,51,0,0,0
교육기관,교육부,남창고등학교,교육부 울산광역시교육청 남창고등학교,112,112,0,112,47,65,0,0
교육기관,교육부,다운고등학교,교육부 울산광역시교육청 다운고등학교,24,23,1,23,23,0,0,0
교육기관,교육부,달천고등학교,교육부 울산광역시교육청 달천고등학교,53,53,0,53,0,53,0,0
교육기관,교육부,대송고등학교,교육부 울산광역시교육청 대송고등학교,47,45,2,45,45,0,0,0
교육기관,교육부,대현고등학교,교육부 울산광역시교육청 대현고등학교,8,8,0,8,4,4,0,0
교육기관,교육부,매곡고등학교,교육부 울산광역시교육청 매곡고등학교,40,38,2,38,32,6,0,0
교육기관,교육부,무거고등학교,교육부 울산광역시교육청 무거고등학교,29,28,1,28,28,0,0,0
교육기관,교육부,무룡고등학교,교육부 울산광역시교육청 무룡고등학교,39,39,0,39,20,19,0,0
교육기관,교육부,문수고등학교,교육부 울산광역시교육청 문수고등학교,29,27,2,27,17,10,0,0
교육기관,교육부,문현고등학교,교육부 울산광역시교육청 문현고등학교,51,51,0,51,14,37,0,0
교육기관,교육부,방어진고등학교,교육부 울산광역시교육청 방어진고등학교,55,54,1,54,50,4,0,0
교육기관,교육부,범서고등학교,교육부 울산광역시교육청 범서고등학교,28,26,2,26,0,26,0,0
교육기관,교육부,삼산고등학교,교육부 울산광역시교육청 삼산고등학교,37,37,0,37,37,0,0,0
교육기관,교육부,성광여자고등학교,교육부 울산광역시교육청 성광여자고등학교,44,42,2,42,17,23,1,1
교육기관,교육부,성신고등학교,교육부 울산광역시교육청 성신고등학교,31,28,3,28,0,28,0,0
교육기관,교육부,신선여자고등학교,교육부 울산광역시교육청 신선여자고등학교,48,48,0,48,48,0,0,0
교육기관,교육부,신정고등학교,교육부 울산광역시교육청 신정고등학교,87,26,61,26,8,9,4,5
교육기관,교육부,약사고등학교,교육부 울산광역시교육청 약사고등학교,56,56,0,56,52,4,0,0
교육기관,교육부,언양고등학교,교육부 울산광역시교육청 언양고등학교,34,33,1,33,7,26,0,0
교육기관,교육부,온산고등학교,교육부 울산광역시교육청 온산고등학교,52,52,0,52,10,42,0,0
교육기관,교육부,우신고등학교,교육부 울산광역시교육청 우신고등학교,40,38,2,38,35,3,0,0
교육기관,교육부,울산강남고등학교,교육부 울산광역시교육청 울산강남고등학교,44,5,39,5,0,5,0,0
교육기관,교육부,울산경의고등학교,교육부 울산광역시교육청 울산경의고등학교,76,76,0,76,0,76,0,0
교육기관,교육부,울산고운중학교,교육부 울산광역시교육청 울산고운중학교,35,35,0,35,0,35,0,0
교육기관,교육부,울산공업고등학교,교육부 울산광역시교육청 울산공업고등학교,108,106,2,106,0,106,0,0
교육기관,교육부,울산과학고등학교,교육부 울산광역시교육청 울산과학고등학교,41,41,0,41,6,33,2,0
교육기관,교육부,울산과학관,교육부 울산광역시교육청 울산과학관,26,26,0,26,0,26,0,0
교육기관,교육부,울산광역시강남교육지원청,교육부 울산광역시교육청 울산광역시강남교육지원청,13,13,0,13,1,12,0,0
교육기관,교육부,강남초등학교,교육부 울산광역시교육청 울산광역시강남교육지원청 강남초등학교,35,35,0,35,35,0,0,0
교육기관,교육부,격동초등학교,교육부 울산광역시교육청 울산광역시강남교육지원청 격동초등학교,27,27,0,27,7,18,1,1
교육기관,교육부,구영유치원,교육부 울산광역시교육청 울산광역시강남교육지원청 구영유치원,12,12,0,12,6,6,0,0
교육기관,교육부,구영중학교,교육부 울산광역시교육청 울산광역시강남교육지원청 구영중학교,34,34,0,34,22,12,0,0
교육기관,교육부,구영초등학교,교육부 울산광역시교육청 울산광역시강남교육지원청 구영초등학교,28,28,0,28,22,6,0,0
교육기관,교육부,굴화초등학교,교육부 울산광역시교육청 울산광역시강남교육지원청 굴화초등학교,26,26,0,26,26,0,0,0
교육기관,교육부,남산초등학교,교육부 울산광역시교육청 울산광역시강남교육지원청 남산초등학교,24,24,0,24,24,0,0,0
교육기관,교육부,남창중학교,교육부 울산광역시교육청 울산광역시강남교육지원청 남창중학교,48,48,0,48,8,36,2,2
교육기관,교육부,대현중학교,교육부 울산광역시교육청 울산광역시강남교육지원청 대현중학교,36,36,0,36,0,36,0,0
교육기관,교육부,대현초등학교,교육부 울산광역시교육청 울산광역시강남교육지원청 대현초등학교,38,38,0,38,38,0,0,0
교육기관,교육부,덕신초등학교,교육부 울산광역시교육청 울산광역시강남교육지원청 덕신초등학교,19,19,0,19,19,0,0,0
교육기관,교육부,도산초등학교,교육부 울산광역시교육청 울산광역시강남교육지원청 도산초등학교,35,35,0,35,0,35,0,0
교육기관,교육부,동백초등학교,교육부 울산광역시교육청 울산광역시강남교육지원청 동백초등학교,21,21,0,21,21,0,0,0
교육기관,교육부,동평초등학교,교육부 울산광역시교육청 울산광역시강남교육지원청 동평초등학교,27,27,0,27,27,0,0,0
교육기관,교육부,두동초등학교,교육부 울산광역시교육청 울산광역시강남교육지원청 두동초등학교,15,15,0,15,15,0,0,0
교육기관,교육부,두서초등학교,교육부 울산광역시교육청 울산광역시강남교육지원청 두서초등학교,16,13,3,13,0,13,0,0
교육기관,교육부,두왕초등학교,교육부 울산광역시교육청 울산광역시강남교육지원청 두왕초등학교,25,25,0,25,11,14,0,0
교육기관,교육부,명산초등학교,교육부 울산광역시교육청 울산광역시강남교육지원청 명산초등학교,21,21,0,21,0,21,0,0
교육기관,교육부,무거중학교,교육부 울산광역시교육청 울산광역시강남교육지원청 무거중학교,30,29,1,29,29,0,0,0
교육기관,교육부,무거초등학교,교육부 울산광역시교육청 울산광역시강남교육지원청 무거초등학교,37,37,0,37,30,7,0,0
교육기관,교육부,문수중학교,교육부 울산광역시교육청 울산광역시강남교육지원청 문수중학교,38,36,2,36,15,21,0,0
교육기관,교육부,문수초등학교,교육부 울산광역시교육청 울산광역시강남교육지원청 문수초등학교,32,32,0,32,32,0,0,0
교육기관,교육부,방기초등학교,교육부 울산광역시교육청 울산광역시강남교육지원청 방기초등학교,14,14,0,14,14,0,0,0
교육기관,교육부,백합초등학교,교육부 울산광역시교육청 울산광역시강남교육지원청 백합초등학교,29,16,13,16,8,6,2,0
교육기관,교육부,범서초등학교,교육부 울산광역시교육청 울산광역시강남교육지원청 범서초등학교,47,47,0,47,47,0,0,0
교육기관,교육부,삼남중학교,교육부 울산광역시교육청 울산광역시강남교육지원청 삼남중학교,37,37,0,37,32,5,0,0
교육기관,교육부,삼남초등학교,교육부 울산광역시교육청 울산광역시강남교육지원청 삼남초등학교,46,14,32,14,8,4,1,1
교육기관,교육부,삼동초등학교,교육부 울산광역시교육청 울산광역시강남교육지원청 삼동초등학교,28,28,0,28,20,8,0,0
교육기관,교육부,삼산초등학교,교육부 울산광역시교육청 울산광역시강남교육지원청 삼산초등학교,30,30,0,30,30,0,0,0
교육기관,교육부,삼신초등학교,교육부 울산광역시교육청 울산광역시강남교육지원청 삼신초등학교,32,32,0,32,0,32,0,0
교육기관,교육부,삼정초등학교,교육부 울산광역시교육청 울산광역시강남교육지원청 삼정초등학교,24,24,0,24,0,24,0,0
교육기관,교육부,삼평초등학교,교육부 울산광역시교육청 울산광역시강남교육지원청 삼평초등학교,13,13,0,13,13,0,0,0
교육기관,교육부,삼호중학교,교육부 울산광역시교육청 울산광역시강남교육지원청 삼호중학교,35,33,2,33,28,5,0,0
교육기관,교육부,삼호초등학교,교육부 울산광역시교육청 울산광역시강남교육지원청 삼호초등학교,32,32,0,32,22,7,0,3
교육기관,교육부,상북유치원,교육부 울산광역시교육청 울산광역시강남교육지원청 상북유치원,12,12,0,12,6,6,0,0
교육기관,교육부,상북중학교,교육부 울산광역시교육청 울산광역시강남교육지원청 상북중학교,43,43,0,43,2,41,0,0
교육기관,교육부,상북초등학교,교육부 울산광역시교육청 울산광역시강남교육지원청 상북초등학교,16,16,0,16,10,6,0,0
교육기관,교육부,상북초등학교소호분교,교육부 울산광역시교육청 울산광역시강남교육지원청 상북초등학교소호분교,5,5,0,5,5,0,0,0
교육기관,교육부,서생중학교,교육부 울산광역시교육청 울산광역시강남교육지원청 서생중학교,92,92,0,92,0,92,0,0
교육기관,교육부,서생초등학교,교육부 울산광역시교육청 울산광역시강남교육지원청 서생초등학교,17,17,0,17,17,0,0,0
교육기관,교육부,선암초등학교,교육부 울산광역시교육청 울산광역시강남교육지원청 선암초등학교,22,22,0,22,22,0,0,0
교육기관,교육부,성동초등학교,교육부 울산광역시교육청 울산광역시강남교육지원청 성동초등학교,31,31,0,31,25,6,0,0
교육기관,교육부,수암초등학교,교육부 울산광역시교육청 울산광역시강남교육지원청 수암초등학교,32,32,0,32,32,0,0,0
교육기관,교육부,신복초등학교,교육부 울산광역시교육청 울산광역시강남교육지원청 신복초등학교,20,20,0,20,20,0,0,0
교육기관,교육부,신언중학교,교육부 울산광역시교육청 울산광역시강남교육지원청 신언중학교,70,70,0,70,30,40,0,0
교육기관,교육부,신일중학교,교육부 울산광역시교육청 울산광역시강남교육지원청 신일중학교,27,27,0,27,0,27,0,0
교육기관,교육부,신정중학교,교육부 울산광역시교육청 울산광역시강남교육지원청 신정중학교,32,30,2,30,16,14,0,0
교육기관,교육부,신정초등학교,교육부 울산광역시교육청 울산광역시강남교육지원청 신정초등학교,28,28,0,28,28,0,0,0
교육기관,교육부,야음중학교,교육부 울산광역시교육청 울산광역시강남교육지원청 야음중학교,44,44,0,44,44,0,0,0
교육기관,교육부,야음초등학교,교육부 울산광역시교육청 울산광역시강남교육지원청 야음초등학교,23,23,0,23,23,0,0,0
교육기관,교육부,언양누리유치원,교육부 울산광역시교육청 울산광역시강남교육지원청 언양누리유치원,29,29,0,29,29,0,0,0
교육기관,교육부,언양중학교,교육부 울산광역시교육청 울산광역시강남교육지원청 언양중학교,55,52,3,52,48,4,0,0
교육기관,교육부,언양초등학교,교육부 울산광역시교육청 울산광역시강남교육지원청 언양초등학교,37,37,0,37,37,0,0,0
교육기관,교육부,여천초등학교,교육부 울산광역시교육청 울산광역시강남교육지원청 여천초등학교,43,43,0,43,43,0,0,0
교육기관,교육부,영화초등학교,교육부 울산광역시교육청 울산광역시강남교육지원청 영화초등학교,32,32,0,32,32,0,0,0
교육기관,교육부,옥동중학교,교육부 울산광역시교육청 울산광역시강남교육지원청 옥동중학교,38,37,1,37,0,37,0,0
교육기관,교육부,옥동초등학교,교육부 울산광역시교육청 울산광역시강남교육지원청 옥동초등학교,32,32,0,32,18,14,0,0
교육기관,교육부,옥산초등학교,교육부 울산광역시교육청 울산광역시강남교육지원청 옥산초등학교,28,28,0,28,0,28,0,0
교육기관,교육부,옥서초등학교,교육부 울산광역시교육청 울산광역시강남교육지원청 옥서초등학교,28,28,0,28,14,14,0,0
교육기관,교육부,옥현유치원,교육부 울산광역시교육청 울산광역시강남교육지원청 옥현유치원,11,11,0,11,7,4,0,0
교육기관,교육부,옥현중학교,교육부 울산광역시교육청 울산광역시강남교육지원청 옥현중학교,37,37,0,37,34,3,0,0
교육기관,교육부,옥현초등학교,교육부 울산광역시교육청 울산광역시강남교육지원청 옥현초등학교,32,32,0,32,32,0,0,0
교육기관,교육부,온남초등학교,교육부 울산광역시교육청 울산광역시강남교육지원청 온남초등학교,25,25,0,25,17,2,4,2
교육기관,교육부,온산중학교,교육부 울산광역시교육청 울산광역시강남교육지원청 온산중학교,42,42,0,42,32,10,0,0
교육기관,교육부,온산초등학교,교육부 울산광역시교육청 울산광역시강남교육지원청 온산초등학교,31,31,0,31,31,0,0,0
교육기관,교육부,온양초등학교,교육부 울산광역시교육청 울산광역시강남교육지원청 온양초등학교,23,23,0,23,0,23,0,0
교육기관,교육부,용연초등학교,교육부 울산광역시교육청 울산광역시강남교육지원청 용연초등학교,30,30,0,30,6,24,0,0
교육기관,교육부,울산강남중학교,교육부 울산광역시교육청 울산광역시강남교육지원청 울산강남중학교,31,31,0,31,14,15,2,0
교육기관,교육부,울산남부초등학교,교육부 울산광역시교육청 울산광역시강남교육지원청 울산남부초등학교,30,30,0,30,27,3,0,0
교육기관,교육부,울산서여자중학교,교육부 울산광역시교육청 울산광역시강남교육지원청 울산서여자중학교,36,6,30,6,4,2,0,0
교육기관,교육부,울산중앙중학교,교육부 울산광역시교육청 울산광역시강남교육지원청 울산중앙중학교,45,45,0,45,31,11,3,0
교육기관,교육부,울산중앙초등학교,교육부 울산광역시교육청 울산광역시강남교육지원청 울산중앙초등학교,26,26,0,26,26,0,0,0
교육기관,교육부,울주명지초등학교,교육부 울산광역시교육청 울산광역시강남교육지원청 울주명지초등학교,15,15,0,15,15,0,0,0
교육기관,교육부,웅촌중학교,교육부 울산광역시교육청 울산광역시강남교육지원청 웅촌중학교,28,28,0,28,0,28,0,0
교육기관,교육부,웅촌초등학교,교육부 울산광역시교육청 울산광역시강남교육지원청 웅촌초등학교,17,17,0,17,17,0,0,0
교육기관,교육부,월계초등학교,교육부 울산광역시교육청 울산광역시강남교육지원청 월계초등학교,16,16,0,16,16,0,0,0
교육기관,교육부,월봉초등학교,교육부 울산광역시교육청 울산광역시강남교육지원청 월봉초등학교,34,34,0,34,26,4,2,2
교육기관,교육부,월평유치원,교육부 울산광역시교육청 울산광역시강남교육지원청 월평유치원,16,2,14,2,1,0,1,0
교육기관,교육부,월평초등학교,교육부 울산광역시교육청 울산광역시강남교육지원청 월평초등학교,20,20,0,20,20,0,0,0
교육기관,교육부,장검중학교,교육부 울산광역시교육청 울산광역시강남교육지원청 장검중학교,51,51,0,51,15,36,0,0
교육기관,교육부,장생포초등학교,교육부 울산광역시교육청 울산광역시강남교육지원청 장생포초등학교,10,10,0,10,10,0,0,0
교육기관,교육부,중남초등학교,교육부 울산광역시교육청 울산광역시강남교육지원청 중남초등학교,23,23,0,23,23,0,0,0
교육기관,교육부,천상중학교,교육부 울산광역시교육청 울산광역시강남교육지원청 천상중학교,58,58,0,58,0,58,0,0
교육기관,교육부,천상초등학교,교육부 울산광역시교육청 울산광역시강남교육지원청 천상초등학교,45,45,0,45,19,26,0,0
교육기관,교육부,청량중학교,교육부 울산광역시교육청 울산광역시강남교육지원청 청량중학교,18,17,1,17,17,0,0,0
교육기관,교육부,청량초등학교,교육부 울산광역시교육청 울산광역시강남교육지원청 청량초등학교,12,12,0,12,8,2,0,2
교육기관,교육부,청솔초등학교,교육부 울산광역시교육청 울산광역시강남교육지원청 청솔초등학교,27,27,0,27,0,27,0,0
교육기관,교육부,태화중학교,교육부 울산광역시교육청 울산광역시강남교육지원청 태화중학교,32,32,0,32,11,21,0,0
교육기관,교육부,학성중학교,교육부 울산광역시교육청 울산광역시강남교육지원청 학성중학교,91,91,0,91,91,0,0,0
교육기관,교육부,호연초등학교,교육부 울산광역시교육청 울산광역시강남교육지원청 호연초등학교,22,22,0,22,17,5,0,0
교육기관,교육부,울산광역시강북교육지원청,교육부 울산광역시교육청 울산광역시강북교육지원청,18,14,4,14,0,14,0,0
교육기관,교육부,가온중학교,교육부 울산광역시교육청 울산광역시강북교육지원청 가온중학교,27,27,0,27,27,0,0,0
교육기관,교육부,강동유치원,교육부 울산광역시교육청 울산광역시강북교육지원청 강동유치원,14,14,0,14,6,8,0,0
교육기관,교육부,강동중학교,교육부 울산광역시교육청 울산광역시강북교육지원청 강동중학교,41,41,0,41,21,20,0,0
교육기관,교육부,강동초등학교,교육부 울산광역시교육청 울산광역시강북교육지원청 강동초등학교,69,69,0,69,0,69,0,0
교육기관,교육부,고헌유치원,교육부 울산광역시교육청 울산광역시강북교육지원청 고헌유치원,23,20,3,20,5,15,0,0
교육기관,교육부,고헌중학교,교육부 울산광역시교육청 울산광역시강북교육지원청 고헌중학교,43,43,0,43,0,43,0,0
교육기관,교육부,고헌초등학교,교육부 울산광역시교육청 울산광역시강북교육지원청 고헌초등학교,55,55,0,55,55,0,0,0
교육기관,교육부,꽃바위유치원,교육부 울산광역시교육청 울산광역시강북교육지원청 꽃바위유치원,10,10,0,10,10,0,0,0
교육기관,교육부,남목중학교,교육부 울산광역시교육청 울산광역시강북교육지원청 남목중학교,33,33,0,33,20,8,5,0
교육기관,교육부,남목초등학교,교육부 울산광역시교육청 울산광역시강북교육지원청 남목초등학교,22,22,0,22,22,0,0,0
교육기관,교육부,남외중학교,교육부 울산광역시교육청 울산광역시강북교육지원청 남외중학교,42,42,0,42,0,42,0,0
교육기관,교육부,남외초등학교,교육부 울산광역시교육청 울산광역시강북교육지원청 남외초등학교,25,25,0,25,25,0,0,0
교육기관,교육부,내황초등학교,교육부 울산광역시교육청 울산광역시강북교육지원청 내황초등학교,24,24,0,24,24,0,0,0
교육기관,교육부,녹수초등학교,교육부 울산광역시교육청 울산광역시강북교육지원청 녹수초등학교,29,22,7,22,0,22,0,0
교육기관,교육부,농서초등학교,교육부 울산광역시교육청 울산광역시강북교육지원청 농서초등학교,30,30,0,30,22,8,0,0
교육기관,교육부,농소중학교,교육부 울산광역시교육청 울산광역시강북교육지원청 농소중학교,29,29,0,29,29,0,0,0
교육기관,교육부,농소초등학교,교육부 울산광역시교육청 울산광역시강북교육지원청 농소초등학교,31,31,0,31,31,0,0,0
교육기관,교육부,다운중학교,교육부 울산광역시교육청 울산광역시강북교육지원청 다운중학교,23,23,0,23,23,0,0,0
교육기관,교육부,다운초등학교,교육부 울산광역시교육청 울산광역시강북교육지원청 다운초등학교,18,18,0,18,18,0,0,0
교육기관,교육부,달천중학교,교육부 울산광역시교육청 울산광역시강북교육지원청 달천중학교,51,51,0,51,51,0,0,0
교육기관,교육부,대송중학교,교육부 울산광역시교육청 울산광역시강북교육지원청 대송중학교,29,29,0,29,0,29,0,0
교육기관,교육부,동대초등학교,교육부 울산광역시교육청 울산광역시강북교육지원청 동대초등학교,30,30,0,30,18,12,0,0
교육기관,교육부,동부초등학교,교육부 울산광역시교육청 울산광역시강북교육지원청 동부초등학교,61,61,0,61,0,61,0,0
교육기관,교육부,동천유치원,교육부 울산광역시교육청 울산광역시강북교육지원청 동천유치원,8,8,0,8,0,8,0,0
교육기관,교육부,동천초등학교,교육부 울산광역시교육청 울산광역시강북교육지원청 동천초등학교,20,20,0,20,18,2,0,0
교육기관,교육부,매곡중학교,교육부 울산광역시교육청 울산광역시강북교육지원청 매곡중학교,51,51,0,51,51,0,0,0
교육기관,교육부,명덕여자중학교,교육부 울산광역시교육청 울산광역시강북교육지원청 명덕여자중학교,18,18,0,18,18,0,0,0
교육기관,교육부,명덕초등학교,교육부 울산광역시교육청 울산광역시강북교육지원청 명덕초등학교,20,20,0,20,20,0,0,0
교육기관,교육부,명정초등학교,교육부 울산광역시교육청 울산광역시강북교육지원청 명정초등학교,28,28,0,28,20,8,0,0
교육기관,교육부,명촌초등학교,교육부 울산광역시교육청 울산광역시강북교육지원청 명촌초등학교,21,21,0,21,21,0,0,0
교육기관,교육부,무룡중학교,교육부 울산광역시교육청 울산광역시강북교육지원청 무룡중학교,42,41,1,41,30,11,0,0
교육기관,교육부,무룡초등학교,교육부 울산광역시교육청 울산광역시강북교육지원청 무룡초등학교,20,20,0,20,20,0,0,0
교육기관,교육부,미포초등학교,교육부 울산광역시교육청 울산광역시강북교육지원청 미포초등학교,24,24,0,24,24,0,0,0
교육기관,교육부,방어진중학교,교육부 울산광역시교육청 울산광역시강북교육지원청 방어진중학교,39,39,0,39,39,0,0,0
교육기관,교육부,방어진초등학교,교육부 울산광역시교육청 울산광역시강북교육지원청 방어진초등학교,13,13,0,13,13,0,0,0
교육기관,교육부,백양초등학교,교육부 울산광역시교육청 울산광역시강북교육지원청 백양초등학교,30,30,0,30,24,6,0,0
교육기관,교육부,병영초등학교,교육부 울산광역시교육청 울산광역시강북교육지원청 병영초등학교,24,24,0,24,14,10,0,0
교육기관,교육부,복산초등학교,교육부 울산광역시교육청 울산광역시강북교육지원청 복산초등학교,23,23,0,23,0,23,0,0
교육기관,교육부,상안유치원,교육부 울산광역시교육청 울산광역시강북교육지원청 상안유치원,17,17,0,17,0,17,0,0
교육기관,교육부,상안중학교,교육부 울산광역시교육청 울산광역시강북교육지원청 상안중학교,31,31,0,31,14,17,0,0
교육기관,교육부,상안초등학교,교육부 울산광역시교육청 울산광역시강북교육지원청 상안초등학교,23,23,0,23,19,4,0,0
교육기관,교육부,상진초등학교,교육부 울산광역시교육청 울산광역시강북교육지원청 상진초등학교,49,49,0,49,49,0,0,0
교육기관,교육부,서부초등학교,교육부 울산광역시교육청 울산광역시강북교육지원청 서부초등학교,61,61,0,61,0,61,0,0
교육기관,교육부,성안중학교,교육부 울산광역시교육청 울산광역시강북교육지원청 성안중학교,48,48,0,48,48,0,0,0
교육기관,교육부,성안초등학교,교육부 울산광역시교육청 울산광역시강북교육지원청 성안초등학교,17,17,0,17,0,17,0,0
교육기관,교육부,신천초등학교,교육부 울산광역시교육청 울산광역시강북교육지원청 신천초등학교,34,34,0,34,34,0,0,0
교육기관,교육부,약사가온유치원,교육부 울산광역시교육청 울산광역시강북교육지원청 약사가온유치원,29,29,0,29,0,29,0,0
교육기관,교육부,약사중학교,교육부 울산광역시교육청 울산광역시강북교육지원청 약사중학교,28,27,1,27,13,14,0,0
교육기관,교육부,약사초등학교,교육부 울산광역시교육청 울산광역시강북교육지원청 약사초등학교,34,34,0,34,34,0,0,0
교육기관,교육부,약수초등학교,교육부 울산광역시교육청 울산광역시강북교육지원청 약수초등학교,23,23,0,23,0,23,0,0
교육기관,교육부,양사초등학교,교육부 울산광역시교육청 울산광역시강북교육지원청 양사초등학교,15,15,0,15,0,15,0,0
교육기관,교육부,연암중학교,교육부 울산광역시교육청 울산광역시강북교육지원청 연암중학교,37,37,0,37,21,16,0,0
교육기관,교육부,연암초등학교,교육부 울산광역시교육청 울산광역시강북교육지원청 연암초등학교,32,32,0,32,0,32,0,0
교육기관,교육부,염포초등학교,교육부 울산광역시교육청 울산광역시강북교육지원청 염포초등학교,21,21,0,21,19,2,0,0
교육기관,교육부,옥성초등학교,교육부 울산광역시교육청 울산광역시강북교육지원청 옥성초등학교,33,33,0,33,20,13,0,0
교육기관,교육부,외솔중학교,교육부 울산광역시교육청 울산광역시강북교육지원청 외솔중학교,34,34,0,34,16,18,0,0
교육기관,교육부,외솔초등학교,교육부 울산광역시교육청 울산광역시강북교육지원청 외솔초등학교,31,31,0,31,31,0,0,0
교육기관,교육부,우정초등학교,교육부 울산광역시교육청 울산광역시강북교육지원청 우정초등학교,30,30,0,30,15,15,0,0
교육기관,교육부,울산양정초등학교,교육부 울산광역시교육청 울산광역시강북교육지원청 울산양정초등학교,19,19,0,19,19,0,0,0
교육기관,교육부,울산제일중학교,교육부 울산광역시교육청 울산광역시강북교육지원청 울산제일중학교,30,30,0,30,30,0,0,0
교육기관,교육부,울산중학교,교육부 울산광역시교육청 울산광역시강북교육지원청 울산중학교,48,47,1,47,0,47,0,0
교육기관,교육부,울산초등학교,교육부 울산광역시교육청 울산광역시강북교육지원청 울산초등학교,34,34,0,34,34,0,0,0
교육기관,교육부,유곡중학교,교육부 울산광역시교육청 울산광역시강북교육지원청 유곡중학교,35,35,0,35,26,9,0,0
교육기관,교육부,은월초등학교,교육부 울산광역시교육청 울산광역시강북교육지원청 은월초등학교,66,66,0,66,0,66,0,0
교육기관,교육부,이화중학교,교육부 울산광역시교육청 울산광역시강북교육지원청 이화중학교,31,31,0,31,31,0,0,0
교육기관,교육부,이화초등학교,교육부 울산광역시교육청 울산광역시강북교육지원청 이화초등학교,27,27,0,27,27,0,0,0
교육기관,교육부,일산중학교,교육부 울산광역시교육청 울산광역시강북교육지원청 일산중학교,39,39,0,39,39,0,0,0
교육기관,교육부,일산초등학교,교육부 울산광역시교육청 울산광역시강북교육지원청 일산초등학교,30,30,0,30,30,0,0,0
교육기관,교육부,전하초등학교,교육부 울산광역시교육청 울산광역시강북교육지원청 전하초등학교,42,42,0,42,30,10,1,1
교육기관,교육부,주전초등학교,교육부 울산광역시교육청 울산광역시강북교육지원청 주전초등학교,10,10,0,10,10,0,0,0
교육기관,교육부,중산초등학교,교육부 울산광역시교육청 울산광역시강북교육지원청 중산초등학교,29,29,0,29,0,29,0,0
교육기관,교육부,진장중학교,교육부 울산광역시교육청 울산광역시강북교육지원청 진장중학교,48,47,1,47,36,9,2,0
교육기관,교육부,천곡중학교,교육부 울산광역시교육청 울산광역시강북교육지원청 천곡중학교,45,45,0,45,45,0,0,0
교육기관,교육부,천곡초등학교,교육부 울산광역시교육청 울산광역시강북교육지원청 천곡초등학교,22,22,0,22,22,0,0,0
교육기관,교육부,태화초등학교,교육부 울산광역시교육청 울산광역시강북교육지원청 태화초등학교,25,25,0,25,25,0,0,0
교육기관,교육부,평산초등학교,교육부 울산광역시교육청 울산광역시강북교육지원청 평산초등학교,9,9,0,9,9,0,0,0
교육기관,교육부,학성여자중학교,교육부 울산광역시교육청 울산광역시강북교육지원청 학성여자중학교,20,20,0,20,0,20,0,0
교육기관,교육부,학성초등학교,교육부 울산광역시교육청 울산광역시강북교육지원청 학성초등학교,16,16,0,16,8,8,0,0
교육기관,교육부,함월초등학교,교육부 울산광역시교육청 울산광역시강북교육지원청 함월초등학교,14,14,0,14,14,0,0,0
교육기관,교육부,현대중학교,교육부 울산광역시교육청 울산광역시강북교육지원청 현대중학교,63,63,0,63,63,0,0,0
교육기관,교육부,현대청운중학교,교육부 울산광역시교육청 울산광역시강북교육지원청 현대청운중학교,66,66,0,66,63,1,2,0
교육기관,교육부,호계중학교,교육부 울산광역시교육청 울산광역시강북교육지원청 호계중학교,61,61,0,61,61,0,0,0
교육기관,교육부,호계초등학교,교육부 울산광역시교육청 울산광역시강북교육지원청 호계초등학교,32,32,0,32,32,0,0,0
교육기관,교육부,화봉중학교,교육부 울산광역시교육청 울산광역시강북교육지원청 화봉중학교,25,24,1,24,0,24,0,0
교육기관,교육부,화봉초등학교,교육부 울산광역시교육청 울산광역시강북교육지원청 화봉초등학교,51,51,0,51,51,0,0,0
교육기관,교육부,화암중학교,교육부 울산광역시교육청 울산광역시강북교육지원청 화암중학교,50,49,1,49,0,49,0,0
교육기관,교육부,화암초등학교,교육부 울산광역시교육청 울산광역시강북교육지원청 화암초등학교,33,33,0,33,23,10,0,0
교육기관,교육부,화정초등학교,교육부 울산광역시교육청 울산광역시강북교육지원청 화정초등학교,30,30,0,30,30,0,0,0
교육기관,교육부,화진중학교,교육부 울산광역시교육청 울산광역시강북교육지원청 화진중학교,16,15,1,15,7,8,0,0
교육기관,교육부,화진초등학교,교육부 울산광역시교육청 울산광역시강북교육지원청 화진초등학교,24,24,0,24,0,24,0,0
교육기관,교육부,효정중학교,교육부 울산광역시교육청 울산광역시강북교육지원청 효정중학교,48,47,1,47,41,6,0,0
교육기관,교육부,울산광역시교육수련원,교육부 울산광역시교육청 울산광역시교육수련원,43,43,0,43,0,43,0,0
교육기관,교육부,울산광역시교육연구정보원,교육부 울산광역시교육청 울산광역시교육연구정보원,124,124,0,124,0,124,0,0
교육기관,교육부,울산광역시교육연수원,교육부 울산광역시교육청 울산광역시교육연수원,61,61,0,61,0,61,0,0
교육기관,교육부,울산광역시수학문화관,교육부 울산광역시교육청 울산광역시수학문화관,14,14,0,14,0,14,0,0
교육기관,교육부,울산광역시유아교육진흥원,교육부 울산광역시교육청 울산광역시유아교육진흥원,90,90,0,90,0,90,0,0
교육기관,교육부,울산광역시학생교육문화회관,교육부 울산광역시교육청 울산광역시학생교육문화회관,59,59,0,59,0,59,0,0
교육기관,교육부,울산광역시학생교육원,교육부 울산광역시교육청 울산광역시학생교육원,33,33,0,33,0,33,0,0
교육기관,교육부,울산기술공업고등학교,교육부 울산광역시교육청 울산기술공업고등학교,37,37,0,37,25,12,0,0
교육기관,교육부,울산남부도서관,교육부 울산광역시교육청 울산남부도서관,33,33,0,33,0,33,0,0
교육기관,교육부,울산마이스터고등학교,교육부 울산광역시교육청 울산마이스터고등학교,129,129,0,129,67,55,6,1
교육기관,교육부,울산미용예술고등학교,교육부 울산광역시교육청 울산미용예술고등학교,48,47,1,47,43,2,2,0
교육기관,교육부,울산상업고등학교,교육부 울산광역시교육청 울산상업고등학교,123,123,0,123,123,0,0,0
교육기관,교육부,울산생활과학고등학교,교육부 울산광역시교육청 울산생활과학고등학교,82,80,2,80,0,80,0,0
교육기관,교육부,울산스포츠과학고등학교,교육부 울산광역시교육청 울산스포츠과학고등학교,189,0,189,0,0,0,0,0
교육기관,교육부,울산애니원고등학교,교육부 울산광역시교육청 울산애니원고등학교,47,47,0,47,0,47,0,0
교육기관,교육부,울산에너지고등학교,교육부 울산광역시교육청 울산에너지고등학교,48,48,0,48,31,17,0,0
교육기관,교육부,울산여자고등학교,교육부 울산광역시교육청 울산여자고등학교,62,62,0,62,62,0,0,0
교육기관,교육부,울산여자상업고등학교,교육부 울산광역시교육청 울산여자상업고등학교,37,36,1,36,36,0,0,0
교육기관,교육부,울산예술고등학교,교육부 울산광역시교육청 울산예술고등학교,21,21,0,21,9,9,2,1
교육기관,교육부,울산외국어고등학교,교육부 울산광역시교육청 울산외국어고등학교,160,160,0,160,87,73,0,0
교육기관,교육부,울산제일고등학교,교육부 울산광역시교육청 울산제일고등학교,56,54,2,54,53,0,1,0
교육기관,교육부,울산중부도서관,교육부 울산광역시교육청 울산중부도서관,7,7,0,7,3,4,0,0
교육기관,교육부,울산중앙고등학교,교육부 울산광역시교육청 울산중앙고등학교,34,34,0,34,0,34,0,0
교육기관,교육부,울산중앙여자고등학교,교육부 울산광역시교육청 울산중앙여자고등학교,32,31,1,31,27,0,4,0
교육기관,교육부,울산행복학교,교육부 울산광역시교육청 울산행복학교,66,66,0,66,0,66,0,0
교육기관,교육부,울주도서관,교육부 울산광역시교육청 울주도서관,41,41,0,41,0,41,0,0
교육기관,교육부,천상고등학교,교육부 울산광역시교육청 천상고등학교,25,25,0,25,25,0,0,0
교육기관,교육부,태연학교,교육부 울산광역시교육청 태연학교,36,36,0,36,27,9,0,0
교육기관,교육부,학성고등학교,교육부 울산광역시교육청 학성고등학교,39,36,3,36,30,6,0,0
교육기관,교육부,학성여자고등학교,교육부 울산광역시교육청 학성여자고등학교,23,23,0,23,13,8,1,1
교육기관,교육부,함월고등학교,교육부 울산광역시교육청 함월고등학교,36,36,0,36,18,18,0,0
교육기관,교육부,현대고등학교,교육부 울산광역시교육청 현대고등학교,45,45,0,45,45,0,0,0
교육기관,교육부,현대공업고등학교,교육부 울산광역시교육청 현대공업고등학교,99,99,0,99,0,99,0,0
교육기관,교육부,현대청운고등학교,교육부 울산광역시교육청 현대청운고등학교,116,22,94,22,22,0,0,0
교육기관,교육부,혜인학교,교육부 울산광역시교육청 혜인학교,65,65,0,65,65,0,0,0
교육기관,교육부,호계고등학교,교육부 울산광역시교육청 호계고등학교,85,85,0,85,60,25,0,0
교육기관,교육부,화봉고등학교,교육부 울산광역시교육청 화봉고등학교,33,30,3,30,18,12,0,0
교육기관,교육부,화암고등학교,교육부 울산광역시교육청 화암고등학교,47,45,2,45,25,16,2,2
교육기관,교육부,효정고등학교,교육부 울산광역시교육청 효정고등학교,16,16,0,16,15,1,0,0
교육기관,교육부,세종특별자치시교육청,교육부 세종특별자치시교육청,55,55,0,55,0,55,0,0
교육기관,교육부,가득초등학교,교육부 세종특별자치시교육청 가득초등학교,54,54,0,54,54,0,0,0
교육기관,교육부,가락유치원,교육부 세종특별자치시교육청 가락유치원,18,18,0,18,0,18,0,0
교육기관,교육부,가락초등학교,교육부 세종특별자치시교육청 가락초등학교,52,52,0,52,39,13,0,0
교육기관,교육부,가온유치원,교육부 세종특별자치시교육청 가온유치원,8,8,0,8,3,4,1,0
교육기관,교육부,감성초등학교,교육부 세종특별자치시교육청 감성초등학교,31,31,0,31,0,31,0,0
교육기관,교육부,고운고등학교,교육부 세종특별자치시교육청 고운고등학교,48,48,0,48,13,35,0,0
교육기관,교육부,고운유치원,교육부 세종특별자치시교육청 고운유치원,26,4,22,4,0,4,0,0
교육기관,교육부,고운초등학교,교육부 세종특별자치시교육청 고운초등학교,89,89,0,89,14,75,0,0
교육기관,교육부,글벗유치원,교육부 세종특별자치시교육청 글벗유치원,22,22,0,22,0,22,0,0
교육기관,교육부,글벗중학교,교육부 세종특별자치시교육청 글벗중학교,44,44,0,44,30,14,0,0
교육기관,교육부,글벗초등학교,교육부 세종특별자치시교육청 글벗초등학교,72,72,0,72,36,36,0,0
교육기관,교육부,금남초등학교,교육부 세종특별자치시교육청 금남초등학교,21,21,0,21,21,0,0,0
교육기관,교육부,금호중학교,교육부 세종특별자치시교육청 금호중학교,55,55,0,55,0,55,0,0
교육기관,교육부,나래유치원,교육부 세종특별자치시교육청 나래유치원,10,10,0,10,0,10,0,0
교육기관,교육부,나래초등학교,교육부 세종특별자치시교육청 나래초등학교,39,39,0,39,20,19,0,0
교육기관,교육부,나루초등학교,교육부 세종특별자치시교육청 나루초등학교,50,48,2,48,41,2,5,0
교육기관,교육부,나성유치원,교육부 세종특별자치시교육청 나성유치원,25,8,17,8,0,8,0,0
교육기관,교육부,나성중학교,교육부 세종특별자치시교육청 나성중학교,77,77,0,77,0,77,0,0
교육기관,교육부,나성초등학교,교육부 세종특별자치시교육청 나성초등학교,91,91,0,91,0,91,0,0
교육기관,교육부,늘봄유치원,교육부 세종특별자치시교육청 늘봄유치원,18,18,0,18,0,18,0,0
교육기관,교육부,늘봄초등학교,교육부 세종특별자치시교육청 늘봄초등학교,40,40,0,40,0,40,0,0
교육기관,교육부,다빛유치원,교육부 세종특별자치시교육청 다빛유치원,25,25,0,25,3,20,1,1
교육기관,교육부,다빛초등학교,교육부 세종특별자치시교육청 다빛초등학교,71,71,0,71,0,71,0,0
교육기관,교육부,다정고등학교,교육부 세종특별자치시교육청 다정고등학교,58,58,0,58,0,58,0,0
교육기관,교육부,다정유치원,교육부 세종특별자치시교육청 다정유치원,16,16,0,16,0,16,0,0
교육기관,교육부,다정중학교,교육부 세종특별자치시교육청 다정중학교,64,62,2,62,0,62,0,0
교육기관,교육부,다정초등학교,교육부 세종특별자치시교육청 다정초등학교,65,21,44,21,11,10,0,0
교육기관,교육부,대평유치원,교육부 세종특별자치시교육청 대평유치원,12,12,0,12,1,11,0,0
교육기관,교육부,대평초등학교,교육부 세종특별자치시교육청 대평초등학교,69,69,0,69,0,69,0,0
교육기관,교육부,도담고등학교,교육부 세종특별자치시교육청 도담고등학교,46,44,2,44,11,33,0,0
교육기관,교육부,도담유치원,교육부 세종특별자치시교육청 도담유치원,8,0,8,0,0,0,0,0
교육기관,교육부,도담초등학교,교육부 세종특별자치시교육청 도담초등학교,74,74,0,74,0,74,0,0
교육기관,교육부,도란유치원,교육부 세종특별자치시교육청 도란유치원,18,18,0,18,9,9,0,0
교육기관,교육부,두루고등학교,교육부 세종특별자치시교육청 두루고등학교,53,52,1,52,0,52,0,0
교육기관,교육부,두루유치원,교육부 세종특별자치시교육청 두루유치원,16,16,0,16,0,16,0,0
교육기관,교육부,두루중학교,교육부 세종특별자치시교육청 두루중학교,43,43,0,43,0,43,0,0
교육기관,교육부,미르유치원,교육부 세종특별자치시교육청 미르유치원,19,19,0,19,0,19,0,0
교육기관,교육부,미르초등학교,교육부 세종특별자치시교육청 미르초등학교,27,27,0,27,5,22,0,0
교육기관,교육부,반곡고등학교,교육부 세종특별자치시교육청 반곡고등학교,80,80,0,80,79,1,0,0
교육기관,교육부,반곡유치원,교육부 세종특별자치시교육청 반곡유치원,21,21,0,21,9,12,0,0
교육기관,교육부,반곡초등학교,교육부 세종특별자치시교육청 반곡초등학교,62,62,0,62,30,32,0,0
교육기관,교육부,보람중학교,교육부 세종특별자치시교육청 보람중학교,58,58,0,58,19,39,0,0
교육기관,교육부,보람초등학교,교육부 세종특별자치시교육청 보람초등학교,69,69,0,69,69,0,0,0
교육기관,교육부,부강중학교,교육부 세종특별자치시교육청 부강중학교,34,33,1,33,0,33,0,0
교육기관,교육부,부강초등학교,교육부 세종특별자치시교육청 부강초등학교,34,33,1,33,0,33,0,0
교육기관,교육부,새뜸유치원,교육부 세종특별자치시교육청 새뜸유치원,24,24,0,24,17,7,0,0
교육기관,교육부,새뜸중학교,교육부 세종특별자치시교육청 새뜸중학교,40,40,0,40,0,40,0,0
교육기관,교육부,새뜸초등학교,교육부 세종특별자치시교육청 새뜸초등학교,63,63,0,63,63,0,0,0
교육기관,교육부,새롬고등학교,교육부 세종특별자치시교육청 새롬고등학교,65,63,2,63,33,30,0,0
교육기관,교육부,새롬유치원,교육부 세종특별자치시교육청 새롬유치원,30,30,0,30,2,26,2,0
교육기관,교육부,새롬중학교,교육부 세종특별자치시교육청 새롬중학교,30,28,2,28,0,28,0,0
교육기관,교육부,새롬초등학교,교육부 세종특별자치시교육청 새롬초등학교,73,73,0,73,73,0,0,0
교육기관,교육부,새솔유치원,교육부 세종특별자치시교육청 새솔유치원,21,4,17,4,2,2,0,0
교육기관,교육부,새움유치원,교육부 세종특별자치시교육청 새움유치원,22,22,0,22,7,15,0,0
교육기관,교육부,새움중학교,교육부 세종특별자치시교육청 새움중학교,30,30,0,30,30,0,0,0
교육기관,교육부,새움초등학교,교육부 세종특별자치시교육청 새움초등학교,67,67,0,67,0,67,0,0
교육기관,교육부,성모유치원,교육부 세종특별자치시교육청 성모유치원,2,2,0,2,1,1,0,0
교육기관,교육부,세종고등학교,교육부 세종특별자치시교육청 세종고등학교,78,78,0,78,0,78,0,0
교육기관,교육부,세종과학예술영재학교,교육부 세종특별자치시교육청 세종과학예술영재학교,76,76,0,76,0,76,0,0
교육기관,교육부,세종국제고등학교,교육부 세종특별자치시교육청 세종국제고등학교,45,45,0,45,45,0,0,0
교육기관,교육부,세종누리학교,교육부 세종특별자치시교육청 세종누리학교,62,62,0,62,3,59,0,0
교육기관,교육부,세종대성고등학교,교육부 세종특별자치시교육청 세종대성고등학교,72,72,0,72,0,72,0,0
교육기관,교육부,세종도원초등학교,교육부 세종특별자치시교육청 세종도원초등학교,61,61,0,61,6,55,0,0
교육기관,교육부,세종여자고등학교,교육부 세종특별자치시교육청 세종여자고등학교,54,54,0,54,51,3,0,0
교육기관,교육부,세종예술고등학교,교육부 세종특별자치시교육청 세종예술고등학교,54,54,0,54,14,40,0,0
교육기관,교육부,세종이음학교,교육부 세종특별자치시교육청 세종이음학교,99,99,0,99,0,99,0,0
교육기관,교육부,세종장영실고등학교,교육부 세종특별자치시교육청 세종장영실고등학교,122,122,0,122,0,122,0,0
교육기관,교육부,세종중학교,교육부 세종특별자치시교육청 세종중학교,98,97,1,97,0,97,0,0
교육기관,교육부,세종특별자치시교육청교육원,교육부 세종특별자치시교육청 세종특별자치시교육청교육원,109,68,41,68,0,68,0,0
교육기관,교육부,세종특별자치시교육청시설지원사업소,교육부 세종특별자치시교육청 세종특별자치시교육청시설지원사업소,21,21,0,21,0,21,0,0
교육기관,교육부,세종특별자치시교육청안전체험교육원,교육부 세종특별자치시교육청 세종특별자치시교육청안전체험교육원,47,46,1,46,10,36,0,0
교육기관,교육부,세종특별자치시교육청학생화해중재원,교육부 세종특별자치시교육청 세종특별자치시교육청학생화해중재원,20,20,0,20,5,15,0,0
교육기관,교육부,세종특별자치시평생교육학습관,교육부 세종특별자치시교육청 세종특별자치시평생교육학습관,16,16,0,16,3,13,0,0
교육기관,교육부,세종하이텍고등학교,교육부 세종특별자치시교육청 세종하이텍고등학교,149,149,0,149,109,40,0,0
교육기관,교육부,소담고등학교,교육부 세종특별자치시교육청 소담고등학교,65,65,0,65,44,15,3,3
교육기관,교육부,소담유치원,교육부 세종특별자치시교육청 소담유치원,19,19,0,19,19,0,0,0
교육기관,교육부,소담중학교,교육부 세종특별자치시교육청 소담중학교,53,51,2,51,0,51,0,0
교육기관,교육부,소담초등학교,교육부 세종특별자치시교육청 소담초등학교,43,43,0,43,43,0,0,0
교육기관,교육부,소정초등학교,교육부 세종특별자치시교육청 소정초등학교,19,19,0,19,19,0,0,0
교육기관,교육부,솔빛숲유치원,교육부 세종특별자치시교육청 솔빛숲유치원,31,29,2,29,5,24,0,0
교육기관,교육부,솔빛초등학교,교육부 세종특별자치시교육청 솔빛초등학교,54,54,0,54,54,0,0,0
교육기관,교육부,수왕초등학교,교육부 세종특별자치시교육청 수왕초등학교,30,30,0,30,0,30,0,0
교육기관,교육부,슬기유치원,교육부 세종특별자치시교육청 슬기유치원,20,20,0,20,2,18,0,0
교육기관,교육부,쌍류초등학교,교육부 세종특별자치시교육청 쌍류초등학교,23,23,0,23,20,3,0,0
교육기관,교육부,아름고등학교,교육부 세종특별자치시교육청 아름고등학교,46,46,0,46,46,0,0,0
교육기관,교육부,아름유치원,교육부 세종특별자치시교육청 아름유치원,16,16,0,16,7,9,0,0
교육기관,교육부,아름중학교,교육부 세종특별자치시교육청 아름중학교,79,79,0,79,0,79,0,0
교육기관,교육부,아름초등학교,교육부 세종특별자치시교육청 아름초등학교,43,43,0,43,43,0,0,0
교육기관,교육부,아이마루유치원,교육부 세종특별자치시교육청 아이마루유치원,16,0,16,0,0,0,0,0
교육기관,교육부,양지고등학교,교육부 세종특별자치시교육청 양지고등학교,53,51,2,51,0,51,0,0
교육기관,교육부,양지중학교,교육부 세종특별자치시교육청 양지중학교,69,69,0,69,16,53,0,0
교육기관,교육부,양지초등학교,교육부 세종특별자치시교육청 양지초등학교,61,61,0,61,7,54,0,0
교육기관,교육부,어진중학교,교육부 세종특별자치시교육청 어진중학교,62,62,0,62,22,40,0,0
교육기관,교육부,여울유치원,교육부 세종특별자치시교육청 여울유치원,15,15,0,15,0,15,0,0
교육기관,교육부,여울초등학교,교육부 세종특별자치시교육청 여울초등학교,70,70,0,70,14,56,0,0
교육기관,교육부,연남초등학교,교육부 세종특별자치시교육청 연남초등학교,17,17,0,17,17,0,0,0
교육기관,교육부,연동초등학교,교육부 세종특별자치시교육청 연동초등학교,20,20,0,20,20,0,0,0
교육기관,교육부,연봉초등학교,교육부 세종특별자치시교육청 연봉초등학교,24,24,0,24,0,24,0,0
교육기관,교육부,연서초등학교,교육부 세종특별자치시교육청 연서초등학교,34,34,0,34,23,11,0,0
교육기관,교육부,연세초등학교,교육부 세종특별자치시교육청 연세초등학교,26,26,0,26,13,13,0,0
교육기관,교육부,연양유치원,교육부 세종특별자치시교육청 연양유치원,15,15,0,15,0,15,0,0
교육기관,교육부,연양초등학교,교육부 세종특별자치시교육청 연양초등학교,70,70,0,70,26,44,0,0
교육기관,교육부,온빛유치원,교육부 세종특별자치시교육청 온빛유치원,13,3,10,3,1,1,1,0
교육기관,교육부,온빛초등학교,교육부 세종특별자치시교육청 온빛초등학교,47,47,0,47,47,0,0,0
교육기관,교육부,올망유치원,교육부 세종특별자치시교육청 올망유치원,22,22,0,22,0,22,0,0
교육기관,교육부,으뜸유치원,교육부 세종특별자치시교육청 으뜸유치원,12,12,0,12,0,12,0,0
교육기관,교육부,으뜸초등학교,교육부 세종특별자치시교육청 으뜸초등학교,32,11,21,11,11,0,0,0
교육기관,교육부,의랑초등학교,교육부 세종특별자치시교육청 의랑초등학교,23,23,0,23,12,11,0,0
교육기관,교육부,장기중학교,교육부 세종특별자치시교육청 장기중학교,16,16,0,16,16,0,0,0
교육기관,교육부,장기초등학교,교육부 세종특별자치시교육청 장기초등학교,24,24,0,24,0,24,0,0
교육기관,교육부,전의중학교,교육부 세종특별자치시교육청 전의중학교,19,19,0,19,12,7,0,0
교육기관,교육부,전의초등학교,교육부 세종특별자치시교육청 전의초등학교,22,22,0,22,11,11,0,0
교육기관,교육부,조치원교동초등학교,교육부 세종특별자치시교육청 조치원교동초등학교,25,25,0,25,0,25,0,0
교육기관,교육부,조치원대동초등학교,교육부 세종특별자치시교육청 조치원대동초등학교,43,43,0,43,43,0,0,0
교육기관,교육부,조치원명동초등학교,교육부 세종특별자치시교육청 조치원명동초등학교,34,19,15,19,19,0,0,0
교육기관,교육부,조치원신봉초등학교,교육부 세종특별자치시교육청 조치원신봉초등학교,44,44,0,44,0,44,0,0
교육기관,교육부,조치원중학교,교육부 세종특별자치시교육청 조치원중학교,61,20,41,20,0,20,0,0
교육기관,교육부,종촌고등학교,교육부 세종특별자치시교육청 종촌고등학교,42,42,0,42,42,0,0,0
교육기관,교육부,종촌유치원,교육부 세종특별자치시교육청 종촌유치원,16,16,0,16,4,12,0,0
교육기관,교육부,종촌중학교,교육부 세종특별자치시교육청 종촌중학교,56,55,1,55,14,41,0,0
교육기관,교육부,종촌초등학교,교육부 세종특별자치시교육청 종촌초등학교,62,62,0,62,19,43,0,0
교육기관,교육부,집현유치원,교육부 세종특별자치시교육청 집현유치원,27,10,17,10,4,2,4,0
교육기관,교육부,집현중학교,교육부 세종특별자치시교육청 집현중학교,58,58,0,58,18,40,0,0
교육기관,교육부,집현초등학교,교육부 세종특별자치시교육청 집현초등학교,53,53,0,53,33,20,0,0
교육기관,교육부,참샘유치원,교육부 세종특별자치시교육청 참샘유치원,16,2,14,2,1,1,0,0
교육기관,교육부,참샘초등학교,교육부 세종특별자치시교육청 참샘초등학교,49,49,0,49,21,28,0,0
교육기관,교육부,초롱별유치원,교육부 세종특별자치시교육청 초롱별유치원,24,24,0,24,0,24,0,0
교육기관,교육부,한결유치원,교육부 세종특별자치시교육청 한결유치원,19,19,0,19,0,19,0,0
교육기관,교육부,한결초등학교,교육부 세종특별자치시교육청 한결초등학교,65,21,44,21,21,0,0,0
교육기관,교육부,한빛유치원,교육부 세종특별자치시교육청 한빛유치원,20,20,0,20,0,20,0,0
교육기관,교육부,한솔고등학교,교육부 세종특별자치시교육청 한솔고등학교,53,53,0,53,0,53,0,0
교육기관,교육부,한솔유치원,교육부 세종특별자치시교육청 한솔유치원,14,3,11,3,0,3,0,0
교육기관,교육부,한솔중학교,교육부 세종특별자치시교육청 한솔중학교,45,45,0,45,20,25,0,0
교육기관,교육부,한솔초등학교,교육부 세종특별자치시교육청 한솔초등학교,45,45,0,45,0,45,0,0
교육기관,교육부,해들유치원,교육부 세종특별자치시교육청 해들유치원,25,25,0,25,9,16,0,0
교육기관,교육부,해밀고등학교,교육부 세종특별자치시교육청 해밀고등학교,59,59,0,59,59,0,0,0
교육기관,교육부,해밀초등학교,교육부 세종특별자치시교육청 해밀초등학교,100,99,1,99,0,99,0,0
교육기관,교육부,경기도교육청,교육부 경기도교육청,113,113,0,113,0,113,0,0
교육기관,교육부,경기과천교육도서관,교육부 경기도교육청 경기과천교육도서관,43,43,0,43,0,43,0,0
교육기관,교육부,경기광주교육도서관,교육부 경기도교육청 경기광주교육도서관,8,8,0,8,0,8,0,0
교육기관,교육부,경기김포교육도서관,교육부 경기도교육청 경기김포교육도서관,8,8,0,8,2,6,0,0
교육기관,교육부,경기도가평교육지원청,교육부 경기도교육청 경기도가평교육지원청,7,7,0,7,0,7,0,0
교육기관,교육부,가평고등학교,교육부 경기도교육청 경기도가평교육지원청 가평고등학교,77,77,0,77,0,77,0,0
교육기관,교육부,가평마장초등학교,교육부 경기도교육청 경기도가평교육지원청 가평마장초등학교,10,2,8,2,2,0,0,0
교육기관,교육부,가평북중학교,교육부 경기도교육청 경기도가평교육지원청 가평북중학교,17,17,0,17,14,1,1,1
교육기관,교육부,가평유치원,교육부 경기도교육청 경기도가평교육지원청 가평유치원,11,11,0,11,0,11,0,0
교육기관,교육부,가평중학교,교육부 경기도교육청 경기도가평교육지원청 가평중학교,37,37,0,37,22,15,0,0
교육기관,교육부,가평초등학교,교육부 경기도교육청 경기도가평교육지원청 가평초등학교,37,34,3,34,16,18,0,0
교육기관,교육부,경기도교직원가평수덕원,교육부 경기도교육청 경기도가평교육지원청 경기도교직원가평수덕원,0,0,0,0,0,0,0,0
교육기관,교육부,노비따스음악중학교,교육부 경기도교육청 경기도가평교육지원청 노비따스음악중학교,36,32,4,32,14,14,2,2
교육기관,교육부,대성초등학교,교육부 경기도교육청 경기도가평교육지원청 대성초등학교,13,13,0,13,5,8,0,0
교육기관,교육부,목동초등학교,교육부 경기도교육청 경기도가평교육지원청 목동초등학교,16,16,0,16,0,16,0,0
교육기관,교육부,미원초등학교,교육부 경기도교육청 경기도가평교육지원청 미원초등학교,16,16,0,16,0,16,0,0
교육기관,교육부,미원초등학교위곡분교장,교육부 경기도교육청 경기도가평교육지원청 미원초등학교위곡분교장,8,8,0,8,4,4,0,0
교육기관,교육부,미원초등학교장락분교장,교육부 경기도교육청 경기도가평교육지원청 미원초등학교장락분교장,8,8,0,8,4,3,0,1
교육기관,교육부,방일초등학교,교육부 경기도교육청 경기도가평교육지원청 방일초등학교,18,18,0,18,18,0,0,0
교육기관,교육부,상면초등학교,교육부 경기도교육청 경기도가평교육지원청 상면초등학교,14,14,0,14,14,0,0,0
교육기관,교육부,상색초등학교,교육부 경기도교육청 경기도가평교육지원청 상색초등학교,12,12,0,12,6,4,2,0
교육기관,교육부,상천초등학교,교육부 경기도교육청 경기도가평교육지원청 상천초등학교,8,8,0,8,0,8,0,0
교육기관,교육부,설악고등학교,교육부 경기도교육청 경기도가평교육지원청 설악고등학교,13,13,0,13,0,13,0,0
교육기관,교육부,설악중학교,교육부 경기도교육청 경기도가평교육지원청 설악중학교,8,8,0,8,8,0,0,0
교육기관,교육부,연하초등학교,교육부 경기도교육청 경기도가평교육지원청 연하초등학교,10,10,0,10,0,10,0,0
교육기관,교육부,율길초등학교,교육부 경기도교육청 경기도가평교육지원청 율길초등학교,8,8,0,8,8,0,0,0
교육기관,교육부,조종고등학교,교육부 경기도교육청 경기도가평교육지원청 조종고등학교,34,15,19,15,10,5,0,0
교육기관,교육부,조종중학교,교육부 경기도교육청 경기도가평교육지원청 조종중학교,0,0,0,0,0,0,0,0
교육기관,교육부,조종초등학교,교육부 경기도교육청 경기도가평교육지원청 조종초등학교,15,15,0,15,0,15,0,0
교육기관,교육부,청심국제고등학교,교육부 경기도교육청 경기도가평교육지원청 청심국제고등학교,136,136,0,136,0,136,0,0
교육기관,교육부,청심국제중학교,교육부 경기도교육청 경기도가평교육지원청 청심국제중학교,136,136,0,136,0,136,0,0
교육기관,교육부,청평고등학교,교육부 경기도교육청 경기도가평교육지원청 청평고등학교,29,29,0,29,16,13,0,0
교육기관,교육부,청평중학교,교육부 경기도교육청 경기도가평교육지원청 청평중학교,16,16,0,16,16,0,0,0
교육기관,교육부,청평초등학교,교육부 경기도교육청 경기도가평교육지원청 청평초등학교,19,19,0,19,19,0,0,0
교육기관,교육부,경기도고양교육지원청,교육부 경기도교육청 경기도고양교육지원청,15,15,0,15,0,15,0,0
교육기관,교육부,가람중학교,교육부 경기도교육청 경기도고양교육지원청 가람중학교,44,44,0,44,0,44,0,0
교육기관,교육부,가람초등학교,교육부 경기도교육청 경기도고양교육지원청 가람초등학교,16,16,0,16,0,16,0,0
교육기관,교육부,가좌고등학교,교육부 경기도교육청 경기도고양교육지원청 가좌고등학교,27,27,0,27,27,0,0,0
교육기관,교육부,가좌초등학교,교육부 경기도교육청 경기도고양교육지원청 가좌초등학교,24,24,0,24,16,8,0,0
교육기관,교육부,강선초등학교,교육부 경기도교육청 경기도고양교육지원청 강선초등학교,13,13,0,13,7,6,0,0
교육기관,교육부,경기영상과학고등학교,교육부 경기도교육청 경기도고양교육지원청 경기영상과학고등학교,34,33,1,33,33,0,0,0
교육기관,교육부,고봉초등학교,교육부 경기도교육청 경기도고양교육지원청 고봉초등학교,25,25,0,25,0,25,0,0
교육기관,교육부,고양고등학교,교육부 경기도교육청 경기도고양교육지원청 고양고등학교,31,31,0,31,31,0,0,0
교육기관,교육부,고양관산초등학교,교육부 경기도교육청 경기도고양교육지원청 고양관산초등학교,20,20,0,20,8,10,1,1
교육기관,교육부,고양국제고등학교,교육부 경기도교육청 경기도고양교육지원청 고양국제고등학교,86,17,69,17,0,17,0,0
교육기관,교육부,고양동산고등학교,교육부 경기도교육청 경기도고양교육지원청 고양동산고등학교,33,33,0,33,25,8,0,0
교육기관,교육부,고양동산초등학교,교육부 경기도교육청 경기도고양교육지원청 고양동산초등학교,30,30,0,30,17,13,0,0
교육기관,교육부,고양백석초등학교,교육부 경기도교육청 경기도고양교육지원청 고양백석초등학교,14,14,0,14,7,7,0,0
교육기관,교육부,고양송산중학교,교육부 경기도교육청 경기도고양교육지원청 고양송산중학교,49,48,1,48,0,48,0,0
교육기관,교육부,고양송암고등학교(2년제),교육부 경기도교육청 경기도고양교육지원청 고양송암고등학교(2년제),16,16,0,16,8,8,0,0
교육기관,교육부,고양신일초등학교,교육부 경기도교육청 경기도고양교육지원청 고양신일초등학교,16,16,0,16,0,16,0,0
교육기관,교육부,고양예술고등학교,교육부 경기도교육청 경기도고양교육지원청 고양예술고등학교,186,186,0,186,57,100,29,0
교육기관,교육부,고양오금유치원,교육부 경기도교육청 경기도고양교육지원청 고양오금유치원,25,25,0,25,0,25,0,0
교육기관,교육부,고양오금초등학교,교육부 경기도교육청 경기도고양교육지원청 고양오금초등학교,16,16,0,16,10,6,0,0
교육기관,교육부,고양외국어고등학교,교육부 경기도교육청 경기도고양교육지원청 고양외국어고등학교,16,16,0,16,2,14,0,0
교육기관,교육부,고양용현초등학교,교육부 경기도교육청 경기도고양교육지원청 고양용현초등학교,11,11,0,11,11,0,0,0
교육기관,교육부,고양일고등학교,교육부 경기도교육청 경기도고양교육지원청 고양일고등학교,32,30,2,30,3,19,4,4
교육기관,교육부,고양일산유치원,교육부 경기도교육청 경기도고양교육지원청 고양일산유치원,11,11,0,11,0,11,0,0
교육기관,교육부,고양제일중학교,교육부 경기도교육청 경기도고양교육지원청 고양제일중학교,14,14,0,14,7,7,0,0
교육기관,교육부,고양중학교,교육부 경기도교육청 경기도고양교육지원청 고양중학교,43,43,0,43,0,43,0,0
교육기관,교육부,고양한내초등학교,교육부 경기도교육청 경기도고양교육지원청 고양한내초등학교,15,15,0,15,0,15,0,0
교육기관,교육부,고양화수초등학교,교육부 경기도교육청 경기도고양교육지원청 고양화수초등학교,13,13,0,13,0,13,0,0
교육기관,교육부,고양화정초등학교,교육부 경기도교육청 경기도고양교육지원청 고양화정초등학교,13,13,0,13,11,2,0,0
교육기관,교육부,광성드림학교,교육부 경기도교육청 경기도고양교육지원청 광성드림학교,41,41,0,41,0,41,0,0
교육기관,교육부,금계초등학교,교육부 경기도교육청 경기도고양교육지원청 금계초등학교,15,15,0,15,15,0,0,0
교육기관,교육부,꽃향기유치원,교육부 경기도교육청 경기도고양교육지원청 꽃향기유치원,26,26,0,26,0,26,0,0
교육기관,교육부,낙민초등학교,교육부 경기도교육청 경기도고양교육지원청 낙민초등학교,13,13,0,13,0,13,0,0
교육기관,교육부,내유초등학교,교육부 경기도교육청 경기도고양교육지원청 내유초등학교,22,22,0,22,22,0,0,0
교육기관,교육부,냉천초등학교,교육부 경기도교육청 경기도고양교육지원청 냉천초등학교,20,20,0,20,3,17,0,0
교육기관,교육부,능곡고등학교,교육부 경기도교육청 경기도고양교육지원청 능곡고등학교,26,25,1,25,10,11,2,2
교육기관,교육부,능곡중학교,교육부 경기도교육청 경기도고양교육지원청 능곡중학교,36,36,0,36,9,27,0,0
교육기관,교육부,능곡초등학교,교육부 경기도교육청 경기도고양교육지원청 능곡초등학교,17,17,0,17,17,0,0,0
교육기관,교육부,다솔유치원,교육부 경기도교육청 경기도고양교육지원청 다솔유치원,11,11,0,11,0,11,0,0
교육기관,교육부,다솜초등학교,교육부 경기도교육청 경기도고양교육지원청 다솜초등학교,14,14,0,14,0,14,0,0
교육기관,교육부,대곡초등학교,교육부 경기도교육청 경기도고양교육지원청 대곡초등학교,14,14,0,14,0,14,0,0
교육기관,교육부,대송중학교,교육부 경기도교육청 경기도고양교육지원청 대송중학교,32,31,1,31,4,25,1,1
교육기관,교육부,대화고등학교,교육부 경기도교육청 경기도고양교육지원청 대화고등학교,35,35,0,35,11,24,0,0
교육기관,교육부,대화중학교,교육부 경기도교육청 경기도고양교육지원청 대화중학교,45,45,0,45,14,31,0,0
교육기관,교육부,대화초등학교,교육부 경기도교육청 경기도고양교육지원청 대화초등학교,8,8,0,8,4,4,0,0
교육기관,교육부,덕양중학교,교육부 경기도교육청 경기도고양교육지원청 덕양중학교,8,8,0,8,5,3,0,0
교육기관,교육부,덕은초등학교,교육부 경기도교육청 경기도고양교육지원청 덕은초등학교,14,14,0,14,10,4,0,0
교육기관,교육부,덕은한강초등학교,교육부 경기도교육청 경기도고양교육지원청 덕은한강초등학교,20,20,0,20,17,3,0,0
교육기관,교육부,덕이고등학교,교육부 경기도교육청 경기도고양교육지원청 덕이고등학교,69,68,1,68,44,24,0,0
교육기관,교육부,덕이중학교,교육부 경기도교육청 경기도고양교육지원청 덕이중학교,96,96,0,96,0,96,0,0
교육기관,교육부,덕이초등학교,교육부 경기도교육청 경기도고양교육지원청 덕이초등학교,12,12,0,12,12,0,0,0
교육기관,교육부,도래울고등학교,교육부 경기도교육청 경기도고양교육지원청 도래울고등학교,42,42,0,42,23,19,0,0
교육기관,교육부,도래울중학교,교육부 경기도교육청 경기도고양교육지원청 도래울중학교,61,60,1,60,31,27,1,1
교육기관,교육부,도래울초등학교,교육부 경기도교육청 경기도고양교육지원청 도래울초등학교,27,27,0,27,27,0,0,0
교육기관,교육부,도래울초등학교병설유치원,교육부 경기도교육청 경기도고양교육지원청 도래울초등학교병설유치원,1,1,0,1,1,0,0,0
교육기관,교육부,동산해오름유치원,교육부 경기도교육청 경기도고양교육지원청 동산해오름유치원,10,10,0,10,0,10,0,0
교육기관,교육부,명현학교,교육부 경기도교육청 경기도고양교육지원청 명현학교,42,11,31,11,8,3,0,0
교육기관,교육부,모당초등학교,교육부 경기도교육청 경기도고양교육지원청 모당초등학교,14,14,0,14,7,7,0,0
교육기관,교육부,목암중학교,교육부 경기도교육청 경기도고양교육지원청 목암중학교,40,40,0,40,40,0,0,0
교육기관,교육부,목암초등학교,교육부 경기도교육청 경기도고양교육지원청 목암초등학교,11,11,0,11,1,8,1,1
교육기관,교육부,무원고등학교,교육부 경기도교육청 경기도고양교육지원청 무원고등학교,15,13,2,13,0,13,0,0
교육기관,교육부,무원중학교,교육부 경기도교육청 경기도고양교육지원청 무원중학교,17,17,0,17,9,8,0,0
교육기관,교육부,무원초등학교,교육부 경기도교육청 경기도고양교육지원청 무원초등학교,8,8,0,8,4,4,0,0
교육기관,교육부,문촌초등학교,교육부 경기도교육청 경기도고양교육지원청 문촌초등학교,20,20,0,20,0,20,0,0
교육기관,교육부,문화초등학교,교육부 경기도교육청 경기도고양교육지원청 문화초등학교,21,21,0,21,12,9,0,0
교육기관,교육부,발산중학교,교육부 경기도교육청 경기도고양교육지원청 발산중학교,32,32,0,32,16,16,0,0
교육기관,교육부,밝은학교,교육부 경기도교육청 경기도고양교육지원청 밝은학교,25,25,0,25,0,25,0,0
교육기관,교육부,백마고등학교,교육부 경기도교육청 경기도고양교육지원청 백마고등학교,39,39,0,39,0,39,0,0
교육기관,교육부,백마중학교,교육부 경기도교육청 경기도고양교육지원청 백마중학교,30,30,0,30,16,14,0,0
교육기관,교육부,백마초등학교,교육부 경기도교육청 경기도고양교육지원청 백마초등학교,27,27,0,27,27,0,0,0
교육기관,교육부,백석고등학교,교육부 경기도교육청 경기도고양교육지원청 백석고등학교,25,25,0,25,8,17,0,0
교육기관,교육부,백석중학교,교육부 경기도교육청 경기도고양교육지원청 백석중학교,16,15,1,15,0,15,0,0
교육기관,교육부,백신고등학교,교육부 경기도교육청 경기도고양교육지원청 백신고등학교,33,31,2,31,3,26,2,0
교육기관,교육부,백신중학교,교육부 경기도교육청 경기도고양교육지원청 백신중학교,28,28,0,28,0,28,0,0
교육기관,교육부,백신초등학교,교육부 경기도교육청 경기도고양교육지원청 백신초등학교,11,11,0,11,0,11,0,0
교육기관,교육부,백양고등학교,교육부 경기도교육청 경기도고양교육지원청 백양고등학교,19,19,0,19,17,2,0,0
교육기관,교육부,백양중학교,교육부 경기도교육청 경기도고양교육지원청 백양중학교,21,21,0,21,18,3,0,0
교육기관,교육부,백양초등학교,교육부 경기도교육청 경기도고양교육지원청 백양초등학교,11,11,0,11,9,2,0,0
교육기관,교육부,삼송초등학교,교육부 경기도교육청 경기도고양교육지원청 삼송초등학교,27,27,0,27,0,27,0,0
교육기관,교육부,서정고등학교,교육부 경기도교육청 경기도고양교육지원청 서정고등학교,50,46,4,46,0,46,0,0
교육기관,교육부,서정중학교,교육부 경기도교육청 경기도고양교육지원청 서정중학교,16,16,0,16,10,6,0,0
교육기관,교육부,서정초등학교,교육부 경기도교육청 경기도고양교육지원청 서정초등학교,14,14,0,14,0,14,0,0
교육기관,교육부,성라초등학교,교육부 경기도교육청 경기도고양교육지원청 성라초등학교,9,9,0,9,4,3,1,1
교육기관,교육부,성사고등학교,교육부 경기도교육청 경기도고양교육지원청 성사고등학교,25,25,0,25,4,21,0,0
교육기관,교육부,성사유치원,교육부 경기도교육청 경기도고양교육지원청 성사유치원,13,13,0,13,6,7,0,0
교육기관,교육부,성사초등학교,교육부 경기도교육청 경기도고양교육지원청 성사초등학교,16,16,0,16,8,8,0,0
교육기관,교육부,성석초등학교,교육부 경기도교육청 경기도고양교육지원청 성석초등학교,13,13,0,13,0,13,0,0
교육기관,교육부,성신초등학교,교육부 경기도교육청 경기도고양교육지원청 성신초등학교,15,15,0,15,15,0,0,0
교육기관,교육부,성저초등학교,교육부 경기도교육청 경기도고양교육지원청 성저초등학교,16,16,0,16,8,8,0,0
교육기관,교육부,세원고등학교,교육부 경기도교육청 경기도고양교육지원청 세원고등학교,53,53,0,53,0,53,0,0
교육기관,교육부,소만유치원,교육부 경기도교육청 경기도고양교육지원청 소만유치원,6,6,0,6,2,4,0,0
교육기관,교육부,소만초등학교,교육부 경기도교육청 경기도고양교육지원청 소만초등학교,29,29,0,29,5,23,1,0
교육기관,교육부,솔마루유치원,교육부 경기도교육청 경기도고양교육지원청 솔마루유치원,23,23,0,23,23,0,0,0
교육기관,교육부,송포초등학교,교육부 경기도교육청 경기도고양교육지원청 송포초등학교,12,12,0,12,9,2,1,0
교육기관,교육부,신능중학교,교육부 경기도교육청 경기도고양교육지원청 신능중학교,10,9,1,9,3,6,0,0
교육기관,교육부,신능초등학교,교육부 경기도교육청 경기도고양교육지원청 신능초등학교,20,16,4,16,13,3,0,0
교육기관,교육부,신원고등학교,교육부 경기도교육청 경기도고양교육지원청 신원고등학교,42,42,0,42,11,29,2,0
교육기관,교육부,신원중학교,교육부 경기도교육청 경기도고양교육지원청 신원중학교,49,49,0,49,44,5,0,0
교육기관,교육부,신원초등학교,교육부 경기도교육청 경기도고양교육지원청 신원초등학교,30,30,0,30,6,20,2,2
교육기관,교육부,신원초등학교병설유치원,교육부 경기도교육청 경기도고양교육지원청 신원초등학교병설유치원,2,0,2,0,0,0,0,0
교육기관,교육부,신일비즈니스고등학교,교육부 경기도교육청 경기도고양교육지원청 신일비즈니스고등학교,48,48,0,48,0,48,0,0
교육기관,교육부,신일중학교,교육부 경기도교육청 경기도고양교육지원청 신일중학교,46,46,0,46,46,0,0,0
교육기관,교육부,신촌초등학교,교육부 경기도교육청 경기도고양교육지원청 신촌초등학교,33,33,0,33,0,33,0,0
교육기관,교육부,아람초등학교,교육부 경기도교육청 경기도고양교육지원청 아람초등학교,22,22,0,22,0,22,0,0
교육기관,교육부,안곡고등학교,교육부 경기도교육청 경기도고양교육지원청 안곡고등학교,56,56,0,56,51,5,0,0
교육기관,교육부,안곡중학교,교육부 경기도교육청 경기도고양교육지원청 안곡중학교,63,63,0,63,2,61,0,0
교육기관,교육부,안곡초등학교,교육부 경기도교육청 경기도고양교육지원청 안곡초등학교,13,13,0,13,13,0,0,0
교육기관,교육부,양일초등학교,교육부 경기도교육청 경기도고양교육지원청 양일초등학교,22,22,0,22,2,17,2,1
교육기관,교육부,오마중학교,교육부 경기도교육청 경기도고양교육지원청 오마중학교,17,17,0,17,17,0,0,0
교육기관,교육부,오마초등학교,교육부 경기도교육청 경기도고양교육지원청 오마초등학교,16,16,0,16,6,6,4,0
교육기관,교육부,용두초등학교,교육부 경기도교육청 경기도고양교육지원청 용두초등학교,9,9,0,9,3,3,2,1
교육기관,교육부,용정초등학교,교육부 경기도교육청 경기도고양교육지원청 용정초등학교,10,10,0,10,4,4,1,1
교육기관,교육부,원당중학교,교육부 경기도교육청 경기도고양교육지원청 원당중학교,43,43,0,43,29,14,0,0
교육기관,교육부,원중초등학교,교육부 경기도교육청 경기도고양교육지원청 원중초등학교,24,24,0,24,0,24,0,0
교육기관,교육부,원흥유치원,교육부 경기도교육청 경기도고양교육지원청 원흥유치원,15,15,0,15,5,10,0,0
교육기관,교육부,원흥초등학교,교육부 경기도교육청 경기도고양교육지원청 원흥초등학교,16,16,0,16,0,16,0,0
교육기관,교육부,율동초등학교,교육부 경기도교육청 경기도고양교육지원청 율동초등학교,23,23,0,23,0,23,0,0
교육기관,교육부,일산고등학교,교육부 경기도교육청 경기도고양교육지원청 일산고등학교,39,18,21,18,8,10,0,0
교육기관,교육부,일산국제컨벤션고등학교,교육부 경기도교육청 경기도고양교육지원청 일산국제컨벤션고등학교,49,5,44,5,5,0,0,0
교육기관,교육부,일산대진고등학교,교육부 경기도교육청 경기도고양교육지원청 일산대진고등학교,76,76,0,76,0,76,0,0
교육기관,교육부,일산동고등학교,교육부 경기도교육청 경기도고양교육지원청 일산동고등학교,40,39,1,39,20,19,0,0
교육기관,교육부,일산동중학교,교육부 경기도교육청 경기도고양교육지원청 일산동중학교,46,46,0,46,0,46,0,0
교육기관,교육부,일산양일중학교,교육부 경기도교육청 경기도고양교육지원청 일산양일중학교,31,31,0,31,16,15,0,0
교육기관,교육부,일산은행초등학교,교육부 경기도교육청 경기도고양교육지원청 일산은행초등학교,22,22,0,22,0,22,0,0
교육기관,교육부,일산중학교,교육부 경기도교육청 경기도고양교육지원청 일산중학교,14,14,0,14,3,10,1,0
교육기관,교육부,장성중학교,교육부 경기도교육청 경기도고양교육지원청 장성중학교,26,25,1,25,25,0,0,0
교육기관,교육부,장성초등학교,교육부 경기도교육청 경기도고양교육지원청 장성초등학교,15,15,0,15,15,0,0,0
교육기관,교육부,장촌초등학교,교육부 경기도교육청 경기도고양교육지원청 장촌초등학교,14,14,0,14,14,0,0,0
교육기관,교육부,저동고등학교,교육부 경기도교육청 경기도고양교육지원청 저동고등학교,57,55,2,55,10,43,1,1
교육기관,교육부,저동중학교,교육부 경기도교육청 경기도고양교육지원청 저동중학교,36,36,0,36,36,0,0,0
교육기관,교육부,저동초등학교,교육부 경기도교육청 경기도고양교육지원청 저동초등학교,16,16,0,16,0,16,0,0
교육기관,교육부,저현고등학교,교육부 경기도교육청 경기도고양교육지원청 저현고등학교,34,32,2,32,0,32,0,0
교육기관,교육부,정발고등학교,교육부 경기도교육청 경기도고양교육지원청 정발고등학교,32,32,0,32,6,22,2,2
교육기관,교육부,정발중학교,교육부 경기도교육청 경기도고양교육지원청 정발중학교,25,25,0,25,21,4,0,0
교육기관,교육부,정발초등학교,교육부 경기도교육청 경기도고양교육지원청 정발초등학교,16,16,0,16,8,8,0,0
교육기관,교육부,주엽고등학교,교육부 경기도교육청 경기도고양교육지원청 주엽고등학교,20,20,0,20,4,12,2,2
교육기관,교육부,주엽초등학교,교육부 경기도교육청 경기도고양교육지원청 주엽초등학교,19,19,0,19,0,19,0,0
교육기관,교육부,중산고등학교,교육부 경기도교육청 경기도고양교육지원청 중산고등학교,38,38,0,38,22,16,0,0
교육기관,교육부,중산중학교,교육부 경기도교육청 경기도고양교육지원청 중산중학교,21,21,0,21,10,11,0,0
교육기관,교육부,중산초등학교,교육부 경기도교육청 경기도고양교육지원청 중산초등학교,12,12,0,12,12,0,0,0
교육기관,교육부,지도중학교,교육부 경기도교육청 경기도고양교육지원청 지도중학교,19,19,0,19,0,19,0,0
교육기관,교육부,지도초등학교,교육부 경기도교육청 경기도고양교육지원청 지도초등학교,16,16,0,16,9,7,0,0
교육기관,교육부,지축유치원,교육부 경기도교육청 경기도고양교육지원청 지축유치원,12,12,0,12,11,1,0,0
교육기관,교육부,지축중학교,교육부 경기도교육청 경기도고양교육지원청 지축중학교,40,40,0,40,24,9,2,5
교육기관,교육부,지축초등학교,교육부 경기도교육청 경기도고양교육지원청 지축초등학교,18,18,0,18,18,0,0,0
교육기관,교육부,창릉초등학교,교육부 경기도교육청 경기도고양교육지원청 창릉초등학교,17,17,0,17,0,17,0,0
교육기관,교육부,토당초등학교,교육부 경기도교육청 경기도고양교육지원청 토당초등학교,8,8,0,8,0,8,0,0
교육기관,교육부,티엘비유글로벌학교(중),교육부 경기도교육청 경기도고양교육지원청 티엘비유글로벌학교(중),36,36,0,36,10,26,0,0
교육기관,교육부,풍동고등학교,교육부 경기도교육청 경기도고양교육지원청 풍동고등학교,56,54,2,54,27,27,0,0
교육기관,교육부,풍동숲속유치원,교육부 경기도교육청 경기도고양교육지원청 풍동숲속유치원,8,6,2,6,0,6,0,0
교육기관,교육부,풍동중학교,교육부 경기도교육청 경기도고양교육지원청 풍동중학교,26,26,0,26,17,9,0,0
교육기관,교육부,풍산중학교,교육부 경기도교육청 경기도고양교육지원청 풍산중학교,47,47,0,47,17,30,0,0
교육기관,교육부,풍산초등학교,교육부 경기도교육청 경기도고양교육지원청 풍산초등학교,16,16,0,16,15,1,0,0
교육기관,교육부,한내유치원,교육부 경기도교육청 경기도고양교육지원청 한내유치원,7,7,0,7,7,0,0,0
교육기관,교육부,한류유치원,교육부 경기도교육청 경기도고양교육지원청 한류유치원,47,47,0,47,0,47,0,0
교육기관,교육부,한류초등학교,교육부 경기도교육청 경기도고양교육지원청 한류초등학교,28,28,0,28,0,28,0,0
교육기관,교육부,한뫼초등학교,교육부 경기도교육청 경기도고양교육지원청 한뫼초등학교,13,13,0,13,11,2,0,0
교육기관,교육부,한산초등학교,교육부 경기도교육청 경기도고양교육지원청 한산초등학교,17,17,0,17,0,17,0,0
교육기관,교육부,한수중학교,교육부 경기도교육청 경기도고양교육지원청 한수중학교,24,24,0,24,24,0,0,0
교육기관,교육부,한수초등학교,교육부 경기도교육청 경기도고양교육지원청 한수초등학교,20,20,0,20,20,0,0,0
교육기관,교육부,행남초등학교,교육부 경기도교육청 경기도고양교육지원청 행남초등학교,10,10,0,10,9,1,0,0
교육기관,교육부,행신고등학교,교육부 경기도교육청 경기도고양교육지원청 행신고등학교,28,27,1,27,27,0,0,0
교육기관,교육부,행신중학교,교육부 경기도교육청 경기도고양교육지원청 행신중학교,12,10,2,10,6,2,1,1
교육기관,교육부,행신초등학교,교육부 경기도교육청 경기도고양교육지원청 행신초등학교,15,15,0,15,0,15,0,0
교육기관,교육부,행주초등학교,교육부 경기도교육청 경기도고양교육지원청 행주초등학교,19,19,0,19,19,0,0,0
교육기관,교육부,향동고등학교,교육부 경기도교육청 경기도고양교육지원청 향동고등학교,28,26,2,26,6,12,4,4
교육기관,교육부,향동숲내초등학교,교육부 경기도교육청 경기도고양교육지원청 향동숲내초등학교,21,21,0,21,18,3,0,0
교육기관,교육부,향동유치원,교육부 경기도교육청 경기도고양교육지원청 향동유치원,41,37,4,37,6,30,1,0
교육기관,교육부,향동중학교,교육부 경기도교육청 경기도고양교육지원청 향동중학교,18,18,0,18,16,2,0,0
교육기관,교육부,향동초등학교,교육부 경기도교육청 경기도고양교육지원청 향동초등학교,23,23,0,23,19,4,0,0
교육기관,교육부,현산초등학교,교육부 경기도교육청 경기도고양교육지원청 현산초등학교,38,38,0,38,0,38,0,0
교육기관,교육부,호곡중학교,교육부 경기도교육청 경기도고양교육지원청 호곡중학교,48,47,1,47,13,29,0,5
교육기관,교육부,호곡초등학교,교육부 경기도교육청 경기도고양교육지원청 호곡초등학교,17,17,0,17,17,0,0,0
교육기관,교육부,호수초등학교,교육부 경기도교육청 경기도고양교육지원청 호수초등학교,17,17,0,17,17,0,0,0
교육기관,교육부,홀트학교,교육부 경기도교육청 경기도고양교육지원청 홀트학교,24,24,0,24,10,14,0,0
교육기관,교육부,화수고등학교,교육부 경기도교육청 경기도고양교육지원청 화수고등학교,20,20,0,20,0,20,0,0
교육기관,교육부,화수중학교,교육부 경기도교육청 경기도고양교육지원청 화수중학교,40,40,0,40,40,0,0,0
교육기관,교육부,화정고등학교,교육부 경기도교육청 경기도고양교육지원청 화정고등학교,30,30,0,30,14,16,0,0
교육기관,교육부,화정중학교,교육부 경기도교육청 경기도고양교육지원청 화정중학교,27,27,0,27,0,27,0,0
교육기관,교육부,화중초등학교,교육부 경기도교육청 경기도고양교육지원청 화중초등학교,24,24,0,24,0,24,0,0
교육기관,교육부,황룡초등학교,교육부 경기도교육청 경기도고양교육지원청 황룡초등학교,16,16,0,16,0,16,0,0
교육기관,교육부,흥도유치원,교육부 경기도교육청 경기도고양교육지원청 흥도유치원,20,20,0,20,15,5,0,0
교육기관,교육부,경기도공업계고등학교공동실습소,교육부 경기도교육청 경기도공업계고등학교공동실습소,16,16,0,16,0,16,0,0
교육기관,교육부,경기도광명교육지원청,교육부 경기도교육청 경기도광명교육지원청,12,12,0,12,6,6,0,0
교육기관,교육부,가림유치원,교육부 경기도교육청 경기도광명교육지원청 가림유치원,0,0,0,0,0,0,0,0
교육기관,교육부,가림중학교,교육부 경기도교육청 경기도광명교육지원청 가림중학교,19,18,1,18,2,16,0,0
교육기관,교육부,가림초등학교,교육부 경기도교육청 경기도광명교육지원청 가림초등학교,15,15,0,15,14,1,0,0
교육기관,교육부,경기항공고등학교,교육부 경기도교육청 경기도광명교육지원청 경기항공고등학교,40,40,0,40,0,40,0,0
교육기관,교육부,광남중학교,교육부 경기도교육청 경기도광명교육지원청 광남중학교,24,23,1,23,1,20,1,1
교육기관,교육부,광명고등학교,교육부 경기도교육청 경기도광명교육지원청 광명고등학교,13,12,1,12,11,0,1,0
교육기관,교육부,광명광덕초등학교,교육부 경기도교육청 경기도광명교육지원청 광명광덕초등학교,18,18,0,18,0,18,0,0
교육기관,교육부,광명광성초등학교,교육부 경기도교육청 경기도광명교육지원청 광명광성초등학교,23,23,0,23,23,0,0,0
교육기관,교육부,광명남초등학교,교육부 경기도교육청 경기도광명교육지원청 광명남초등학교,24,24,0,24,22,2,0,0
교육기관,교육부,광명동초등학교,교육부 경기도교육청 경기도광명교육지원청 광명동초등학교,20,20,0,20,15,5,0,0
교육기관,교육부,광명북고등학교,교육부 경기도교육청 경기도광명교육지원청 광명북고등학교,63,63,0,63,29,34,0,0
교육기관,교육부,광명북중학교,교육부 경기도교육청 경기도광명교육지원청 광명북중학교,18,16,2,16,9,4,2,1
교육기관,교육부,광명북초등학교,교육부 경기도교육청 경기도광명교육지원청 광명북초등학교,13,13,0,13,6,5,2,0
교육기관,교육부,광명서초등학교,교육부 경기도교육청 경기도광명교육지원청 광명서초등학교,16,15,1,15,12,2,1,0
교육기관,교육부,광명중학교,교육부 경기도교육청 경기도광명교육지원청 광명중학교,52,52,0,52,38,14,0,0
교육기관,교육부,광명초등학교,교육부 경기도교육청 경기도광명교육지원청 광명초등학교,26,26,0,26,26,0,0,0
교육기관,교육부,광문고등학교,교육부 경기도교육청 경기도광명교육지원청 광문고등학교,17,17,0,17,0,17,0,0
교육기관,교육부,광문중학교,교육부 경기도교육청 경기도광명교육지원청 광문중학교,32,31,1,31,5,22,2,2
교육기관,교육부,광문초등학교,교육부 경기도교육청 경기도광명교육지원청 광문초등학교,19,19,0,19,16,3,0,0
교육기관,교육부,광은유치원,교육부 경기도교육청 경기도광명교육지원청 광은유치원,16,1,15,1,1,0,0,0
교육기관,교육부,광일초등학교,교육부 경기도교육청 경기도광명교육지원청 광일초등학교,24,24,0,24,24,0,0,0
교육기관,교육부,광휘고등학교,교육부 경기도교육청 경기도광명교육지원청 광휘고등학교,51,51,0,51,9,42,0,0
교육기관,교육부,구름산유치원,교육부 경기도교육청 경기도광명교육지원청 구름산유치원,13,13,0,13,7,6,0,0
교육기관,교육부,구름산초등학교,교육부 경기도교육청 경기도광명교육지원청 구름산초등학교,21,21,0,21,20,1,0,0
교육기관,교육부,도덕초등학교,교육부 경기도교육청 경기도광명교육지원청 도덕초등학교,0,0,0,0,0,0,0,0
교육기관,교육부,명문고등학교,교육부 경기도교육청 경기도광명교육지원청 명문고등학교,24,24,0,24,0,24,0,0
교육기관,교육부,밝은빛유치원,교육부 경기도교육청 경기도광명교육지원청 밝은빛유치원,15,15,0,15,4,11,0,0
교육기관,교육부,빛가온유치원,교육부 경기도교육청 경기도광명교육지원청 빛가온유치원,16,16,0,16,16,0,0,0
교육기관,교육부,빛가온초등학교,교육부 경기도교육청 경기도광명교육지원청 빛가온초등학교,19,19,0,19,19,0,0,0
교육기관,교육부,산들유치원,교육부 경기도교육청 경기도광명교육지원청 산들유치원,13,13,0,13,0,13,0,0
교육기관,교육부,삼흥유치원,교육부 경기도교육청 경기도광명교육지원청 삼흥유치원,10,10,0,10,0,10,0,0
교육기관,교육부,서면초등학교,교육부 경기도교육청 경기도광명교육지원청 서면초등학교,19,19,0,19,19,0,0,0
교육기관,교육부,세교유치원,교육부 경기도교육청 경기도광명교육지원청 세교유치원,10,10,0,10,0,10,0,0
교육기관,교육부,소하고등학교,교육부 경기도교육청 경기도광명교육지원청 소하고등학교,33,33,0,33,4,29,0,0
교육기관,교육부,소하중학교,교육부 경기도교육청 경기도광명교육지원청 소하중학교,39,39,0,39,34,5,0,0
교육기관,교육부,소하초등학교,교육부 경기도교육청 경기도광명교육지원청 소하초등학교,16,16,0,16,11,5,0,0
교육기관,교육부,안서중학교,교육부 경기도교육청 경기도광명교육지원청 안서중학교,11,11,0,11,5,6,0,0
교육기관,교육부,안서초등학교,교육부 경기도교육청 경기도광명교육지원청 안서초등학교,13,13,0,13,13,0,0,0
교육기관,교육부,안현초등학교,교육부 경기도교육청 경기도광명교육지원청 안현초등학교,14,14,0,14,10,4,0,0
교육기관,교육부,연서초등학교,교육부 경기도교육청 경기도광명교육지원청 연서초등학교,11,11,0,11,11,0,0,0
교육기관,교육부,예솔유치원,교육부 경기도교육청 경기도광명교육지원청 예솔유치원,14,3,11,3,3,0,0,0
교육기관,교육부,예원유치원,교육부 경기도교육청 경기도광명교육지원청 예원유치원,16,2,14,2,1,1,0,0
교육기관,교육부,예지유치원,교육부 경기도교육청 경기도광명교육지원청 예지유치원,10,10,0,10,6,4,0,0
교육기관,교육부,온신초등학교,교육부 경기도교육청 경기도광명교육지원청 온신초등학교,8,8,0,8,4,4,0,0
교육기관,교육부,운산고등학교,교육부 경기도교육청 경기도광명교육지원청 운산고등학교,65,65,0,65,61,4,0,0
교육기관,교육부,은총유치원,교육부 경기도교육청 경기도광명교육지원청 은총유치원,32,6,26,6,0,6,0,0
교육기관,교육부,진성고등학교,교육부 경기도교육청 경기도광명교육지원청 진성고등학교,37,37,0,37,0,37,0,0
교육기관,교육부,창의경영고등학교,교육부 경기도교육청 경기도광명교육지원청 창의경영고등학교,35,35,0,35,30,5,0,0
교육기관,교육부,철산중학교,교육부 경기도교육청 경기도광명교육지원청 철산중학교,61,61,0,61,0,61,0,0
교육기관,교육부,철산초등학교,교육부 경기도교육청 경기도광명교육지원청 철산초등학교,22,19,3,19,15,1,2,1
교육기관,교육부,충현고등학교,교육부 경기도교육청 경기도광명교육지원청 충현고등학교,47,45,2,45,21,24,0,0
교육기관,교육부,충현중학교,교육부 경기도교육청 경기도광명교육지원청 충현중학교,38,38,0,38,11,27,0,0
교육기관,교육부,충현초등학교,교육부 경기도교육청 경기도광명교육지원청 충현초등학교,16,15,1,15,14,1,0,0
교육기관,교육부,트인아이유치원,교육부 경기도교육청 경기도광명교육지원청 트인아이유치원,24,24,0,24,4,20,0,0
교육기관,교육부,하안남초등학교,교육부 경기도교육청 경기도광명교육지원청 하안남초등학교,11,11,0,11,6,5,0,0
교육기관,교육부,하안북중학교,교육부 경기도교육청 경기도광명교육지원청 하안북중학교,17,17,0,17,17,0,0,0
교육기관,교육부,하안북초등학교,교육부 경기도교육청 경기도광명교육지원청 하안북초등학교,17,17,0,17,17,0,0,0
교육기관,교육부,하안중학교,교육부 경기도교육청 경기도광명교육지원청 하안중학교,19,17,2,17,10,2,5,0
교육기관,교육부,하안초등학교,교육부 경기도교육청 경기도광명교육지원청 하안초등학교,16,16,0,16,15,1,0,0
교육기관,교육부,하일초등학교,교육부 경기도교육청 경기도광명교육지원청 하일초등학교,17,17,0,17,10,7,0,0
교육기관,교육부,한마음유치원,교육부 경기도교육청 경기도광명교육지원청 한마음유치원,15,15,0,15,0,15,0,0
교육기관,교육부,해누리유치원,교육부 경기도교육청 경기도광명교육지원청 해누리유치원,7,7,0,7,0,7,0,0
교육기관,교육부,혜성유치원,교육부 경기도교육청 경기도광명교육지원청 혜성유치원,16,0,16,0,0,0,0,0
교육기관,교육부,감일고등학교,교육부 경기도교육청 경기도광주하남교육지원청 감일고등학교,29,29,0,29,0,29,0,0
교육기관,교육부,감일백제중학교,교육부 경기도교육청 경기도광주하남교육지원청 감일백제중학교,10,10,0,10,2,8,0,0
교육기관,교육부,감일유치원,교육부 경기도교육청 경기도광주하남교육지원청 감일유치원,14,14,0,14,0,14,0,0
교육기관,교육부,감일중학교,교육부 경기도교육청 경기도광주하남교육지원청 감일중학교,18,16,2,16,0,16,0,0
교육기관,교육부,감일초등학교,교육부 경기도교육청 경기도광주하남교육지원청 감일초등학교,19,19,0,19,8,11,0,0
교육기관,교육부,경안중학교,교육부 경기도교육청 경기도광주하남교육지원청 경안중학교,80,80,0,80,67,8,5,0
교육기관,교육부,경안초등학교,교육부 경기도교육청 경기도광주하남교육지원청 경안초등학교,16,16,0,16,16,0,0,0
교육기관,교육부,경화여자EnglishBusiness고등학교,교육부 경기도교육청 경기도광주하남교육지원청 경화여자EnglishBusiness고등학교,32,32,0,32,0,32,0,0
교육기관,교육부,경화여자고등학교,교육부 경기도교육청 경기도광주하남교육지원청 경화여자고등학교,131,30,101,30,8,15,7,0
교육기관,교육부,경화여자중학교,교육부 경기도교육청 경기도광주하남교육지원청 경화여자중학교,21,19,2,19,17,2,0,0
교육기관,교육부,고골초등학교,교육부 경기도교육청 경기도광주하남교육지원청 고골초등학교,16,16,0,16,10,6,0,0
교육기관,교육부,고산유치원,교육부 경기도교육청 경기도광주하남교육지원청 고산유치원,16,16,0,16,0,16,0,0
교육기관,교육부,고산하늘초등학교,교육부 경기도교육청 경기도광주하남교육지원청 고산하늘초등학교,32,32,0,32,0,32,0,0
교육기관,교육부,곤지암고등학교,교육부 경기도교육청 경기도광주하남교육지원청 곤지암고등학교,22,22,0,22,16,5,1,0
교육기관,교육부,곤지암중학교,교육부 경기도교육청 경기도광주하남교육지원청 곤지암중학교,11,11,0,11,6,5,0,0
교육기관,교육부,곤지암초등학교,교육부 경기도교육청 경기도광주하남교육지원청 곤지암초등학교,24,24,0,24,14,4,5,1
교육기관,교육부,광남고등학교,교육부 경기도교육청 경기도광주하남교육지원청 광남고등학교,50,49,1,49,6,39,2,2
교육기관,교육부,광남초등학교,교육부 경기도교육청 경기도광주하남교육지원청 광남초등학교,37,37,0,37,19,18,0,0
교육기관,교육부,광일중학교,교육부 경기도교육청 경기도광주하남교육지원청 광일중학교,27,27,0,27,18,7,1,1
교육기관,교육부,광주고등학교,교육부 경기도교육청 경기도광주하남교육지원청 광주고등학교,45,19,26,19,9,7,1,2
교육기관,교육부,광주광남중학교,교육부 경기도교육청 경기도광주하남교육지원청 광주광남중학교,31,30,1,30,12,18,0,0
교육기관,교육부,광주광명초등학교,교육부 경기도교육청 경기도광주하남교육지원청 광주광명초등학교,24,24,0,24,24,0,0,0
교육기관,교육부,광주도평초등학교,교육부 경기도교육청 경기도광주하남교육지원청 광주도평초등학교,22,22,0,22,0,22,0,0
교육기관,교육부,광주매곡초등학교,교육부 경기도교육청 경기도광주하남교육지원청 광주매곡초등학교,17,17,0,17,17,0,0,0
교육기관,교육부,광주새롬학교,교육부 경기도교육청 경기도광주하남교육지원청 광주새롬학교,14,14,0,14,0,14,0,0
교육기관,교육부,광주송정초등학교,교육부 경기도교육청 경기도광주하남교육지원청 광주송정초등학교,23,20,3,20,5,13,1,1
교육기관,교육부,광주유치원,교육부 경기도교육청 경기도광주하남교육지원청 광주유치원,16,16,0,16,5,11,0,0
교육기관,교육부,광주중앙고등학교,교육부 경기도교육청 경기도광주하남교육지원청 광주중앙고등학교,67,67,0,67,67,0,0,0
교육기관,교육부,광주중학교,교육부 경기도교육청 경기도광주하남교육지원청 광주중학교,32,12,20,12,9,3,0,0
교육기관,교육부,광주초등학교,교육부 경기도교육청 경기도광주하남교육지원청 광주초등학교,28,28,0,28,20,5,3,0
교육기관,교육부,광주푸른초등학교,교육부 경기도교육청 경기도광주하남교육지원청 광주푸른초등학교,17,17,0,17,0,17,0,0
교육기관,교육부,광지원초등학교,교육부 경기도교육청 경기도광주하남교육지원청 광지원초등학교,10,10,0,10,0,10,0,0
교육기관,교육부,구산유치원,교육부 경기도교육청 경기도광주하남교육지원청 구산유치원,11,11,0,11,4,4,3,0
교육기관,교육부,금강유치원,교육부 경기도교육청 경기도광주하남교육지원청 금강유치원,24,4,20,4,2,1,1,0
교육기관,교육부,나룰초등학교,교육부 경기도교육청 경기도광주하남교육지원청 나룰초등학교,16,16,0,16,13,3,0,0
교육기관,교육부,남한고등학교,교육부 경기도교육청 경기도광주하남교육지원청 남한고등학교,28,28,0,28,28,0,0,0
교육기관,교육부,남한산초등학교,교육부 경기도교육청 경기도광주하남교육지원청 남한산초등학교,19,19,0,19,18,1,0,0
교육기관,교육부,남한중학교,교육부 경기도교육청 경기도광주하남교육지원청 남한중학교,35,35,0,35,0,35,0,0
교육기관,교육부,단가람유치원,교육부 경기도교육청 경기도광주하남교육지원청 단가람유치원,16,9,7,9,5,4,0,0
교육기관,교육부,달봄유치원,교육부 경기도교육청 경기도광주하남교육지원청 달봄유치원,12,12,0,12,3,9,0,0
교육기관,교육부,덕풍중학교,교육부 경기도교육청 경기도광주하남교육지원청 덕풍중학교,32,30,2,30,0,30,0,0
교육기관,교육부,덕풍초등학교,교육부 경기도교육청 경기도광주하남교육지원청 덕풍초등학교,22,22,0,22,0,22,0,0
교육기관,교육부,도곡초등학교,교육부 경기도교육청 경기도광주하남교육지원청 도곡초등학교,16,16,0,16,10,6,0,0
교육기관,교육부,도궁초등학교,교육부 경기도교육청 경기도광주하남교육지원청 도궁초등학교,12,12,0,12,12,0,0,0
교육기관,교육부,도수초등학교,교육부 경기도교육청 경기도광주하남교육지원청 도수초등학교,17,17,0,17,0,17,0,0
교육기관,교육부,도척초등학교,교육부 경기도교육청 경기도광주하남교육지원청 도척초등학교,12,12,0,12,12,0,0,0
교육기관,교육부,동부중학교,교육부 경기도교육청 경기도광주하남교육지원청 동부중학교,32,32,0,32,27,5,0,0
교육기관,교육부,동부초등학교,교육부 경기도교육청 경기도광주하남교육지원청 동부초등학교,18,18,0,18,10,8,0,0
교육기관,교육부,동현학교,교육부 경기도교육청 경기도광주하남교육지원청 동현학교,18,18,0,18,18,0,0,0
교육기관,교육부,만선초등학교,교육부 경기도교육청 경기도광주하남교육지원청 만선초등학교,13,13,0,13,13,0,0,0
교육기관,교육부,망월초등학교,교육부 경기도교육청 경기도광주하남교육지원청 망월초등학교,28,28,0,28,11,16,1,0
교육기관,교육부,매양중학교,교육부 경기도교육청 경기도광주하남교육지원청 매양중학교,52,52,0,52,30,22,0,0
교육기관,교육부,미담유치원,교육부 경기도교육청 경기도광주하남교육지원청 미담유치원,30,3,27,3,3,0,0,0
교육기관,교육부,미사강변고등학교,교육부 경기도교육청 경기도광주하남교육지원청 미사강변고등학교,35,35,0,35,20,15,0,0
교육기관,교육부,미사강변중학교,교육부 경기도교육청 경기도광주하남교육지원청 미사강변중학교,36,34,2,34,17,17,0,0
교육기관,교육부,미사강변초등학교,교육부 경기도교육청 경기도광주하남교육지원청 미사강변초등학교,27,27,0,27,9,18,0,0
교육기관,교육부,미사고등학교,교육부 경기도교육청 경기도광주하남교육지원청 미사고등학교,32,7,25,7,7,0,0,0
교육기관,교육부,미사랑유치원,교육부 경기도교육청 경기도광주하남교육지원청 미사랑유치원,18,10,8,10,0,10,0,0
교육기관,교육부,미사중앙초등학교,교육부 경기도교육청 경기도광주하남교육지원청 미사중앙초등학교,32,32,0,32,16,16,0,0
교육기관,교육부,미사중학교,교육부 경기도교육청 경기도광주하남교육지원청 미사중학교,35,35,0,35,23,12,0,0
교육기관,교육부,미사초등학교,교육부 경기도교육청 경기도광주하남교육지원청 미사초등학교,22,22,0,22,22,0,0,0
교육기관,교육부,번천초등학교,교육부 경기도교육청 경기도광주하남교육지원청 번천초등학교,20,20,0,20,0,20,0,0
교육기관,교육부,벌원초등학교,교육부 경기도교육청 경기도광주하남교육지원청 벌원초등학교,20,20,0,20,20,0,0,0
교육기관,교육부,분원초등학교,교육부 경기도교육청 경기도광주하남교육지원청 분원초등학교,7,7,0,7,7,0,0,0
교육기관,교육부,산곡초등학교,교육부 경기도교육청 경기도광주하남교육지원청 산곡초등학교,19,19,0,19,0,19,0,0
교육기관,교육부,삼리초등학교,교육부 경기도교육청 경기도광주하남교육지원청 삼리초등학교,23,23,0,23,8,15,0,0
교육기관,교육부,서부초등학교,교육부 경기도교육청 경기도광주하남교육지원청 서부초등학교,8,8,0,8,8,0,0,0
교육기관,교육부,선동초등학교,교육부 경기도교육청 경기도광주하남교육지원청 선동초등학교,15,15,0,15,15,0,0,0
교육기관,교육부,성광학교,교육부 경기도교육청 경기도광주하남교육지원청 성광학교,29,29,0,29,19,10,0,0
교육기관,교육부,세화몬테소리유치원,교육부 경기도교육청 경기도광주하남교육지원청 세화몬테소리유치원,36,36,0,36,8,28,0,0
교육기관,교육부,신우초등학교,교육부 경기도교육청 경기도광주하남교육지원청 신우초등학교,33,33,0,33,5,28,0,0
교육기관,교육부,신장고등학교,교육부 경기도교육청 경기도광주하남교육지원청 신장고등학교,40,40,0,40,0,40,0,0
교육기관,교육부,신장중학교,교육부 경기도교육청 경기도광주하남교육지원청 신장중학교,23,18,5,18,11,4,2,1
교육기관,교육부,신장초등학교,교육부 경기도교육청 경기도광주하남교육지원청 신장초등학교,18,18,0,18,2,16,0,0
교육기관,교육부,신평중학교,교육부 경기도교육청 경기도광주하남교육지원청 신평중학교,29,28,1,28,28,0,0,0
교육기관,교육부,신평초등학교,교육부 경기도교육청 경기도광주하남교육지원청 신평초등학교,18,18,0,18,14,4,0,0
교육기관,교육부,신현중학교,교육부 경기도교육청 경기도광주하남교육지원청 신현중학교,49,49,0,49,15,30,2,2
교육기관,교육부,신현초등학교,교육부 경기도교육청 경기도광주하남교육지원청 신현초등학교,29,29,0,29,0,29,0,0
교육기관,교육부,쌍령초등학교,교육부 경기도교육청 경기도광주하남교육지원청 쌍령초등학교,30,30,0,30,30,0,0,0
교육기관,교육부,양실유치원,교육부 경기도교육청 경기도광주하남교육지원청 양실유치원,16,15,1,15,11,2,1,1
교육기관,교육부,역동초등학교,교육부 경기도교육청 경기도광주하남교육지원청 역동초등학교,28,28,0,28,24,4,0,0
교육기관,교육부,오포초등학교,교육부 경기도교육청 경기도광주하남교육지원청 오포초등학교,22,22,0,22,16,6,0,0
교육기관,교육부,위례송하유치원,교육부 경기도교육청 경기도광주하남교육지원청 위례송하유치원,15,15,0,15,15,0,0,0
교육기관,교육부,위례숲초등학교,교육부 경기도교육청 경기도광주하남교육지원청 위례숲초등학교,21,21,0,21,21,0,0,0
교육기관,교육부,위례유치원,교육부 경기도교육청 경기도광주하남교육지원청 위례유치원,19,19,0,19,0,19,0,0
교육기관,교육부,위례중학교,교육부 경기도교육청 경기도광주하남교육지원청 위례중학교,33,33,0,33,29,4,0,0
교육기관,교육부,위례초등학교,교육부 경기도교육청 경기도광주하남교육지원청 위례초등학교,24,10,14,10,10,0,0,0
교육기관,교육부,윤슬중학교,교육부 경기도교육청 경기도광주하남교육지원청 윤슬중학교,38,37,1,37,20,15,1,1
교육기관,교육부,은가람중학교,교육부 경기도교육청 경기도광주하남교육지원청 은가람중학교,16,16,0,16,16,0,0,0
교육기관,교육부,인덕학교,교육부 경기도교육청 경기도광주하남교육지원청 인덕학교,22,22,0,22,10,11,1,0
교육기관,교육부,창우초등학교,교육부 경기도교육청 경기도광주하남교육지원청 창우초등학교,12,12,0,12,12,0,0,0
교육기관,교육부,청아초등학교,교육부 경기도교육청 경기도광주하남교육지원청 청아초등학교,27,9,18,9,5,4,0,0
교육기관,교육부,초월고등학교,교육부 경기도교육청 경기도광주하남교육지원청 초월고등학교,48,46,2,46,12,34,0,0
교육기관,교육부,초월중학교,교육부 경기도교육청 경기도광주하남교육지원청 초월중학교,37,37,0,37,37,0,0,0
교육기관,교육부,초월초등학교,교육부 경기도교육청 경기도광주하남교육지원청 초월초등학교,15,15,0,15,9,6,0,0
교육기관,교육부,초월한솔유치원,교육부 경기도교육청 경기도광주하남교육지원청 초월한솔유치원,14,14,0,14,0,14,0,0
교육기관,교육부,탄벌중학교,교육부 경기도교육청 경기도광주하남교육지원청 탄벌중학교,35,35,0,35,0,35,0,0
교육기관,교육부,탄벌초등학교,교육부 경기도교육청 경기도광주하남교육지원청 탄벌초등학교,25,25,0,25,0,25,0,0
교육기관,교육부,태성초등학교,교육부 경기도교육청 경기도광주하남교육지원청 태성초등학교,18,18,0,18,0,18,0,0
교육기관,교육부,태전고등학교,교육부 경기도교육청 경기도광주하남교육지원청 태전고등학교,28,28,0,28,0,28,0,0
교육기관,교육부,태전초등학교,교육부 경기도교육청 경기도광주하남교육지원청 태전초등학교,23,23,0,23,23,0,0,0
교육기관,교육부,풍산고등학교,교육부 경기도교육청 경기도광주하남교육지원청 풍산고등학교,39,39,0,39,0,39,0,0
교육기관,교육부,하남경영고등학교,교육부 경기도교육청 경기도광주하남교육지원청 하남경영고등학교,33,33,0,33,20,6,6,1
교육기관,교육부,하남고등학교,교육부 경기도교육청 경기도광주하남교육지원청 하남고등학교,32,32,0,32,0,32,0,0
교육기관,교육부,하남중학교,교육부 경기도교육청 경기도광주하남교육지원청 하남중학교,38,38,0,38,23,15,0,0
교육기관,교육부,하남천현초등학교,교육부 경기도교육청 경기도광주하남교육지원청 하남천현초등학교,19,19,0,19,17,2,0,0
교육기관,교육부,하남초등학교,교육부 경기도교육청 경기도광주하남교육지원청 하남초등학교,20,20,0,20,10,10,0,0
교육기관,교육부,하남풍산초등학교,교육부 경기도교육청 경기도광주하남교육지원청 하남풍산초등학교,18,18,0,18,0,18,0,0
교육기관,교육부,하은유치원,교육부 경기도교육청 경기도광주하남교육지원청 하은유치원,16,0,16,0,0,0,0,0
교육기관,교육부,한국애니메이션고등학교,교육부 경기도교육청 경기도광주하남교육지원청 한국애니메이션고등학교,61,61,0,61,0,61,0,0
교육기관,교육부,한사랑학교,교육부 경기도교육청 경기도광주하남교육지원청 한사랑학교,44,44,0,44,8,36,0,0
교육기관,교육부,한아람초등학교,교육부 경기도교육청 경기도광주하남교육지원청 한아람초등학교,19,19,0,19,0,19,0,0
교육기관,교육부,한홀초등학교,교육부 경기도교육청 경기도광주하남교육지원청 한홀초등학교,30,24,6,24,10,14,0,0
교육기관,교육부,경기도교육복지종합센터,교육부 경기도교육청 경기도교육복지종합센터,30,30,0,30,0,30,0,0
교육기관,교육부,경기도교육연구원,교육부 경기도교육청 경기도교육연구원,15,15,0,15,0,15,0,0
교육기관,교육부,경기도교육연수원,교육부 경기도교육청 경기도교육연수원,88,88,0,88,0,88,0,0
교육기관,교육부,경기도교육정보기록원,교육부 경기도교육청 경기도교육정보기록원,47,8,39,8,0,8,0,0
교육기관,교육부,경기도교육청안전교육관,교육부 경기도교육청 경기도교육청안전교육관,55,53,2,53,0,53,0,0
교육기관,교육부,경기도구리남양주교육지원청,교육부 경기도교육청 경기도구리남양주교육지원청,30,26,4,26,10,16,0,0
교육기관,교육부,가곡초등학교,교육부 경기도교육청 경기도구리남양주교육지원청 가곡초등학교,19,19,0,19,9,10,0,0
교육기관,교육부,가양초등학교,교육부 경기도교육청 경기도구리남양주교육지원청 가양초등학교,8,8,0,8,8,0,0,0
교육기관,교육부,가운고등학교,교육부 경기도교육청 경기도구리남양주교육지원청 가운고등학교,50,50,0,50,10,38,1,1
교육기관,교육부,가운중학교,교육부 경기도교육청 경기도구리남양주교육지원청 가운중학교,10,8,2,8,8,0,0,0
교육기관,교육부,가운초등학교,교육부 경기도교육청 경기도구리남양주교육지원청 가운초등학교,24,24,0,24,12,12,0,0
교육기관,교육부,갈매고등학교,교육부 경기도교육청 경기도구리남양주교육지원청 갈매고등학교,48,48,0,48,14,34,0,0
교육기관,교육부,갈매유치원,교육부 경기도교육청 경기도구리남양주교육지원청 갈매유치원,21,21,0,21,5,16,0,0
교육기관,교육부,갈매중학교,교육부 경기도교육청 경기도구리남양주교육지원청 갈매중학교,53,53,0,53,0,53,0,0
교육기관,교육부,갈매초등학교,교육부 경기도교육청 경기도구리남양주교육지원청 갈매초등학교,23,23,0,23,0,23,0,0
교육기관,교육부,건원초등학교,교육부 경기도교육청 경기도구리남양주교육지원청 건원초등학교,22,22,0,22,12,10,0,0
교육기관,교육부,경은학교,교육부 경기도교육청 경기도구리남양주교육지원청 경은학교,29,29,0,29,2,27,0,0
교육기관,교육부,광동고등학교,교육부 경기도교육청 경기도구리남양주교육지원청 광동고등학교,16,16,0,16,0,16,0,0
교육기관,교육부,광동중학교,교육부 경기도교육청 경기도구리남양주교육지원청 광동중학교,45,45,0,45,3,42,0,0
교육기관,교육부,광릉중학교,교육부 경기도교육청 경기도구리남양주교육지원청 광릉중학교,28,28,0,28,26,2,0,0
교육기관,교육부,광릉초등학교,교육부 경기도교육청 경기도구리남양주교육지원청 광릉초등학교,14,14,0,14,7,7,0,0
교육기관,교육부,교문중학교,교육부 경기도교육청 경기도구리남양주교육지원청 교문중학교,32,32,0,32,26,3,2,1
교육기관,교육부,교문초등학교,교육부 경기도교육청 경기도구리남양주교육지원청 교문초등학교,18,18,0,18,5,13,0,0
교육기관,교육부,구룡초등학교,교육부 경기도교육청 경기도구리남양주교육지원청 구룡초등학교,19,19,0,19,0,19,0,0
교육기관,교육부,구리고등학교,교육부 경기도교육청 경기도구리남양주교육지원청 구리고등학교,42,42,0,42,12,30,0,0
교육기관,교육부,구리여자고등학교,교육부 경기도교육청 경기도구리남양주교육지원청 구리여자고등학교,46,46,0,46,0,46,0,0
교육기관,교육부,구리여자중학교,교육부 경기도교육청 경기도구리남양주교육지원청 구리여자중학교,39,39,0,39,19,20,0,0
교육기관,교육부,구리중학교,교육부 경기도교육청 경기도구리남양주교육지원청 구리중학교,47,45,2,45,0,45,0,0
교육기관,교육부,구지초등학교,교육부 경기도교육청 경기도구리남양주교육지원청 구지초등학교,15,15,0,15,11,4,0,0
교육기관,교육부,금곡고등학교,교육부 경기도교육청 경기도구리남양주교육지원청 금곡고등학교,39,39,0,39,2,37,0,0
교육기관,교육부,금곡중학교,교육부 경기도교육청 경기도구리남양주교육지원청 금곡중학교,20,20,0,20,17,3,0,0
교육기관,교육부,금남초등학교,교육부 경기도교육청 경기도구리남양주교육지원청 금남초등학교,10,10,0,10,0,10,0,0
교육기관,교육부,남양주공업고등학교,교육부 경기도교육청 경기도구리남양주교육지원청 남양주공업고등학교,70,70,0,70,70,0,0,0
교육기관,교육부,남양주금곡초등학교,교육부 경기도교육청 경기도구리남양주교육지원청 남양주금곡초등학교,15,15,0,15,15,0,0,0
교육기관,교육부,남양주다산고등학교,교육부 경기도교육청 경기도구리남양주교육지원청 남양주다산고등학교,52,52,0,52,16,36,0,0
교육기관,교육부,남양주다산유치원,교육부 경기도교육청 경기도구리남양주교육지원청 남양주다산유치원,30,30,0,30,10,20,0,0
교육기관,교육부,남양주다산중학교,교육부 경기도교육청 경기도구리남양주교육지원청 남양주다산중학교,14,13,1,13,6,7,0,0
교육기관,교육부,남양주다산초등학교,교육부 경기도교육청 경기도구리남양주교육지원청 남양주다산초등학교,23,23,0,23,17,6,0,0
교육기관,교육부,남양주덕송초등학교,교육부 경기도교육청 경기도구리남양주교육지원청 남양주덕송초등학교,21,21,0,21,7,14,0,0
교육기관,교육부,남양주덕송초등학교병설유치원,교육부 경기도교육청 경기도구리남양주교육지원청 남양주덕송초등학교병설유치원,4,4,0,4,2,2,0,0
교육기관,교육부,남양주도곡초등학교,교육부 경기도교육청 경기도구리남양주교육지원청 남양주도곡초등학교,12,12,0,12,5,7,0,0
교육기관,교육부,남양주도담유치원,교육부 경기도교육청 경기도구리남양주교육지원청 남양주도담유치원,22,11,11,11,5,6,0,0
교육기관,교육부,남양주동곡초등학교,교육부 경기도교육청 경기도구리남양주교육지원청 남양주동곡초등학교,9,9,0,9,0,9,0,0
교육기관,교육부,남양주미금초등학교,교육부 경기도교육청 경기도구리남양주교육지원청 남양주미금초등학교,25,25,0,25,0,25,0,0
교육기관,교육부,남양주백봉초등학교,교육부 경기도교육청 경기도구리남양주교육지원청 남양주백봉초등학교,28,28,0,28,0,28,0,0
교육기관,교육부,남양주별빛유치원,교육부 경기도교육청 경기도구리남양주교육지원청 남양주별빛유치원,9,9,0,9,4,5,0,0
교육기관,교육부,남양주송라초등학교,교육부 경기도교육청 경기도구리남양주교육지원청 남양주송라초등학교,18,18,0,18,18,0,0,0
교육기관,교육부,남양주송촌초등학교,교육부 경기도교육청 경기도구리남양주교육지원청 남양주송촌초등학교,10,10,0,10,8,2,0,0
교육기관,교육부,남양주신촌초등학교,교육부 경기도교육청 경기도구리남양주교육지원청 남양주신촌초등학교,16,16,0,16,16,0,0,0
교육기관,교육부,남양주양정초등학교,교육부 경기도교육청 경기도구리남양주교육지원청 남양주양정초등학교,13,13,0,13,6,7,0,0
교육기관,교육부,남양주양지초등학교,교육부 경기도교육청 경기도구리남양주교육지원청 남양주양지초등학교,17,17,0,17,14,1,1,1
교육기관,교육부,남양주월산초등학교,교육부 경기도교육청 경기도구리남양주교육지원청 남양주월산초등학교,11,11,0,11,4,3,2,2
교육기관,교육부,내양초등학교,교육부 경기도교육청 경기도구리남양주교육지원청 내양초등학교,8,8,0,8,3,5,0,0
교육기관,교육부,다산가람초등학교,교육부 경기도교육청 경기도구리남양주교육지원청 다산가람초등학교,23,23,0,23,23,0,0,0
교육기관,교육부,다산꽃다비유치원,교육부 경기도교육청 경기도구리남양주교육지원청 다산꽃다비유치원,30,8,22,8,0,8,0,0
교육기관,교육부,다산별빛초등학교,교육부 경기도교육청 경기도구리남양주교육지원청 다산별빛초등학교,32,32,0,32,32,0,0,0
교육기관,교육부,다산새봄유치원,교육부 경기도교육청 경기도구리남양주교육지원청 다산새봄유치원,8,8,0,8,4,4,0,0
교육기관,교육부,다산새봄중학교,교육부 경기도교육청 경기도구리남양주교육지원청 다산새봄중학교,59,58,1,58,58,0,0,0
교육기관,교육부,다산새봄초등학교,교육부 경기도교육청 경기도구리남양주교육지원청 다산새봄초등학교,46,45,1,45,22,23,0,0
교육기관,교육부,다산하늘빛유치원,교육부 경기도교육청 경기도구리남양주교육지원청 다산하늘빛유치원,30,30,0,30,8,22,0,0
교육기관,교육부,다산하늘초등학교,교육부 경기도교육청 경기도구리남양주교육지원청 다산하늘초등학교,24,24,0,24,17,7,0,0
교육기관,교육부,다산한강유치원,교육부 경기도교육청 경기도구리남양주교육지원청 다산한강유치원,15,9,6,9,1,4,3,1
교육기관,교육부,다산한강중학교,교육부 경기도교육청 경기도구리남양주교육지원청 다산한강중학교,16,15,1,15,8,7,0,0
교육기관,교육부,다산한강초등학교,교육부 경기도교육청 경기도구리남양주교육지원청 다산한강초등학교,36,36,0,36,0,36,0,0
교육기관,교육부,답내초등학교,교육부 경기도교육청 경기도구리남양주교육지원청 답내초등학교,9,9,0,9,3,6,0,0
교육기관,교육부,덕소고등학교,교육부 경기도교육청 경기도구리남양주교육지원청 덕소고등학교,54,54,0,54,0,54,0,0
교육기관,교육부,덕소중학교,교육부 경기도교육청 경기도구리남양주교육지원청 덕소중학교,42,42,0,42,32,10,0,0
교육기관,교육부,덕소초등학교,교육부 경기도교육청 경기도구리남양주교육지원청 덕소초등학교,18,18,0,18,13,5,0,0
교육기관,교육부,도농고등학교,교육부 경기도교육청 경기도구리남양주교육지원청 도농고등학교,45,45,0,45,41,4,0,0
교육기관,교육부,도농중학교,교육부 경기도교육청 경기도구리남양주교육지원청 도농중학교,27,27,0,27,2,23,2,0
교육기관,교육부,도심초등학교,교육부 경기도교육청 경기도구리남양주교육지원청 도심초등학교,11,11,0,11,5,6,0,0
교육기관,교육부,도제원초등학교,교육부 경기도교육청 경기도구리남양주교육지원청 도제원초등학교,16,16,0,16,16,0,0,0
교육기관,교육부,동구중학교,교육부 경기도교육청 경기도구리남양주교육지원청 동구중학교,43,40,3,40,40,0,0,0
교육기관,교육부,동구초등학교,교육부 경기도교육청 경기도구리남양주교육지원청 동구초등학교,11,11,0,11,11,0,0,0
교육기관,교육부,동인초등학교,교육부 경기도교육청 경기도구리남양주교육지원청 동인초등학교,32,32,0,32,32,0,0,0
교육기관,교육부,동화고등학교,교육부 경기도교육청 경기도구리남양주교육지원청 동화고등학교,32,32,0,32,32,0,0,0
교육기관,교육부,동화중학교,교육부 경기도교육청 경기도구리남양주교육지원청 동화중학교,15,15,0,15,14,1,0,0
교육기관,교육부,마석고등학교,교육부 경기도교육청 경기도구리남양주교육지원청 마석고등학교,74,17,57,17,17,0,0,0
교육기관,교육부,마석중학교,교육부 경기도교육청 경기도구리남양주교육지원청 마석중학교,33,33,0,33,33,0,0,0
교육기관,교육부,마석초등학교,교육부 경기도교육청 경기도구리남양주교육지원청 마석초등학교,14,14,0,14,13,1,0,0
교육기관,교육부,미금중학교,교육부 경기도교육청 경기도구리남양주교육지원청 미금중학교,23,23,0,23,23,0,0,0
교육기관,교육부,백문초등학교,교육부 경기도교육청 경기도구리남양주교육지원청 백문초등학교,20,20,0,20,17,3,0,0
교육기관,교육부,별가람고등학교,교육부 경기도교육청 경기도구리남양주교육지원청 별가람고등학교,55,55,0,55,24,31,0,0
교육기관,교육부,별가람유치원,교육부 경기도교육청 경기도구리남양주교육지원청 별가람유치원,7,7,0,7,2,5,0,0
교육기관,교육부,별가람중학교,교육부 경기도교육청 경기도구리남양주교육지원청 별가람중학교,32,32,0,32,21,11,0,0
교육기관,교육부,별가람초등학교,교육부 경기도교육청 경기도구리남양주교육지원청 별가람초등학교,13,13,0,13,3,10,0,0
교육기관,교육부,별내고등학교,교육부 경기도교육청 경기도구리남양주교육지원청 별내고등학교,50,50,0,50,48,2,0,0
교육기관,교육부,별내중학교,교육부 경기도교육청 경기도구리남양주교육지원청 별내중학교,16,16,0,16,6,10,0,0
교육기관,교육부,별내초등학교,교육부 경기도교육청 경기도구리남양주교육지원청 별내초등학교,20,20,0,20,20,0,0,0
교육기관,교육부,부양초등학교,교육부 경기도교육청 경기도구리남양주교육지원청 부양초등학교,23,23,0,23,23,0,0,0
교육기관,교육부,부평초등학교,교육부 경기도교육청 경기도구리남양주교육지원청 부평초등학교,18,18,0,18,14,4,0,0
교육기관,교육부,사능초등학교,교육부 경기도교육청 경기도구리남양주교육지원청 사능초등학교,15,15,0,15,14,1,0,0
교육기관,교육부,산마루초등학교,교육부 경기도교육청 경기도구리남양주교육지원청 산마루초등학교,22,22,0,22,0,22,0,0
교육기관,교육부,서울삼육고등학교,교육부 경기도교육청 경기도구리남양주교육지원청 서울삼육고등학교,80,64,16,64,0,62,2,0
교육기관,교육부,서울삼육중학교,교육부 경기도교육청 경기도구리남양주교육지원청 서울삼육중학교,46,46,0,46,9,37,0,0
교육기관,교육부,송라중학교,교육부 경기도교육청 경기도구리남양주교육지원청 송라중학교,20,19,1,19,19,0,0,0
교육기관,교육부,수동중학교,교육부 경기도교육청 경기도구리남양주교육지원청 수동중학교,24,24,0,24,0,24,0,0
교육기관,교육부,수동초등학교송천분교장,교육부 경기도교육청 경기도구리남양주교육지원청 수동초등학교송천분교장,12,12,0,12,0,12,0,0
교육기관,교육부,수택고등학교,교육부 경기도교육청 경기도구리남양주교육지원청 수택고등학교,55,53,2,53,2,51,0,0
교육기관,교육부,수택초등학교,교육부 경기도교육청 경기도구리남양주교육지원청 수택초등학교,20,20,0,20,0,20,0,0
교육기관,교육부,심석고등학교,교육부 경기도교육청 경기도구리남양주교육지원청 심석고등학교,46,44,2,44,22,22,0,0
교육기관,교육부,심석중학교,교육부 경기도교육청 경기도구리남양주교육지원청 심석중학교,32,32,0,32,22,10,0,0
교육기관,교육부,심석초등학교,교육부 경기도교육청 경기도구리남양주교육지원청 심석초등학교,38,38,0,38,0,38,0,0
교육기관,교육부,양오중학교,교육부 경기도교육청 경기도구리남양주교육지원청 양오중학교,37,35,2,35,0,35,0,0
교육기관,교육부,양오초등학교,교육부 경기도교육청 경기도구리남양주교육지원청 양오초등학교,17,17,0,17,17,0,0,0
교육기관,교육부,어람중학교,교육부 경기도교육청 경기도구리남양주교육지원청 어람중학교,22,20,2,20,12,6,1,1
교육기관,교육부,연세중학교,교육부 경기도교육청 경기도구리남양주교육지원청 연세중학교,9,9,0,9,0,9,0,0
교육기관,교육부,예봉중학교,교육부 경기도교육청 경기도구리남양주교육지원청 예봉중학교,32,32,0,32,18,14,0,0
교육기관,교육부,예봉초등학교,교육부 경기도교육청 경기도구리남양주교육지원청 예봉초등학교,13,13,0,13,10,3,0,0
교육기관,교육부,예봉초등학교병설유치원,교육부 경기도교육청 경기도구리남양주교육지원청 예봉초등학교병설유치원,2,2,0,2,1,0,1,0
교육기관,교육부,오남고등학교,교육부 경기도교육청 경기도구리남양주교육지원청 오남고등학교,64,41,23,41,19,22,0,0
교육기관,교육부,오남중학교,교육부 경기도교육청 경기도구리남양주교육지원청 오남중학교,53,53,0,53,35,18,0,0
교육기관,교육부,와부고등학교,교육부 경기도교육청 경기도구리남양주교육지원청 와부고등학교,77,14,63,14,14,0,0,0
교육기관,교육부,와부중학교,교육부 경기도교육청 경기도구리남양주교육지원청 와부중학교,34,32,2,32,17,15,0,0
교육기관,교육부,용신초등학교,교육부 경기도교육청 경기도구리남양주교육지원청 용신초등학교,11,11,0,11,11,0,0,0
교육기관,교육부,은솔초등학교,교육부 경기도교육청 경기도구리남양주교육지원청 은솔초등학교,19,17,2,17,12,3,0,2
교육기관,교육부,인창유치원,교육부 경기도교육청 경기도구리남양주교육지원청 인창유치원,7,7,0,7,4,3,0,0
교육기관,교육부,인창중학교,교육부 경기도교육청 경기도구리남양주교육지원청 인창중학교,16,12,4,12,9,3,0,0
교육기관,교육부,인창초등학교,교육부 경기도교육청 경기도구리남양주교육지원청 인창초등학교,12,12,0,12,7,5,0,0
교육기관,교육부,장내중학교,교육부 경기도교육청 경기도구리남양주교육지원청 장내중학교,18,18,0,18,2,16,0,0
교육기관,교육부,장내초등학교,교육부 경기도교육청 경기도구리남양주교육지원청 장내초등학교,22,22,0,22,22,0,0,0
교육기관,교육부,장승초등학교,교육부 경기도교육청 경기도구리남양주교육지원청 장승초등학교,13,13,0,13,13,0,0,0
교육기관,교육부,장자중학교,교육부 경기도교육청 경기도구리남양주교육지원청 장자중학교,39,35,4,35,27,8,0,0
교육기관,교육부,장자초등학교,교육부 경기도교육청 경기도구리남양주교육지원청 장자초등학교,11,11,0,11,9,2,0,0
교육기관,교육부,장자초등학교병설유치원,교육부 경기도교육청 경기도구리남양주교육지원청 장자초등학교병설유치원,11,11,0,11,7,2,2,0
교육기관,교육부,장현초등학교,교육부 경기도교육청 경기도구리남양주교육지원청 장현초등학교,17,17,0,17,17,0,0,0
교육기관,교육부,조안초등학교,교육부 경기도교육청 경기도구리남양주교육지원청 조안초등학교,12,12,0,12,4,8,0,0
교육기관,교육부,주곡중학교,교육부 경기도교육청 경기도구리남양주교육지원청 주곡중학교,19,19,0,19,0,19,0,0
교육기관,교육부,주곡초등학교,교육부 경기도교육청 경기도구리남양주교육지원청 주곡초등학교,18,18,0,18,0,18,0,0
교육기관,교육부,진건고등학교,교육부 경기도교육청 경기도구리남양주교육지원청 진건고등학교,49,49,0,49,44,5,0,0
교육기관,교육부,진건중학교,교육부 경기도교육청 경기도구리남양주교육지원청 진건중학교,14,12,2,12,10,2,0,0
교육기관,교육부,진건초등학교,교육부 경기도교육청 경기도구리남양주교육지원청 진건초등학교,19,19,0,19,19,0,0,0
교육기관,교육부,진접고등학교,교육부 경기도교육청 경기도구리남양주교육지원청 진접고등학교,103,103,0,103,21,82,0,0
교육기관,교육부,진접중학교,교육부 경기도교육청 경기도구리남양주교육지원청 진접중학교,23,22,1,22,11,11,0,0
교육기관,교육부,진접초등학교,교육부 경기도교육청 경기도구리남양주교육지원청 진접초등학교,21,21,0,21,11,10,0,0
교육기관,교육부,차산초등학교,교육부 경기도교육청 경기도구리남양주교육지원청 차산초등학교,19,19,0,19,13,3,2,1
교육기관,교육부,창현유치원,교육부 경기도교육청 경기도구리남양주교육지원청 창현유치원,16,16,0,16,0,16,0,0
교육기관,교육부,창현초등학교,교육부 경기도교육청 경기도구리남양주교육지원청 창현초등학교,16,16,0,16,0,16,0,0
교육기관,교육부,천마중학교,교육부 경기도교육청 경기도구리남양주교육지원청 천마중학교,27,27,0,27,1,26,0,0
교육기관,교육부,천마초등학교,교육부 경기도교육청 경기도구리남양주교육지원청 천마초등학교,32,32,0,32,0,32,0,0
교육기관,교육부,청학고등학교,교육부 경기도교육청 경기도구리남양주교육지원청 청학고등학교,66,66,0,66,49,17,0,0
교육기관,교육부,토평고등학교,교육부 경기도교육청 경기도구리남양주교육지원청 토평고등학교,40,40,0,40,24,16,0,0
교육기관,교육부,토평중학교,교육부 경기도교육청 경기도구리남양주교육지원청 토평중학교,20,19,1,19,7,6,2,4
교육기관,교육부,토평초등학교,교육부 경기도교육청 경기도구리남양주교육지원청 토평초등학교,14,14,0,14,14,0,0,0
교육기관,교육부,퇴계원고등학교,교육부 경기도교육청 경기도구리남양주교육지원청 퇴계원고등학교,48,48,0,48,48,0,0,0
교육기관,교육부,퇴계원중학교,교육부 경기도교육청 경기도구리남양주교육지원청 퇴계원중학교,19,19,0,19,0,19,0,0
교육기관,교육부,퇴계원초등학교,교육부 경기도교육청 경기도구리남양주교육지원청 퇴계원초등학교,10,10,0,10,5,5,0,0
교육기관,교육부,판곡고등학교,교육부 경기도교육청 경기도구리남양주교육지원청 판곡고등학교,63,61,2,61,40,20,1,0
교육기관,교육부,판곡중학교,교육부 경기도교육청 경기도구리남양주교육지원청 판곡중학교,47,47,0,47,40,7,0,0
교육기관,교육부,판곡초등학교,교육부 경기도교육청 경기도구리남양주교육지원청 판곡초등학교,32,32,0,32,32,0,0,0
교육기관,교육부,평내고등학교,교육부 경기도교육청 경기도구리남양주교육지원청 평내고등학교,32,32,0,32,0,32,0,0
교육기관,교육부,평내중학교,교육부 경기도교육청 경기도구리남양주교육지원청 평내중학교,25,25,0,25,9,14,1,1
교육기관,교육부,평내초등학교,교육부 경기도교육청 경기도구리남양주교육지원청 평내초등학교,13,13,0,13,0,13,0,0
교육기관,교육부,평동초등학교,교육부 경기도교육청 경기도구리남양주교육지원청 평동초등학교,17,17,0,17,1,13,1,2
교육기관,교육부,풍양중학교,교육부 경기도교육청 경기도구리남양주교육지원청 풍양중학교,16,16,0,16,0,16,0,0
교육기관,교육부,하랑중학교,교육부 경기도교육청 경기도구리남양주교육지원청 하랑중학교,34,32,2,32,0,32,0,0
교육기관,교육부,하랑초등학교,교육부 경기도교육청 경기도구리남양주교육지원청 하랑초등학교,34,34,0,34,34,0,0,0
교육기관,교육부,한별중학교,교육부 경기도교육청 경기도구리남양주교육지원청 한별중학교,48,48,0,48,39,9,0,0
교육기관,교육부,한별초등학교,교육부 경기도교육청 경기도구리남양주교육지원청 한별초등학교,25,25,0,25,19,6,0,0
교육기관,교육부,해밀초등학교,교육부 경기도교육청 경기도구리남양주교육지원청 해밀초등학교,14,14,0,14,0,14,0,0
교육기관,교육부,호평고등학교,교육부 경기도교육청 경기도구리남양주교육지원청 호평고등학교,58,58,0,58,50,8,0,0
교육기관,교육부,호평유치원,교육부 경기도교육청 경기도구리남양주교육지원청 호평유치원,4,4,0,4,0,4,0,0
교육기관,교육부,호평중학교,교육부 경기도교육청 경기도구리남양주교육지원청 호평중학교,75,75,0,75,69,4,0,2
교육기관,교육부,호평초등학교,교육부 경기도교육청 경기도구리남양주교육지원청 호평초등학교,11,11,0,11,11,0,0,0
교육기관,교육부,화광중학교,교육부 경기도교육청 경기도구리남양주교육지원청 화광중학교,29,29,0,29,27,2,0,0
교육기관,교육부,화도은솔유치원,교육부 경기도교육청 경기도구리남양주교육지원청 화도은솔유치원,8,8,0,8,0,8,0,0
교육기관,교육부,화도초등학교,교육부 경기도교육청 경기도구리남양주교육지원청 화도초등학교,23,23,0,23,23,0,0,0
교육기관,교육부,화봉초등학교,교육부 경기도교육청 경기도구리남양주교육지원청 화봉초등학교,18,18,0,18,18,0,0,0
교육기관,교육부,화접초등학교,교육부 경기도교육청 경기도구리남양주교육지원청 화접초등학교,24,24,0,24,24,0,0,0
교육기관,교육부,경기도국제교육원,교육부 경기도교육청 경기도국제교육원,27,27,0,27,27,0,0,0
교육기관,교육부,경기도군포의왕교육지원청,교육부 경기도교육청 경기도군포의왕교육지원청,8,8,0,8,0,8,0,0
교육기관,교육부,갈뫼중학교,교육부 경기도교육청 경기도군포의왕교육지원청 갈뫼중학교,16,15,1,15,15,0,0,0
교육기관,교육부,갈뫼초등학교,교육부 경기도교육청 경기도군포의왕교육지원청 갈뫼초등학교,23,23,0,23,23,0,0,0
교육기관,교육부,경기외국어고등학교,교육부 경기도교육청 경기도군포의왕교육지원청 경기외국어고등학교,154,154,0,154,0,154,0,0
교육기관,교육부,경기폴리텍고등학교,교육부 경기도교육청 경기도군포의왕교육지원청 경기폴리텍고등학교,31,31,0,31,11,20,0,0
교육기관,교육부,고천중학교,교육부 경기도교육청 경기도군포의왕교육지원청 고천중학교,21,21,0,21,17,4,0,0
교육기관,교육부,고천초등학교,교육부 경기도교육청 경기도군포의왕교육지원청 고천초등학교,21,21,0,21,20,1,0,0
교육기관,교육부,곡란중학교,교육부 경기도교육청 경기도군포의왕교육지원청 곡란중학교,21,21,0,21,21,0,0,0
교육기관,교육부,곡란초등학교,교육부 경기도교육청 경기도군포의왕교육지원청 곡란초등학교,22,22,0,22,7,13,1,1
교육기관,교육부,관모초등학교,교육부 경기도교육청 경기도군포의왕교육지원청 관모초등학교,21,21,0,21,21,0,0,0
교육기관,교육부,광정초등학교,교육부 경기도교육청 경기도군포의왕교육지원청 광정초등학교,19,19,0,19,19,0,0,0
교육기관,교육부,군포e비즈니스고등학교,교육부 경기도교육청 경기도군포의왕교육지원청 군포e비즈니스고등학교,59,59,0,59,0,59,0,0
교육기관,교육부,군포고등학교,교육부 경기도교육청 경기도군포의왕교육지원청 군포고등학교,41,41,0,41,20,19,1,1
교육기관,교육부,군포대야초등학교,교육부 경기도교육청 경기도군포의왕교육지원청 군포대야초등학교,19,19,0,19,0,19,0,0
교육기관,교육부,군포신기초등학교,교육부 경기도교육청 경기도군포의왕교육지원청 군포신기초등학교,13,13,0,13,8,2,0,3
교육기관,교육부,군포양정초등학교,교육부 경기도교육청 경기도군포의왕교육지원청 군포양정초등학교,24,24,0,24,13,11,0,0
교육기관,교육부,군포옥천초등학교,교육부 경기도교육청 경기도군포의왕교육지원청 군포옥천초등학교,20,20,0,20,20,0,0,0
교육기관,교육부,군포유치원,교육부 경기도교육청 경기도군포의왕교육지원청 군포유치원,3,0,3,0,0,0,0,0
교육기관,교육부,군포중앙고등학교,교육부 경기도교육청 경기도군포의왕교육지원청 군포중앙고등학교,23,23,0,23,0,23,0,0
교육기관,교육부,군포중학교,교육부 경기도교육청 경기도군포의왕교육지원청 군포중학교,15,15,0,15,0,14,0,1
교육기관,교육부,군포초등학교,교육부 경기도교육청 경기도군포의왕교육지원청 군포초등학교,36,36,0,36,18,18,0,0
교육기관,교육부,군포화산초등학교,교육부 경기도교육청 경기도군포의왕교육지원청 군포화산초등학교,12,12,0,12,12,0,0,0
교육기관,교육부,궁내중학교,교육부 경기도교육청 경기도군포의왕교육지원청 궁내중학교,19,19,0,19,11,8,0,0
교육기관,교육부,궁내초등학교,교육부 경기도교육청 경기도군포의왕교육지원청 궁내초등학교,20,20,0,20,20,0,0,0
교육기관,교육부,금정중학교,교육부 경기도교육청 경기도군포의왕교육지원청 금정중학교,37,35,2,35,19,15,1,0
교육기관,교육부,금정초등학교,교육부 경기도교육청 경기도군포의왕교육지원청 금정초등학교,30,30,0,30,20,10,0,0
교육기관,교육부,내동초등학교,교육부 경기도교육청 경기도군포의왕교육지원청 내동초등학교,19,19,0,19,19,0,0,0
교육기관,교육부,내손초등학교,교육부 경기도교육청 경기도군포의왕교육지원청 내손초등학교,21,21,0,21,16,5,0,0
교육기관,교육부,능내초등학교,교육부 경기도교육청 경기도군포의왕교육지원청 능내초등학교,10,10,0,10,0,10,0,0
교육기관,교육부,당동중학교,교육부 경기도교육청 경기도군포의왕교육지원청 당동중학교,23,22,1,22,19,3,0,0
교육기관,교육부,당동초등학교,교육부 경기도교육청 경기도군포의왕교육지원청 당동초등학교,13,13,0,13,13,0,0,0
교육기관,교육부,당정중학교,교육부 경기도교육청 경기도군포의왕교육지원청 당정중학교,17,17,0,17,5,12,0,0
교육기관,교육부,당정초등학교,교육부 경기도교육청 경기도군포의왕교육지원청 당정초등학교,9,9,0,9,3,3,2,1
교육기관,교육부,덕장중학교,교육부 경기도교육청 경기도군포의왕교육지원청 덕장중학교,16,16,0,16,15,1,0,0
교육기관,교육부,덕장초등학교,교육부 경기도교육청 경기도군포의왕교육지원청 덕장초등학교,16,16,0,16,16,0,0,0
교육기관,교육부,도장중학교,교육부 경기도교육청 경기도군포의왕교육지원청 도장중학교,23,21,2,21,0,21,0,0
교육기관,교육부,도장초등학교,교육부 경기도교육청 경기도군포의왕교육지원청 도장초등학교,15,15,0,15,0,15,0,0
교육기관,교육부,둔대초등학교,교육부 경기도교육청 경기도군포의왕교육지원청 둔대초등학교,17,17,0,17,13,4,0,0
교육기관,교육부,둔전초등학교,교육부 경기도교육청 경기도군포의왕교육지원청 둔전초등학교,16,16,0,16,4,10,1,1
교육기관,교육부,모락고등학교,교육부 경기도교육청 경기도군포의왕교육지원청 모락고등학교,33,33,0,33,20,13,0,0
교육기관,교육부,모락중학교,교육부 경기도교육청 경기도군포의왕교육지원청 모락중학교,13,13,0,13,0,13,0,0
교육기관,교육부,모락초등학교,교육부 경기도교육청 경기도군포의왕교육지원청 모락초등학교,16,16,0,16,7,7,2,0
교육기관,교육부,밝음유치원,교육부 경기도교육청 경기도군포의왕교육지원청 밝음유치원,8,1,7,1,1,0,0,0
교육기관,교육부,백운고등학교,교육부 경기도교육청 경기도군포의왕교육지원청 백운고등학교,23,23,0,23,12,11,0,0
교육기관,교육부,백운중학교,교육부 경기도교육청 경기도군포의왕교육지원청 백운중학교,22,21,1,21,5,16,0,0
교육기관,교육부,백운초등학교,교육부 경기도교육청 경기도군포의왕교육지원청 백운초등학교,15,15,0,15,5,9,1,0
교육기관,교육부,백운호수초등학교,교육부 경기도교육청 경기도군포의왕교육지원청 백운호수초등학교,21,21,0,21,2,16,3,0
교육기관,교육부,부곡중앙중학교,교육부 경기도교육청 경기도군포의왕교육지원청 부곡중앙중학교,19,14,5,14,7,7,0,0
교육기관,교육부,부곡중앙초등학교,교육부 경기도교육청 경기도군포의왕교육지원청 부곡중앙초등학교,20,20,0,20,12,8,0,0
교육기관,교육부,사랑유치원,교육부 경기도교육청 경기도군포의왕교육지원청 사랑유치원,16,16,0,16,0,16,0,0
교육기관,교육부,산본고등학교,교육부 경기도교육청 경기도군포의왕교육지원청 산본고등학교,22,22,0,22,13,9,0,0
교육기관,교육부,산본유치원,교육부 경기도교육청 경기도군포의왕교육지원청 산본유치원,10,2,8,2,0,2,0,0
교육기관,교육부,산본중학교,교육부 경기도교육청 경기도군포의왕교육지원청 산본중학교,30,30,0,30,12,16,1,1
교육기관,교육부,산본초등학교,교육부 경기도교육청 경기도군포의왕교육지원청 산본초등학교,17,17,0,17,17,0,0,0
교육기관,교육부,성유유치원,교육부 경기도교육청 경기도군포의왕교육지원청 성유유치원,24,0,24,0,0,0,0,0
교육기관,교육부,소중한아이들유치원,교육부 경기도교육청 경기도군포의왕교육지원청 소중한아이들유치원,16,3,13,3,2,1,0,0
교육기관,교육부,송안초등학교,교육부 경기도교육청 경기도군포의왕교육지원청 송안초등학교,26,26,0,26,22,4,0,0
교육기관,교육부,수리고등학교,교육부 경기도교육청 경기도군포의왕교육지원청 수리고등학교,30,30,0,30,16,14,0,0
교육기관,교육부,수리중학교,교육부 경기도교육청 경기도군포의왕교육지원청 수리중학교,12,10,2,10,0,10,0,0
교육기관,교육부,수리초등학교,교육부 경기도교육청 경기도군포의왕교육지원청 수리초등학교,8,8,0,8,1,7,0,0
교육기관,교육부,숲속해뜰유치원,교육부 경기도교육청 경기도군포의왕교육지원청 숲속해뜰유치원,5,5,0,5,0,5,0,0
교육기관,교육부,신흥초등학교,교육부 경기도교육청 경기도군포의왕교육지원청 신흥초등학교,12,12,0,12,2,10,0,0
교육기관,교육부,여수룬유치원,교육부 경기도교육청 경기도군포의왕교육지원청 여수룬유치원,12,12,0,12,0,12,0,0
교육기관,교육부,오금초등학교,교육부 경기도교육청 경기도군포의왕교육지원청 오금초등학교,10,10,0,10,7,3,0,0
교육기관,교육부,오전초등학교,교육부 경기도교육청 경기도군포의왕교육지원청 오전초등학교,32,32,0,32,16,16,0,0
교육기관,교육부,왕곡초등학교,교육부 경기도교육청 경기도군포의왕교육지원청 왕곡초등학교,25,25,0,25,19,6,0,0
교육기관,교육부,용호고등학교,교육부 경기도교육청 경기도군포의왕교육지원청 용호고등학교,15,15,0,15,14,1,0,0
교육기관,교육부,용호중학교,교육부 경기도교육청 경기도군포의왕교육지원청 용호중학교,19,19,0,19,0,19,0,0
교육기관,교육부,용호초등학교,교육부 경기도교육청 경기도군포의왕교육지원청 용호초등학교,15,15,0,15,14,1,0,0
교육기관,교육부,우성고등학교,교육부 경기도교육청 경기도군포의왕교육지원청 우성고등학교,27,27,0,27,19,8,0,0
교육기관,교육부,의왕고등학교,교육부 경기도교육청 경기도군포의왕교육지원청 의왕고등학교,47,47,0,47,47,0,0,0
교육기관,교육부,의왕덕성초등학교,교육부 경기도교육청 경기도군포의왕교육지원청 의왕덕성초등학교,50,50,0,50,35,15,0,0
교육기관,교육부,의왕부곡중학교,교육부 경기도교육청 경기도군포의왕교육지원청 의왕부곡중학교,20,20,0,20,9,11,0,0
교육기관,교육부,의왕부곡초등학교,교육부 경기도교육청 경기도군포의왕교육지원청 의왕부곡초등학교,12,12,0,12,12,0,0,0
교육기관,교육부,의왕정음학교,교육부 경기도교육청 경기도군포의왕교육지원청 의왕정음학교,36,36,0,36,0,36,0,0
교육기관,교육부,의왕중학교,교육부 경기도교육청 경기도군포의왕교육지원청 의왕중학교,14,14,0,14,4,10,0,0
교육기관,교육부,의왕초등학교,교육부 경기도교육청 경기도군포의왕교육지원청 의왕초등학교,12,12,0,12,6,6,0,0
교육기관,교육부,천사유치원,교육부 경기도교육청 경기도군포의왕교육지원청 천사유치원,16,2,14,2,0,2,0,0
교육기관,교육부,태을초등학교,교육부 경기도교육청 경기도군포의왕교육지원청 태을초등학교,10,10,0,10,10,0,0,0
교육기관,교육부,포일사과나무유치원,교육부 경기도교육청 경기도군포의왕교육지원청 포일사과나무유치원,12,12,0,12,8,4,0,0
교육기관,교육부,포일성모유치원,교육부 경기도교육청 경기도군포의왕교육지원청 포일성모유치원,16,9,7,9,3,3,2,1
교육기관,교육부,포일초등학교,교육부 경기도교육청 경기도군포의왕교육지원청 포일초등학교,19,19,0,19,19,0,0,0
교육기관,교육부,한얼초등학교,교육부 경기도교육청 경기도군포의왕교육지원청 한얼초등학교,16,16,0,16,2,14,0,0
교육기관,교육부,현대유치원,교육부 경기도교육청 경기도군포의왕교육지원청 현대유치원,16,16,0,16,12,4,0,0
교육기관,교육부,홍하유치원,교육부 경기도교육청 경기도군포의왕교육지원청 홍하유치원,22,3,19,3,1,2,0,0
교육기관,교육부,흥진고등학교,교육부 경기도교육청 경기도군포의왕교육지원청 흥진고등학교,34,34,0,34,11,21,2,0
교육기관,교육부,흥진중학교,교육부 경기도교육청 경기도군포의왕교육지원청 흥진중학교,12,10,2,10,2,5,2,1
교육기관,교육부,흥진초등학교,교육부 경기도교육청 경기도군포의왕교육지원청 흥진초등학교,9,9,0,9,4,5,0,0
교육기관,교육부,경기도김포교육지원청,교육부 경기도교육청 경기도김포교육지원청,17,17,0,17,14,3,0,0
교육기관,교육부,가현초등학교,교육부 경기도교육청 경기도김포교육지원청 가현초등학교,21,21,0,21,21,0,0,0
교육기관,교육부,감정중학교,교육부 경기도교육청 경기도김포교육지원청 감정중학교,25,25,0,25,5,20,0,0
교육기관,교육부,감정초등학교,교육부 경기도교육청 경기도김포교육지원청 감정초등학교,8,8,0,8,3,3,1,1
교육기관,교육부,개곡초등학교,교육부 경기도교육청 경기도김포교육지원청 개곡초등학교,25,25,0,25,0,25,0,0
교육기관,교육부,걸포초등학교,교육부 경기도교육청 경기도김포교육지원청 걸포초등학교,17,17,0,17,8,9,0,0
교육기관,교육부,고창중학교,교육부 경기도교육청 경기도김포교육지원청 고창중학교,27,27,0,27,3,24,0,0
교육기관,교육부,고창초등학교,교육부 경기도교육청 경기도김포교육지원청 고창초등학교,13,13,0,13,10,3,0,0
교육기관,교육부,고촌중학교,교육부 경기도교육청 경기도김포교육지원청 고촌중학교,11,11,0,11,4,6,1,0
교육기관,교육부,고촌초등학교,교육부 경기도교육청 경기도김포교육지원청 고촌초등학교,20,20,0,20,0,20,0,0
교육기관,교육부,금란초등학교,교육부 경기도교육청 경기도김포교육지원청 금란초등학교,23,23,0,23,19,4,0,0
교육기관,교육부,금성초등학교,교육부 경기도교육청 경기도김포교육지원청 금성초등학교,16,16,0,16,16,0,0,0
교육기관,교육부,금파중학교,교육부 경기도교육청 경기도김포교육지원청 금파중학교,22,22,0,22,12,10,0,0
교육기관,교육부,금파초등학교,교육부 경기도교육청 경기도김포교육지원청 금파초등학교,12,12,0,12,0,12,0,0
교육기관,교육부,김포가온유치원,교육부 경기도교육청 경기도김포교육지원청 김포가온유치원,16,3,13,3,3,0,0,0
교육기관,교육부,김포고등학교,교육부 경기도교육청 경기도김포교육지원청 김포고등학교,27,27,0,27,20,7,0,0
교육기관,교육부,김포구래초등학교,교육부 경기도교육청 경기도김포교육지원청 김포구래초등학교,14,14,0,14,14,0,0,0
교육기관,교육부,김포금빛초등학교,교육부 경기도교육청 경기도김포교육지원청 김포금빛초등학교,27,27,0,27,8,19,0,0
교육기관,교육부,김포나진초등학교,교육부 경기도교육청 경기도김포교육지원청 김포나진초등학교,16,16,0,16,16,0,0,0
교육기관,교육부,김포대명초등학교,교육부 경기도교육청 경기도김포교육지원청 김포대명초등학교,15,15,0,15,6,9,0,0
교육기관,교육부,김포서초등학교,교육부 경기도교육청 경기도김포교육지원청 김포서초등학교,23,23,0,23,2,21,0,0
교육기관,교육부,김포신곡중학교,교육부 경기도교육청 경기도김포교육지원청 김포신곡중학교,27,27,0,27,10,15,1,1
교육기관,교육부,김포신풍초등학교,교육부 경기도교육청 경기도김포교육지원청 김포신풍초등학교,30,30,0,30,30,0,0,0
교육기관,교육부,김포여자중학교,교육부 경기도교육청 경기도김포교육지원청 김포여자중학교,12,12,0,12,6,6,0,0
교육기관,교육부,김포외국어고등학교,교육부 경기도교육청 경기도김포교육지원청 김포외국어고등학교,92,90,2,90,12,78,0,0
교육기관,교육부,김포유치원,교육부 경기도교육청 경기도김포교육지원청 김포유치원,6,6,0,6,0,6,0,0
교육기관,교육부,김포은솔유치원,교육부 경기도교육청 경기도김포교육지원청 김포은솔유치원,6,6,0,6,0,6,0,0
교육기관,교육부,김포제일고등학교,교육부 경기도교육청 경기도김포교육지원청 김포제일고등학교,14,13,1,13,13,0,0,0
교육기관,교육부,김포제일공업고등학교,교육부 경기도교육청 경기도김포교육지원청 김포제일공업고등학교,33,33,0,33,18,15,0,0
교육기관,교육부,김포중학교,교육부 경기도교육청 경기도김포교육지원청 김포중학교,27,27,0,27,27,0,0,0
교육기관,교육부,김포초등학교,교육부 경기도교육청 경기도김포교육지원청 김포초등학교,37,37,0,37,37,0,0,0
교육기관,교육부,김포한가람유치원,교육부 경기도교육청 경기도김포교육지원청 김포한가람유치원,10,10,0,10,10,0,0,0
교육기관,교육부,김포한가람중학교,교육부 경기도교육청 경기도김포교육지원청 김포한가람중학교,28,28,0,28,2,24,1,1
교육기관,교육부,김포한가람초등학교,교육부 경기도교육청 경기도김포교육지원청 김포한가람초등학교,18,18,0,18,0,18,0,0
교육기관,교육부,김포호수초등학교,교육부 경기도교육청 경기도김포교육지원청 김포호수초등학교,21,21,0,21,19,2,0,0
교육기관,교육부,나래중학교,교육부 경기도교육청 경기도김포교육지원청 나래중학교,20,19,1,19,19,0,0,0
교육기관,교육부,나비초등학교,교육부 경기도교육청 경기도김포교육지원청 나비초등학교,14,14,0,14,12,2,0,0
교육기관,교육부,다사랑유치원,교육부 경기도교육청 경기도김포교육지원청 다사랑유치원,29,7,22,7,0,7,0,0
교육기관,교육부,달빛유치원,교육부 경기도교육청 경기도김포교육지원청 달빛유치원,12,12,0,12,6,6,0,0
교육기관,교육부,대곶중학교,교육부 경기도교육청 경기도김포교육지원청 대곶중학교,14,14,0,14,14,0,0,0
교육기관,교육부,대곶초등학교,교육부 경기도교육청 경기도김포교육지원청 대곶초등학교,11,11,0,11,11,0,0,0
교육기관,교육부,마송고등학교,교육부 경기도교육청 경기도김포교육지원청 마송고등학교,25,24,1,24,9,13,2,0
교육기관,교육부,마송중앙초등학교,교육부 경기도교육청 경기도김포교육지원청 마송중앙초등학교,16,16,0,16,16,0,0,0
교육기관,교육부,마송중학교,교육부 경기도교육청 경기도김포교육지원청 마송중학교,13,13,0,13,9,4,0,0
교육기관,교육부,마송초등학교,교육부 경기도교육청 경기도김포교육지원청 마송초등학교,10,10,0,10,10,0,0,0
교육기관,교육부,모담유치원,교육부 경기도교육청 경기도김포교육지원청 모담유치원,10,10,0,10,4,6,0,0
교육기관,교육부,물빛유치원,교육부 경기도교육청 경기도김포교육지원청 물빛유치원,28,8,20,8,6,2,0,0
교육기관,교육부,보름초등학교,교육부 경기도교육청 경기도김포교육지원청 보름초등학교,24,24,0,24,0,24,0,0
교육기관,교육부,분진중학교,교육부 경기도교육청 경기도김포교육지원청 분진중학교,15,15,0,15,15,0,0,0
교육기관,교육부,사우고등학교,교육부 경기도교육청 경기도김포교육지원청 사우고등학교,31,31,0,31,20,11,0,0
교육기관,교육부,사우초등학교,교육부 경기도교육청 경기도김포교육지원청 사우초등학교,24,24,0,24,5,19,0,0
교육기관,교육부,새솔학교,교육부 경기도교육청 경기도김포교육지원청 새솔학교,24,24,0,24,0,24,0,0
교육기관,교육부,샘재유치원,교육부 경기도교육청 경기도김포교육지원청 샘재유치원,17,17,0,17,0,17,0,0
교육기관,교육부,서암초등학교,교육부 경기도교육청 경기도김포교육지원청 서암초등학교,16,16,0,16,12,4,0,0
교육기관,교육부,솔터고등학교,교육부 경기도교육청 경기도김포교육지원청 솔터고등학교,45,45,0,45,10,35,0,0
교육기관,교육부,솔터초등학교,교육부 경기도교육청 경기도김포교육지원청 솔터초등학교,25,25,0,25,14,11,0,0
교육기관,교육부,수남초등학교,교육부 경기도교육청 경기도김포교육지원청 수남초등학교,10,10,0,10,10,0,0,0
교육기관,교육부,신곡초등학교,교육부 경기도교육청 경기도김포교육지원청 신곡초등학교,13,13,0,13,13,0,0,0
교육기관,교육부,신양중학교,교육부 경기도교육청 경기도김포교육지원청 신양중학교,15,15,0,15,11,4,0,0
교육기관,교육부,신양초등학교,교육부 경기도교육청 경기도김포교육지원청 신양초등학교,17,17,0,17,10,7,0,0
교육기관,교육부,아리유치원,교육부 경기도교육청 경기도김포교육지원청 아리유치원,16,16,0,16,4,9,3,0
교육기관,교육부,양곡고등학교,교육부 경기도교육청 경기도김포교육지원청 양곡고등학교,14,10,4,10,0,10,0,0
교육기관,교육부,양곡숲유치원,교육부 경기도교육청 경기도김포교육지원청 양곡숲유치원,16,3,13,3,0,3,0,0
교육기관,교육부,양곡중학교,교육부 경기도교육청 경기도김포교육지원청 양곡중학교,26,26,0,26,0,26,0,0
교육기관,교육부,양곡초등학교,교육부 경기도교육청 경기도김포교육지원청 양곡초등학교,13,13,0,13,13,0,0,0
교육기관,교육부,양도중학교,교육부 경기도교육청 경기도김포교육지원청 양도중학교,36,33,3,33,33,0,0,0
교육기관,교육부,양도초등학교,교육부 경기도교육청 경기도김포교육지원청 양도초등학교,15,15,0,15,12,3,0,0
교육기관,교육부,에릭한유치원,교육부 경기도교육청 경기도김포교육지원청 에릭한유치원,36,36,0,36,0,36,0,0
교육기관,교육부,옹정초등학교,교육부 경기도교육청 경기도김포교육지원청 옹정초등학교,14,14,0,14,14,0,0,0
교육기관,교육부,운양중학교,교육부 경기도교육청 경기도김포교육지원청 운양중학교,15,15,0,15,2,13,0,0
교육기관,교육부,운양초등학교,교육부 경기도교육청 경기도김포교육지원청 운양초등학교,16,16,0,16,16,0,0,0
교육기관,교육부,운유초등학교,교육부 경기도교육청 경기도김포교육지원청 운유초등학교,23,23,0,23,23,0,0,0
교육기관,교육부,월곶초등학교,교육부 경기도교육청 경기도김포교육지원청 월곶초등학교,16,16,0,16,8,8,0,0
교육기관,교육부,유현초등학교,교육부 경기도교육청 경기도김포교육지원청 유현초등학교,26,26,0,26,15,9,1,1
교육기관,교육부,은여울중학교,교육부 경기도교육청 경기도김포교육지원청 은여울중학교,34,34,0,34,34,0,0,0
교육기관,교육부,은여울초등학교,교육부 경기도교육청 경기도김포교육지원청 은여울초등학교,11,11,0,11,0,11,0,0
교육기관,교육부,이든유치원,교육부 경기도교육청 경기도김포교육지원청 이든유치원,27,2,25,2,0,2,0,0
교육기관,교육부,장기고등학교,교육부 경기도교육청 경기도김포교육지원청 장기고등학교,27,27,0,27,0,27,0,0
교육기관,교육부,장기중학교,교육부 경기도교육청 경기도김포교육지원청 장기중학교,16,15,1,15,15,0,0,0
교육기관,교육부,장기초등학교,교육부 경기도교육청 경기도김포교육지원청 장기초등학교,12,12,0,12,6,6,0,0
교육기관,교육부,청수초등학교,교육부 경기도교육청 경기도김포교육지원청 청수초등학교,21,21,0,21,0,21,0,0
교육기관,교육부,통진중학교,교육부 경기도교육청 경기도김포교육지원청 통진중학교,20,20,0,20,10,10,0,0
교육기관,교육부,통진초등학교,교육부 경기도교육청 경기도김포교육지원청 통진초등학교,8,8,0,8,3,5,0,0
교육기관,교육부,푸른솔유치원,교육부 경기도교육청 경기도김포교육지원청 푸른솔유치원,25,11,14,11,3,6,1,1
교육기관,교육부,푸른솔중학교,교육부 경기도교육청 경기도김포교육지원청 푸른솔중학교,20,19,1,19,6,13,0,0
교육기관,교육부,푸른솔초등학교,교육부 경기도교육청 경기도김포교육지원청 푸른솔초등학교,19,19,0,19,19,0,0,0
교육기관,교육부,풍무고등학교,교육부 경기도교육청 경기도김포교육지원청 풍무고등학교,32,29,3,29,8,16,3,2
교육기관,교육부,풍무중학교,교육부 경기도교육청 경기도김포교육지원청 풍무중학교,26,26,0,26,11,11,4,0
교육기관,교육부,하늘빛중학교,교육부 경기도교육청 경기도김포교육지원청 하늘빛중학교,14,13,1,13,4,5,0,4
교육기관,교육부,하늘빛초등학교,교육부 경기도교육청 경기도김포교육지원청 하늘빛초등학교,24,24,0,24,24,0,0,0
교육기관,교육부,하성고등학교,교육부 경기도교육청 경기도김포교육지원청 하성고등학교,60,33,27,33,6,27,0,0
교육기관,교육부,하성중학교,교육부 경기도교육청 경기도김포교육지원청 하성중학교,18,18,0,18,18,0,0,0
교육기관,교육부,하성초등학교,교육부 경기도교육청 경기도김포교육지원청 하성초등학교,15,15,0,15,9,6,0,0
교육기관,교육부,학운초등학교,교육부 경기도교육청 경기도김포교육지원청 학운초등학교,21,21,0,21,6,15,0,0
교육기관,교육부,해솔유치원,교육부 경기도교육청 경기도김포교육지원청 해솔유치원,46,8,38,8,5,3,0,0
교육기관,교육부,향산중학교,교육부 경기도교육청 경기도김포교육지원청 향산중학교,23,21,2,21,8,6,2,5
교육기관,교육부,효성유치원,교육부 경기도교육청 경기도김포교육지원청 효성유치원,15,1,14,1,0,1,0,0
교육기관,교육부,가납초등학교,교육부 경기도교육청 경기도동두천양주교육지원청 가납초등학교,7,7,0,7,3,4,0,0
교육기관,교육부,고암중학교,교육부 경기도교육청 경기도동두천양주교육지원청 고암중학교,36,35,1,35,0,33,1,1
교육기관,교육부,고암초등학교,교육부 경기도교육청 경기도동두천양주교육지원청 고암초등학교,15,15,0,15,0,15,0,0
교육기관,교육부,광사초등학교,교육부 경기도교육청 경기도동두천양주교육지원청 광사초등학교,18,18,0,18,18,0,0,0
교육기관,교육부,광숭초등학교,교육부 경기도교육청 경기도동두천양주교육지원청 광숭초등학교,14,14,0,14,0,14,0,0
교육기관,교육부,남면초등학교,교육부 경기도교육청 경기도동두천양주교육지원청 남면초등학교,15,15,0,15,8,7,0,0
교육기관,교육부,남면초등학교양덕분교장,교육부 경기도교육청 경기도동두천양주교육지원청 남면초등학교양덕분교장,13,13,0,13,0,13,0,0
교육기관,교육부,남문중학교,교육부 경기도교육청 경기도동두천양주교육지원청 남문중학교,16,16,0,16,8,8,0,0
교육기관,교육부,덕계고등학교,교육부 경기도교육청 경기도동두천양주교육지원청 덕계고등학교,76,76,0,76,10,66,0,0
교육기관,교육부,덕계중학교,교육부 경기도교육청 경기도동두천양주교육지원청 덕계중학교,17,17,0,17,2,15,0,0
교육기관,교육부,덕계초등학교,교육부 경기도교육청 경기도동두천양주교육지원청 덕계초등학교,25,25,0,25,24,1,0,0
교육기관,교육부,덕도초등학교,교육부 경기도교육청 경기도동두천양주교육지원청 덕도초등학교,12,12,0,12,10,2,0,0
교육기관,교육부,덕정고등학교,교육부 경기도교육청 경기도동두천양주교육지원청 덕정고등학교,55,55,0,55,25,30,0,0
교육기관,교육부,덕정중학교,교육부 경기도교육청 경기도동두천양주교육지원청 덕정중학교,37,37,0,37,23,14,0,0
교육기관,교육부,덕정초등학교,교육부 경기도교육청 경기도동두천양주교육지원청 덕정초등학교,12,12,0,12,12,0,0,0
교육기관,교육부,덕현고등학교,교육부 경기도교육청 경기도동두천양주교육지원청 덕현고등학교,24,22,2,22,0,22,0,0
교육기관,교육부,덕현중학교,교육부 경기도교육청 경기도동두천양주교육지원청 덕현중학교,67,67,0,67,0,67,0,0
교육기관,교육부,도둔초등학교,교육부 경기도교육청 경기도동두천양주교육지원청 도둔초등학교,11,11,0,11,11,0,0,0
교육기관,교육부,동두천고등학교,교육부 경기도교육청 경기도동두천양주교육지원청 동두천고등학교,21,21,0,21,0,21,0,0
교육기관,교육부,동두천사동유치원,교육부 경기도교육청 경기도동두천양주교육지원청 동두천사동유치원,19,0,19,0,0,0,0,0
교육기관,교육부,동두천송내초등학교,교육부 경기도교육청 경기도동두천양주교육지원청 동두천송내초등학교,10,10,0,10,10,0,0,0
교육기관,교육부,동두천신천초등학교,교육부 경기도교육청 경기도동두천양주교육지원청 동두천신천초등학교,9,9,0,9,5,4,0,0
교육기관,교육부,동두천여자중학교,교육부 경기도교육청 경기도동두천양주교육지원청 동두천여자중학교,10,10,0,10,0,10,0,0
교육기관,교육부,동두천외국어고등학교,교육부 경기도교육청 경기도동두천양주교육지원청 동두천외국어고등학교,50,48,2,48,0,48,0,0
교육기관,교육부,동두천중앙고등학교,교육부 경기도교육청 경기도동두천양주교육지원청 동두천중앙고등학교,45,41,4,41,37,2,1,1
교육기관,교육부,동두천중학교,교육부 경기도교육청 경기도동두천양주교육지원청 동두천중학교,50,48,2,48,48,0,0,0
교육기관,교육부,동두천초등학교,교육부 경기도교육청 경기도동두천양주교육지원청 동두천초등학교,17,17,0,17,7,10,0,0
교육기관,교육부,동보초등학교,교육부 경기도교육청 경기도동두천양주교육지원청 동보초등학교,11,11,0,11,10,1,0,0
교육기관,교육부,만송초등학교,교육부 경기도교육청 경기도동두천양주교육지원청 만송초등학교,21,21,0,21,0,21,0,0
교육기관,교육부,보산초등학교,교육부 경기도교육청 경기도동두천양주교육지원청 보산초등학교,12,12,0,12,5,5,0,2
교육기관,교육부,보영여자고등학교,교육부 경기도교육청 경기도동두천양주교육지원청 보영여자고등학교,44,44,0,44,13,31,0,0
교육기관,교육부,봉암초등학교,교육부 경기도교육청 경기도동두천양주교육지원청 봉암초등학교,11,11,0,11,7,4,0,0
교육기관,교육부,사동초등학교,교육부 경기도교육청 경기도동두천양주교육지원청 사동초등학교,20,20,0,20,20,0,0,0
교육기관,교육부,산북초등학교,교육부 경기도교육청 경기도동두천양주교육지원청 산북초등학교,10,10,0,10,10,0,0,0
교육기관,교육부,삼상초등학교,교육부 경기도교육청 경기도동두천양주교육지원청 삼상초등학교,10,10,0,10,10,0,0,0
교육기관,교육부,삼숭중학교,교육부 경기도교육청 경기도동두천양주교육지원청 삼숭중학교,63,61,2,61,23,38,0,0
교육기관,교육부,삼숭초등학교,교육부 경기도교육청 경기도동두천양주교육지원청 삼숭초등학교,17,17,0,17,17,0,0,0
교육기관,교육부,상수초등학교,교육부 경기도교육청 경기도동두천양주교육지원청 상수초등학교,14,14,0,14,2,12,0,0
교육기관,교육부,상패초등학교,교육부 경기도교육청 경기도동두천양주교육지원청 상패초등학교,16,16,0,16,8,8,0,0
교육기관,교육부,생연중학교,교육부 경기도교육청 경기도동두천양주교육지원청 생연중학교,36,36,0,36,36,0,0,0
교육기관,교육부,생연초등학교,교육부 경기도교육청 경기도동두천양주교육지원청 생연초등학교,8,8,0,8,6,2,0,0
교육기관,교육부,소요초등학교,교육부 경기도교육청 경기도동두천양주교육지원청 소요초등학교,8,8,0,8,4,4,0,0
교육기관,교육부,송내중앙중학교,교육부 경기도교육청 경기도동두천양주교육지원청 송내중앙중학교,31,30,1,30,20,10,0,0
교육기관,교육부,송랑유치원,교육부 경기도교육청 경기도동두천양주교육지원청 송랑유치원,10,10,0,10,8,2,0,0
교육기관,교육부,송추초등학교,교육부 경기도교육청 경기도동두천양주교육지원청 송추초등학교,14,14,0,14,11,3,0,0
교육기관,교육부,쉐마기독학교,교육부 경기도교육청 경기도동두천양주교육지원청 쉐마기독학교,49,49,0,49,35,13,0,1
교육기관,교육부,신지초등학교,교육부 경기도교육청 경기도동두천양주교육지원청 신지초등학교,12,12,0,12,6,6,0,0
교육기관,교육부,신흥고등학교,교육부 경기도교육청 경기도동두천양주교육지원청 신흥고등학교,9,9,0,9,3,3,2,1
교육기관,교육부,신흥중학교,교육부 경기도교육청 경기도동두천양주교육지원청 신흥중학교,8,8,0,8,8,0,0,0
교육기관,교육부,양주고등학교,교육부 경기도교육청 경기도동두천양주교육지원청 양주고등학교,56,54,2,54,0,54,0,0
교육기관,교육부,양주덕산초등학교,교육부 경기도교육청 경기도동두천양주교육지원청 양주덕산초등학교,22,22,0,22,11,11,0,0
교육기관,교육부,양주덕현초등학교,교육부 경기도교육청 경기도동두천양주교육지원청 양주덕현초등학교,17,17,0,17,0,17,0,0
교육기관,교육부,양주도담학교,교육부 경기도교육청 경기도동두천양주교육지원청 양주도담학교,69,19,50,19,8,7,2,2
교육기관,교육부,양주백석고등학교,교육부 경기도교육청 경기도동두천양주교육지원청 양주백석고등학교,86,85,1,85,49,36,0,0
교육기관,교육부,양주백석중학교,교육부 경기도교육청 경기도동두천양주교육지원청 양주백석중학교,33,33,0,33,13,19,1,0
교육기관,교육부,양주백석초등학교,교육부 경기도교육청 경기도동두천양주교육지원청 양주백석초등학교,14,14,0,14,12,2,0,0
교육기관,교육부,양주유치원,교육부 경기도교육청 경기도동두천양주교육지원청 양주유치원,42,42,0,42,0,42,0,0
교육기관,교육부,연곡초등학교,교육부 경기도교육청 경기도동두천양주교육지원청 연곡초등학교,14,14,0,14,6,8,0,0
교육기관,교육부,연푸른초등학교,교육부 경기도교육청 경기도동두천양주교육지원청 연푸른초등학교,0,0,0,0,0,0,0,0
교육기관,교육부,옥빛고등학교,교육부 경기도교육청 경기도동두천양주교육지원청 옥빛고등학교,54,54,0,54,43,11,0,0
교육기관,교육부,옥빛중학교,교육부 경기도교육청 경기도동두천양주교육지원청 옥빛중학교,39,39,0,39,0,39,0,0
교육기관,교육부,옥빛초등학교,교육부 경기도교육청 경기도동두천양주교육지원청 옥빛초등학교,30,30,0,30,12,18,0,0
교육기관,교육부,옥정고등학교,교육부 경기도교육청 경기도동두천양주교육지원청 옥정고등학교,36,36,0,36,0,36,0,0
교육기관,교육부,옥정중학교,교육부 경기도교육청 경기도동두천양주교육지원청 옥정중학교,38,7,31,7,0,7,0,0
교육기관,교육부,옥정초등학교,교육부 경기도교육청 경기도동두천양주교육지원청 옥정초등학교,20,20,0,20,3,17,0,0
교육기관,교육부,유양초등학교,교육부 경기도교육청 경기도동두천양주교육지원청 유양초등학교,14,14,0,14,0,14,0,0
교육기관,교육부,율빛초등학교,교육부 경기도교육청 경기도동두천양주교육지원청 율빛초등학교,15,15,0,15,15,0,0,0
교육기관,교육부,율정초등학교,교육부 경기도교육청 경기도동두천양주교육지원청 율정초등학교,16,16,0,16,2,14,0,0
교육기관,교육부,은봉초등학교,교육부 경기도교육청 경기도동두천양주교육지원청 은봉초등학교,19,19,0,19,10,9,0,0
교육기관,교육부,은현초등학교,교육부 경기도교육청 경기도동두천양주교육지원청 은현초등학교,8,8,0,8,0,8,0,0
교육기관,교육부,이담초등학교,교육부 경기도교육청 경기도동두천양주교육지원청 이담초등학교,19,19,0,19,7,6,6,0
교육기관,교육부,조양중학교,교육부 경기도교육청 경기도동두천양주교육지원청 조양중학교,10,9,1,9,0,9,0,0
교육기관,교육부,주원초등학교,교육부 경기도교육청 경기도동두천양주교육지원청 주원초등학교,12,12,0,12,0,12,0,0
교육기관,교육부,지행초등학교,교육부 경기도교육청 경기도동두천양주교육지원청 지행초등학교,11,11,0,11,11,0,0,0
교육기관,교육부,천보초등학교,교육부 경기도교육청 경기도동두천양주교육지원청 천보초등학교,19,19,0,19,9,10,0,0
교육기관,교육부,칠봉초등학교,교육부 경기도교육청 경기도동두천양주교육지원청 칠봉초등학교,18,18,0,18,12,6,0,0
교육기관,교육부,탑동초등학교,교육부 경기도교육청 경기도동두천양주교육지원청 탑동초등학교,12,12,0,12,0,12,0,0
교육기관,교육부,한국문화영상고등학교,교육부 경기도교육청 경기도동두천양주교육지원청 한국문화영상고등학교,22,22,0,22,19,3,0,0
교육기관,교육부,한국외식과학고등학교,교육부 경기도교육청 경기도동두천양주교육지원청 한국외식과학고등학교,42,42,0,42,31,11,0,0
교육기관,교육부,한빛누리중학교,교육부 경기도교육청 경기도동두천양주교육지원청 한빛누리중학교,27,27,0,27,27,0,0,0
교육기관,교육부,회정초등학교,교육부 경기도교육청 경기도동두천양주교육지원청 회정초등학교,10,10,0,10,10,0,0,0
교육기관,교육부,회천중학교,교육부 경기도교육청 경기도동두천양주교육지원청 회천중학교,23,23,0,23,0,23,0,0
교육기관,교육부,회천초등학교,교육부 경기도교육청 경기도동두천양주교육지원청 회천초등학교,8,8,0,8,8,0,0,0
교육기관,교육부,효촌초등학교,교육부 경기도교육청 경기도동두천양주교육지원청 효촌초등학교,23,23,0,23,1,22,0,0
교육기관,교육부,경기경영고등학교,교육부 경기도교육청 경기도부천교육지원청 경기경영고등학교,21,21,0,21,0,21,0,0
교육기관,교육부,경기국제통상고등학교,교육부 경기도교육청 경기도부천교육지원청 경기국제통상고등학교,33,32,1,32,9,14,8,1
교육기관,교육부,경기예술고등학교,교육부 경기도교육청 경기도부천교육지원청 경기예술고등학교,33,33,0,33,7,26,0,0
교육기관,교육부,계남고등학교,교육부 경기도교육청 경기도부천교육지원청 계남고등학교,14,14,0,14,14,0,0,0
교육기관,교육부,계남중학교,교육부 경기도교육청 경기도부천교육지원청 계남중학교,8,7,1,7,0,7,0,0
교육기관,교육부,계남초등학교,교육부 경기도교육청 경기도부천교육지원청 계남초등학교,16,16,0,16,16,0,0,0
교육기관,교육부,고강초등학교,교육부 경기도교육청 경기도부천교육지원청 고강초등학교,9,9,0,9,9,0,0,0
교육기관,교육부,고리울초등학교,교육부 경기도교육청 경기도부천교육지원청 고리울초등학교,20,20,0,20,20,0,0,0
교육기관,교육부,까치울중학교,교육부 경기도교육청 경기도부천교육지원청 까치울중학교,19,19,0,19,9,10,0,0
교육기관,교육부,까치울초등학교,교육부 경기도교육청 경기도부천교육지원청 까치울초등학교,8,8,0,8,8,0,0,0
교육기관,교육부,꿈길유치원,교육부 경기도교육청 경기도부천교육지원청 꿈길유치원,11,11,0,11,0,11,0,0
교육기관,교육부,내동중학교,교육부 경기도교육청 경기도부천교육지원청 내동중학교,11,10,1,10,5,5,0,0
교육기관,교육부,덕산중학교,교육부 경기도교육청 경기도부천교육지원청 덕산중학교,19,19,0,19,10,9,0,0
교육기관,교육부,도당고등학교,교육부 경기도교육청 경기도부천교육지원청 도당고등학교,14,14,0,14,2,12,0,0
교육기관,교육부,도당중학교,교육부 경기도교육청 경기도부천교육지원청 도당중학교,35,20,15,20,20,0,0,0
교육기관,교육부,도당초등학교,교육부 경기도교육청 경기도부천교육지원청 도당초등학교,17,17,0,17,0,17,0,0
교육기관,교육부,도원초등학교,교육부 경기도교육청 경기도부천교육지원청 도원초등학교,8,8,0,8,6,2,0,0
교육기관,교육부,동곡초등학교,교육부 경기도교육청 경기도부천교육지원청 동곡초등학교,16,16,0,16,12,4,0,0
교육기관,교육부,동산초등학교,교육부 경기도교육청 경기도부천교육지원청 동산초등학교,20,20,0,20,20,0,0,0
교육기관,교육부,동원유치원,교육부 경기도교육청 경기도부천교육지원청 동원유치원,16,16,0,16,0,16,0,0
교육기관,교육부,목화유치원,교육부 경기도교육청 경기도부천교육지원청 목화유치원,11,11,0,11,1,10,0,0
교육기관,교육부,민영유치원,교육부 경기도교육청 경기도부천교육지원청 민영유치원,12,1,11,1,0,1,0,0
교육기관,교육부,백조유치원,교육부 경기도교육청 경기도부천교육지원청 백조유치원,12,12,0,12,0,12,0,0
교육기관,교육부,범박고등학교,교육부 경기도교육청 경기도부천교육지원청 범박고등학교,54,54,0,54,0,54,0,0
교육기관,교육부,범박중학교,교육부 경기도교육청 경기도부천교육지원청 범박중학교,19,10,9,10,5,5,0,0
교육기관,교육부,범박초등학교,교육부 경기도교육청 경기도부천교육지원청 범박초등학교,22,22,0,22,4,16,1,1
교육기관,교육부,복사초등학교,교육부 경기도교육청 경기도부천교육지원청 복사초등학교,11,11,0,11,7,4,0,0
교육기관,교육부,부광초등학교,교육부 경기도교육청 경기도부천교육지원청 부광초등학교,14,14,0,14,14,0,0,0
교육기관,교육부,부명고등학교,교육부 경기도교육청 경기도부천교육지원청 부명고등학교,15,15,0,15,15,0,0,0
교육기관,교육부,부명중학교,교육부 경기도교육청 경기도부천교육지원청 부명중학교,14,13,1,13,0,9,1,3
교육기관,교육부,부명초등학교,교육부 경기도교육청 경기도부천교육지원청 부명초등학교,14,14,0,14,14,0,0,0
교육기관,교육부,부원초등학교,교육부 경기도교육청 경기도부천교육지원청 부원초등학교,24,24,0,24,0,24,0,0
교육기관,교육부,부인중학교,교육부 경기도교육청 경기도부천교육지원청 부인중학교,23,23,0,23,0,23,0,0
교육기관,교육부,부인초등학교,교육부 경기도교육청 경기도부천교육지원청 부인초등학교,7,7,0,7,4,1,1,1
교육기관,교육부,부일중학교,교육부 경기도교육청 경기도부천교육지원청 부일중학교,9,9,0,9,4,5,0,0
교육기관,교육부,부일초등학교,교육부 경기도교육청 경기도부천교육지원청 부일초등학교,13,13,0,13,0,13,0,0
교육기관,교육부,부천고등학교,교육부 경기도교육청 경기도부천교육지원청 부천고등학교,33,30,3,30,9,18,2,1
교육기관,교육부,부천공업고등학교,교육부 경기도교육청 경기도부천교육지원청 부천공업고등학교,28,28,0,28,0,28,0,0
교육기관,교육부,부천남중학교,교육부 경기도교육청 경기도부천교육지원청 부천남중학교,16,16,0,16,16,0,0,0
교육기관,교육부,부천남초등학교,교육부 경기도교육청 경기도부천교육지원청 부천남초등학교,24,24,0,24,16,8,0,0
교육기관,교육부,부천대명초등학교,교육부 경기도교육청 경기도부천교육지원청 부천대명초등학교,15,15,0,15,11,4,0,0
교육기관,교육부,부천덕산초등학교,교육부 경기도교육청 경기도부천교육지원청 부천덕산초등학교,17,17,0,17,11,6,0,0
교육기관,교육부,부천동여자중학교,교육부 경기도교육청 경기도부천교육지원청 부천동여자중학교,7,5,2,5,5,0,0,0
교육기관,교육부,부천동중학교,교육부 경기도교육청 경기도부천교육지원청 부천동중학교,8,8,0,8,8,0,0,0
교육기관,교육부,부천동초등학교,교육부 경기도교육청 경기도부천교육지원청 부천동초등학교,15,15,0,15,0,15,0,0
교육기관,교육부,부천두리유치원,교육부 경기도교육청 경기도부천교육지원청 부천두리유치원,13,2,11,2,0,2,0,0
교육기관,교육부,부천부곡중학교,교육부 경기도교육청 경기도부천교육지원청 부천부곡중학교,10,10,0,10,10,0,0,0
교육기관,교육부,부천부곡초등학교,교육부 경기도교육청 경기도부천교육지원청 부천부곡초등학교,16,16,0,16,0,16,0,0
교육기관,교육부,부천부안초등학교,교육부 경기도교육청 경기도부천교육지원청 부천부안초등학교,15,15,0,15,0,11,4,0
교육기관,교육부,부천부흥중학교,교육부 경기도교육청 경기도부천교육지원청 부천부흥중학교,17,16,1,16,8,8,0,0
교육기관,교육부,부천부흥초등학교,교육부 경기도교육청 경기도부천교육지원청 부천부흥초등학교,10,10,0,10,10,0,0,0
교육기관,교육부,부천북고등학교,교육부 경기도교육청 경기도부천교육지원청 부천북고등학교,12,12,0,12,9,3,0,0
교육기관,교육부,부천북초등학교,교육부 경기도교육청 경기도부천교육지원청 부천북초등학교,18,18,0,18,9,5,2,2
교육기관,교육부,부천삼정초등학교,교육부 경기도교육청 경기도부천교육지원청 부천삼정초등학교,12,12,0,12,12,0,0,0
교육기관,교육부,부천송일초등학교,교육부 경기도교육청 경기도부천교육지원청 부천송일초등학교,20,20,0,20,17,3,0,0
교육기관,교육부,부천수주초등학교,교육부 경기도교육청 경기도부천교육지원청 부천수주초등학교,6,6,0,6,5,1,0,0
교육기관,교육부,부천신흥초등학교,교육부 경기도교육청 경기도부천교육지원청 부천신흥초등학교,23,23,0,23,23,0,0,0
교육기관,교육부,부천실업고등학교,교육부 경기도교육청 경기도부천교육지원청 부천실업고등학교,2,2,0,2,1,1,0,0
교육기관,교육부,부천양지초등학교,교육부 경기도교육청 경기도부천교육지원청 부천양지초등학교,14,14,0,14,0,14,0,0
교육기관,교육부,부천여월중학교,교육부 경기도교육청 경기도부천교육지원청 부천여월중학교,21,21,0,21,21,0,0,0
교육기관,교육부,부천여월초등학교,교육부 경기도교육청 경기도부천교육지원청 부천여월초등학교,18,18,0,18,12,6,0,0
교육기관,교육부,부천여자고등학교,교육부 경기도교육청 경기도부천교육지원청 부천여자고등학교,8,8,0,8,4,4,0,0
교육기관,교육부,부천여자중학교,교육부 경기도교육청 경기도부천교육지원청 부천여자중학교,18,18,0,18,4,11,3,0
교육기관,교육부,부천역곡초등학교,교육부 경기도교육청 경기도부천교육지원청 부천역곡초등학교,9,9,0,9,0,7,2,0
교육기관,교육부,부천원일초등학교,교육부 경기도교육청 경기도부천교육지원청 부천원일초등학교,15,15,0,15,0,15,0,0
교육기관,교육부,부천일신중학교,교육부 경기도교육청 경기도부천교육지원청 부천일신중학교,34,34,0,34,0,34,0,0
교육기관,교육부,부천일신초등학교,교육부 경기도교육청 경기도부천교육지원청 부천일신초등학교,16,16,0,16,0,16,0,0
교육기관,교육부,부천정보산업고등학교,교육부 경기도교육청 경기도부천교육지원청 부천정보산업고등학교,13,13,0,13,1,12,0,0
교육기관,교육부,부천중앙초등학교,교육부 경기도교육청 경기도부천교육지원청 부천중앙초등학교,13,13,0,13,13,0,0,0
교육기관,교육부,부천중원초등학교,교육부 경기도교육청 경기도부천교육지원청 부천중원초등학교,9,9,0,9,3,6,0,0
교육기관,교육부,부천중학교,교육부 경기도교육청 경기도부천교육지원청 부천중학교,15,11,4,11,10,1,0,0
교육기관,교육부,부천초등학교,교육부 경기도교육청 경기도부천교육지원청 부천초등학교,12,12,0,12,8,4,0,0
교육기관,교육부,부천혜림학교,교육부 경기도교육청 경기도부천교육지원청 부천혜림학교,21,21,0,21,21,0,0,0
교육기관,교육부,상도중학교,교육부 경기도교육청 경기도부천교육지원청 상도중학교,22,21,1,21,14,7,0,0
교육기관,교육부,상동중학교,교육부 경기도교육청 경기도부천교육지원청 상동중학교,24,24,0,24,12,12,0,0
교육기관,교육부,상동초등학교,교육부 경기도교육청 경기도부천교육지원청 상동초등학교,20,20,0,20,20,0,0,0
교육기관,교육부,상미초등학교,교육부 경기도교육청 경기도부천교육지원청 상미초등학교,17,13,4,13,13,0,0,0
교육기관,교육부,상원고등학교,교육부 경기도교육청 경기도부천교육지원청 상원고등학교,32,32,0,32,11,21,0,0
교육기관,교육부,상원초등학교,교육부 경기도교육청 경기도부천교육지원청 상원초등학교,12,12,0,12,12,0,0,0
교육기관,교육부,상인초등학교,교육부 경기도교육청 경기도부천교육지원청 상인초등학교,13,13,0,13,0,13,0,0
교육기관,교육부,상일고등학교,교육부 경기도교육청 경기도부천교육지원청 상일고등학교,43,43,0,43,13,30,0,0
교육기관,교육부,상일중학교,교육부 경기도교육청 경기도부천교육지원청 상일중학교,25,24,1,24,24,0,0,0
교육기관,교육부,상일초등학교,교육부 경기도교육청 경기도부천교육지원청 상일초등학교,8,8,0,8,0,8,0,0
교육기관,교육부,상지초등학교,교육부 경기도교육청 경기도부천교육지원청 상지초등학교,9,9,0,9,0,9,0,0
교육기관,교육부,새싹유치원,교육부 경기도교육청 경기도부천교육지원청 새싹유치원,16,16,0,16,16,0,0,0
교육기관,교육부,샘솔유치원,교육부 경기도교육청 경기도부천교육지원청 샘솔유치원,16,16,0,16,0,16,0,0
교육기관,교육부,석천중학교,교육부 경기도교육청 경기도부천교육지원청 석천중학교,17,15,2,15,14,1,0,0
교육기관,교육부,석천초등학교,교육부 경기도교육청 경기도부천교육지원청 석천초등학교,15,15,0,15,15,0,0,0
교육기관,교육부,성가정유치원,교육부 경기도교육청 경기도부천교육지원청 성가정유치원,16,16,0,16,16,0,0,0
교육기관,교육부,성곡중학교,교육부 경기도교육청 경기도부천교육지원청 성곡중학교,18,18,0,18,12,6,0,0
교육기관,교육부,성곡초등학교,교육부 경기도교육청 경기도부천교육지원청 성곡초등학교,12,12,0,12,12,0,0,0
교육기관,교육부,성주중학교,교육부 경기도교육청 경기도부천교육지원청 성주중학교,14,14,0,14,0,14,0,0
교육기관,교육부,성주초등학교,교육부 경기도교육청 경기도부천교육지원청 성주초등학교,28,28,0,28,28,0,0,0
교육기관,교육부,소명여자고등학교,교육부 경기도교육청 경기도부천교육지원청 소명여자고등학교,24,19,5,19,0,19,0,0
교육기관,교육부,소명여자중학교,교육부 경기도교육청 경기도부천교육지원청 소명여자중학교,14,14,0,14,14,0,0,0
교육기관,교육부,소사고등학교,교육부 경기도교육청 경기도부천교육지원청 소사고등학교,16,15,1,15,1,12,0,2
교육기관,교육부,소사중학교,교육부 경기도교육청 경기도부천교육지원청 소사중학교,40,40,0,40,11,29,0,0
교육기관,교육부,소사초등학교,교육부 경기도교육청 경기도부천교육지원청 소사초등학교,9,9,0,9,9,0,0,0
교육기관,교육부,소새울유치원,교육부 경기도교육청 경기도부천교육지원청 소새울유치원,19,8,11,8,5,3,0,0
교육기관,교육부,소안초등학교,교육부 경기도교육청 경기도부천교육지원청 소안초등학교,12,12,0,12,12,0,0,0
교육기관,교육부,소일초등학교,교육부 경기도교육청 경기도부천교육지원청 소일초등학교,12,12,0,12,12,0,0,0
교육기관,교육부,소화유치원,교육부 경기도교육청 경기도부천교육지원청 소화유치원,12,12,0,12,10,2,0,0
교육기관,교육부,솔안초등학교,교육부 경기도교육청 경기도부천교육지원청 솔안초등학교,15,15,0,15,15,0,0,0
교육기관,교육부,송내고등학교,교육부 경기도교육청 경기도부천교육지원청 송내고등학교,21,20,1,20,5,13,1,1
교육기관,교육부,송내초등학교,교육부 경기도교육청 경기도부천교육지원청 송내초등학교,9,9,0,9,0,9,0,0
교육기관,교육부,수주고등학교,교육부 경기도교육청 경기도부천교육지원청 수주고등학교,29,16,13,16,4,10,1,1
교육기관,교육부,수주중학교,교육부 경기도교육청 경기도부천교육지원청 수주중학교,33,33,0,33,20,13,0,0
교육기관,교육부,신도초등학교,교육부 경기도교육청 경기도부천교육지원청 신도초등학교,9,9,0,9,4,5,0,0
교육기관,교육부,심곡초등학교,교육부 경기도교육청 경기도부천교육지원청 심곡초등학교,22,22,0,22,8,10,4,0
교육기관,교육부,심원고등학교,교육부 경기도교육청 경기도부천교육지원청 심원고등학교,21,21,0,21,21,0,0,0
교육기관,교육부,심원중학교,교육부 경기도교육청 경기도부천교육지원청 심원중학교,16,16,0,16,0,16,0,0
교육기관,교육부,심원초등학교,교육부 경기도교육청 경기도부천교육지원청 심원초등학교,22,22,0,22,22,0,0,0
교육기관,교육부,약대초등학교,교육부 경기도교육청 경기도부천교육지원청 약대초등학교,8,8,0,8,4,4,0,0
교육기관,교육부,역곡고등학교,교육부 경기도교육청 경기도부천교육지원청 역곡고등학교,16,16,0,16,8,8,0,0
교육기관,교육부,역곡중학교,교육부 경기도교육청 경기도부천교육지원청 역곡중학교,27,27,0,27,9,18,0,0
교육기관,교육부,예일유치원,교육부 경기도교육청 경기도부천교육지원청 예일유치원,33,0,33,0,0,0,0,0
교육기관,교육부,오정초등학교,교육부 경기도교육청 경기도부천교육지원청 오정초등학교,16,16,0,16,16,0,0,0
교육기관,교육부,옥길버들초등학교,교육부 경기도교육청 경기도부천교육지원청 옥길버들초등학교,18,18,0,18,0,18,0,0
교육기관,교육부,옥길산들초등학교,교육부 경기도교육청 경기도부천교육지원청 옥길산들초등학교,24,24,0,24,4,18,0,2
교육기관,교육부,옥길유치원,교육부 경기도교육청 경기도부천교육지원청 옥길유치원,32,32,0,32,7,25,0,0
교육기관,교육부,옥길중학교,교육부 경기도교육청 경기도부천교육지원청 옥길중학교,19,19,0,19,19,0,0,0
교육기관,교육부,옥산초등학교,교육부 경기도교육청 경기도부천교육지원청 옥산초등학교,9,7,2,7,7,0,0,0
교육기관,교육부,원미고등학교,교육부 경기도교육청 경기도부천교육지원청 원미고등학교,25,25,0,25,5,20,0,0
교육기관,교육부,원미중학교,교육부 경기도교육청 경기도부천교육지원청 원미중학교,29,29,0,29,8,21,0,0
교육기관,교육부,원미초등학교,교육부 경기도교육청 경기도부천교육지원청 원미초등학교,25,25,0,25,25,0,0,0
교육기관,교육부,원종고등학교,교육부 경기도교육청 경기도부천교육지원청 원종고등학교,14,14,0,14,8,5,1,0
교육기관,교육부,원종초등학교,교육부 경기도교육청 경기도부천교육지원청 원종초등학교,9,9,0,9,0,9,0,0
교육기관,교육부,정명고등학교,교육부 경기도교육청 경기도부천교육지원청 정명고등학교,38,38,0,38,5,32,1,0
교육기관,교육부,중동초등학교,교육부 경기도교육청 경기도부천교육지원청 중동초등학교,19,19,0,19,19,0,0,0
교육기관,교육부,중원중학교,교육부 경기도교육청 경기도부천교육지원청 중원중학교,20,20,0,20,20,0,0,0
교육기관,교육부,중흥고등학교,교육부 경기도교육청 경기도부천교육지원청 중흥고등학교,28,28,0,28,28,0,0,0
교육기관,교육부,중흥중학교,교육부 경기도교육청 경기도부천교육지원청 중흥중학교,10,10,0,10,6,0,4,0
교육기관,교육부,중흥초등학교,교육부 경기도교육청 경기도부천교육지원청 중흥초등학교,26,26,0,26,0,26,0,0
교육기관,교육부,진영고등학교,교육부 경기도교육청 경기도부천교육지원청 진영고등학교,16,16,0,16,0,16,0,0
교육기관,교육부,창영초등학교,교육부 경기도교육청 경기도부천교육지원청 창영초등학교,16,16,0,16,12,2,2,0
교육기관,교육부,청심유치원,교육부 경기도교육청 경기도부천교육지원청 청심유치원,34,4,30,4,0,4,0,0
교육기관,교육부,푸른솔유치원,교육부 경기도교육청 경기도부천교육지원청 푸른솔유치원,11,11,0,11,3,8,0,0
교육기관,교육부,해와달유치원,교육부 경기도교육청 경기도부천교육지원청 해와달유치원,13,3,10,3,2,1,0,0
교육기관,교육부,혜성유치원,교육부 경기도교육청 경기도부천교육지원청 혜성유치원,9,2,7,2,2,0,0,0
교육기관,교육부,홍지유치원,교육부 경기도교육청 경기도부천교육지원청 홍지유치원,7,1,6,1,1,0,0,0
교육기관,교육부,효성유치원,교육부 경기도교육청 경기도부천교육지원청 효성유치원,24,24,0,24,2,20,1,1
교육기관,교육부,경기도성남교육지원청,교육부 경기도교육청 경기도성남교육지원청,8,8,0,8,5,3,0,0
교육기관,교육부,검단초등학교,교육부 경기도교육청 경기도성남교육지원청 검단초등학교,25,25,0,25,6,19,0,0
교육기관,교육부,계원예술고등학교,교육부 경기도교육청 경기도성남교육지원청 계원예술고등학교,34,32,2,32,0,32,0,0
교육기관,교육부,고등나래유치원,교육부 경기도교육청 경기도성남교육지원청 고등나래유치원,22,22,0,22,10,8,4,0
교육기관,교육부,구미중학교,교육부 경기도교육청 경기도성남교육지원청 구미중학교,16,16,0,16,4,12,0,0
교육기관,교육부,구미초등학교,교육부 경기도교육청 경기도성남교육지원청 구미초등학교,8,8,0,8,8,0,0,0
교육기관,교육부,금광중학교,교육부 경기도교육청 경기도성남교육지원청 금광중학교,10,9,1,9,0,9,0,0
교육기관,교육부,금빛초등학교,교육부 경기도교육청 경기도성남교육지원청 금빛초등학교,42,42,0,42,42,0,0,0
교육기관,교육부,금상초등학교,교육부 경기도교육청 경기도성남교육지원청 금상초등학교,16,16,0,16,5,11,0,0
교육기관,교육부,낙생고등학교,교육부 경기도교육청 경기도성남교육지원청 낙생고등학교,39,39,0,39,39,0,0,0
교육기관,교육부,낙생초등학교,교육부 경기도교육청 경기도성남교육지원청 낙생초등학교,31,31,0,31,6,25,0,0
교육기관,교육부,낙원중학교,교육부 경기도교육청 경기도성남교육지원청 낙원중학교,40,40,0,40,0,40,0,0
교육기관,교육부,내정중학교,교육부 경기도교육청 경기도성남교육지원청 내정중학교,29,29,0,29,29,0,0,0
교육기관,교육부,내정초등학교,교육부 경기도교육청 경기도성남교육지원청 내정초등학교,16,16,0,16,0,16,0,0
교육기관,교육부,늘푸른고등학교,교육부 경기도교육청 경기도성남교육지원청 늘푸른고등학교,68,68,0,68,10,58,0,0
교육기관,교육부,늘푸른중학교,교육부 경기도교육청 경기도성남교육지원청 늘푸른중학교,17,16,1,16,0,16,0,0
교육기관,교육부,늘푸른초등학교,교육부 경기도교육청 경기도성남교육지원청 늘푸른초등학교,9,9,0,9,0,9,0,0
교육기관,교육부,다올유치원,교육부 경기도교육청 경기도성남교육지원청 다올유치원,16,2,14,2,1,1,0,0
교육기관,교육부,단남초등학교,교육부 경기도교육청 경기도성남교육지원청 단남초등학교,19,19,0,19,10,9,0,0
교육기관,교육부,단대초등학교,교육부 경기도교육청 경기도성남교육지원청 단대초등학교,16,16,0,16,13,3,0,0
교육기관,교육부,당촌초등학교,교육부 경기도교육청 경기도성남교육지원청 당촌초등학교,33,33,0,33,0,33,0,0
교육기관,교육부,대원중학교,교육부 경기도교육청 경기도성남교육지원청 대원중학교,29,29,0,29,10,19,0,0
교육기관,교육부,대일초등학교,교육부 경기도교육청 경기도성남교육지원청 대일초등학교,15,15,0,15,3,11,1,0
교육기관,교육부,대하초등학교,교육부 경기도교육청 경기도성남교육지원청 대하초등학교,8,8,0,8,6,2,0,0
교육기관,교육부,도촌유치원,교육부 경기도교육청 경기도성남교육지원청 도촌유치원,6,6,0,6,3,3,0,0
교육기관,교육부,도촌중학교,교육부 경기도교육청 경기도성남교육지원청 도촌중학교,11,10,1,10,6,2,1,1
교육기관,교육부,도촌초등학교,교육부 경기도교육청 경기도성남교육지원청 도촌초등학교,9,9,0,9,5,4,0,0
교육기관,교육부,돌마고등학교,교육부 경기도교육청 경기도성남교육지원청 돌마고등학교,20,20,0,20,0,20,0,0
교육기관,교육부,돌마초등학교,교육부 경기도교육청 경기도성남교육지원청 돌마초등학교,10,10,0,10,10,0,0,0
교육기관,교육부,동광고등학교,교육부 경기도교육청 경기도성남교육지원청 동광고등학교,33,33,0,33,11,22,0,0
교육기관,교육부,동광중학교,교육부 경기도교육청 경기도성남교육지원청 동광중학교,23,23,0,23,12,11,0,0
교육기관,교육부,동명유치원,교육부 경기도교육청 경기도성남교육지원청 동명유치원,39,10,29,10,3,7,0,0
교육기관,교육부,매송중학교,교육부 경기도교육청 경기도성남교육지원청 매송중학교,16,16,0,16,8,8,0,0
교육기관,교육부,문정유치원,교육부 경기도교육청 경기도성남교육지원청 문정유치원,6,6,0,6,3,3,0,0
교육기관,교육부,백현중학교,교육부 경기도교육청 경기도성남교육지원청 백현중학교,42,42,0,42,41,1,0,0
교육기관,교육부,백현초등학교,교육부 경기도교육청 경기도성남교육지원청 백현초등학교,15,15,0,15,2,13,0,0
교육기관,교육부,보평고등학교,교육부 경기도교육청 경기도성남교육지원청 보평고등학교,34,34,0,34,21,13,0,0
교육기관,교육부,보평중학교,교육부 경기도교육청 경기도성남교육지원청 보평중학교,44,44,0,44,18,25,0,1
교육기관,교육부,보평초등학교,교육부 경기도교육청 경기도성남교육지원청 보평초등학교,28,28,0,28,0,28,0,0
교육기관,교육부,복정고등학교,교육부 경기도교육청 경기도성남교육지원청 복정고등학교,28,28,0,28,0,28,0,0
교육기관,교육부,복정초등학교,교육부 경기도교육청 경기도성남교육지원청 복정초등학교,13,13,0,13,9,4,0,0
교육기관,교육부,분당경영고등학교,교육부 경기도교육청 경기도성남교육지원청 분당경영고등학교,26,26,0,26,26,0,0,0
교육기관,교육부,분당고등학교,교육부 경기도교육청 경기도성남교육지원청 분당고등학교,30,30,0,30,30,0,0,0
교육기관,교육부,분당대진고등학교,교육부 경기도교육청 경기도성남교육지원청 분당대진고등학교,72,15,57,15,15,0,0,0
교육기관,교육부,분당성모유치원,교육부 경기도교육청 경기도성남교육지원청 분당성모유치원,20,20,0,20,0,20,0,0
교육기관,교육부,분당영덕여자고등학교,교육부 경기도교육청 경기도성남교육지원청 분당영덕여자고등학교,25,25,0,25,20,5,0,0
교육기관,교육부,분당중앙고등학교,교육부 경기도교육청 경기도성남교육지원청 분당중앙고등학교,29,28,1,28,28,0,0,0
교육기관,교육부,분당중앙유치원,교육부 경기도교육청 경기도성남교육지원청 분당중앙유치원,14,3,11,3,3,0,0,0
교육기관,교육부,분당초등학교,교육부 경기도교육청 경기도성남교육지원청 분당초등학교,29,29,0,29,29,0,0,0
교육기관,교육부,불곡고등학교,교육부 경기도교육청 경기도성남교육지원청 불곡고등학교,16,11,5,11,9,1,1,0
교육기관,교육부,불곡중학교,교육부 경기도교육청 경기도성남교육지원청 불곡중학교,24,24,0,24,0,24,0,0
교육기관,교육부,불곡초등학교,교육부 경기도교육청 경기도성남교육지원청 불곡초등학교,8,8,0,8,8,0,0,0
교육기관,교육부,산운유치원,교육부 경기도교육청 경기도성남교육지원청 산운유치원,4,4,0,4,2,2,0,0
교육기관,교육부,산운초등학교,교육부 경기도교육청 경기도성남교육지원청 산운초등학교,18,18,0,18,0,18,0,0
교육기관,교육부,삼육유치원,교육부 경기도교육청 경기도성남교육지원청 삼육유치원,10,4,6,4,2,2,0,0
교육기관,교육부,삼평유치원,교육부 경기도교육청 경기도성남교육지원청 삼평유치원,8,8,0,8,0,8,0,0
교육기관,교육부,삼평중학교,교육부 경기도교육청 경기도성남교육지원청 삼평중학교,16,16,0,16,2,12,2,0
교육기관,교육부,상대원초등학교,교육부 경기도교육청 경기도성남교육지원청 상대원초등학교,21,21,0,21,0,21,0,0
교육기관,교육부,상원여자중학교,교육부 경기도교육청 경기도성남교육지원청 상원여자중학교,25,17,8,17,3,12,2,0
교육기관,교육부,상원초등학교,교육부 경기도교육청 경기도성남교육지원청 상원초등학교,21,21,0,21,0,21,0,0
교육기관,교육부,상탑초등학교,교육부 경기도교육청 경기도성남교육지원청 상탑초등학교,19,19,0,19,19,0,0,0
교육기관,교육부,샛별중학교,교육부 경기도교육청 경기도성남교육지원청 샛별중학교,31,31,0,31,18,13,0,0
교육기관,교육부,서당초등학교,교육부 경기도교육청 경기도성남교육지원청 서당초등학교,13,13,0,13,6,7,0,0
교육기관,교육부,서현고등학교,교육부 경기도교육청 경기도성남교육지원청 서현고등학교,39,39,0,39,0,39,0,0
교육기관,교육부,서현중학교,교육부 경기도교육청 경기도성남교육지원청 서현중학교,32,32,0,32,16,16,0,0
교육기관,교육부,서현초등학교,교육부 경기도교육청 경기도성남교육지원청 서현초등학교,24,24,0,24,16,8,0,0
교육기관,교육부,성남고등학교,교육부 경기도교육청 경기도성남교육지원청 성남고등학교,31,31,0,31,17,14,0,0
교육기관,교육부,성남동중학교,교육부 경기도교육청 경기도성남교육지원청 성남동중학교,48,48,0,48,15,33,0,0
교육기관,교육부,성남동초등학교,교육부 경기도교육청 경기도성남교육지원청 성남동초등학교,16,16,0,16,0,16,0,0
교육기관,교육부,성남매송초등학교,교육부 경기도교육청 경기도성남교육지원청 성남매송초등학교,15,15,0,15,15,0,0,0
교육기관,교육부,성남문원중학교,교육부 경기도교육청 경기도성남교육지원청 성남문원중학교,17,16,1,16,8,7,1,0
교육기관,교육부,성남미금초등학교,교육부 경기도교육청 경기도성남교육지원청 성남미금초등학교,16,16,0,16,9,7,0,0
교육기관,교육부,성남서중학교,교육부 경기도교육청 경기도성남교육지원청 성남서중학교,32,32,0,32,20,12,0,0
교육기관,교육부,성남서초등학교,교육부 경기도교육청 경기도성남교육지원청 성남서초등학교,20,20,0,20,0,20,0,0
교육기관,교육부,성남송현초등학교,교육부 경기도교육청 경기도성남교육지원청 성남송현초등학교,19,19,0,19,16,3,0,0
교육기관,교육부,성남수정초등학교,교육부 경기도교육청 경기도성남교육지원청 성남수정초등학교,16,16,0,16,0,16,0,0
교육기관,교육부,성남신기초등학교,교육부 경기도교육청 경기도성남교육지원청 성남신기초등학교,24,24,0,24,24,0,0,0
교육기관,교육부,성남신흥초등학교,교육부 경기도교육청 경기도성남교육지원청 성남신흥초등학교,16,16,0,16,0,16,0,0
교육기관,교육부,성남여수유치원,교육부 경기도교육청 경기도성남교육지원청 성남여수유치원,4,4,0,4,0,4,0,0
교육기관,교육부,성남여수초등학교,교육부 경기도교육청 경기도성남교육지원청 성남여수초등학교,24,24,0,24,24,0,0,0
교육기관,교육부,성남여자고등학교,교육부 경기도교육청 경기도성남교육지원청 성남여자고등학교,22,22,0,22,16,6,0,0
교육기관,교육부,성남여자중학교,교육부 경기도교육청 경기도성남교육지원청 성남여자중학교,8,8,0,8,2,2,2,2
교육기관,교육부,성남은행초등학교,교육부 경기도교육청 경기도성남교육지원청 성남은행초등학교,27,27,0,27,2,25,0,0
교육기관,교육부,성남장안초등학교,교육부 경기도교육청 경기도성남교육지원청 성남장안초등학교,25,25,0,25,0,25,0,0
교육기관,교육부,성남정자초등학교,교육부 경기도교육청 경기도성남교육지원청 성남정자초등학교,29,29,0,29,0,29,0,0
교육기관,교육부,성남제일초등학교,교육부 경기도교육청 경기도성남교육지원청 성남제일초등학교,12,12,0,12,12,0,0,0
교육기관,교육부,성남중앙초등학교,교육부 경기도교육청 경기도성남교육지원청 성남중앙초등학교,11,7,4,7,4,3,0,0
교육기관,교육부,성남중학교,교육부 경기도교육청 경기도성남교육지원청 성남중학교,9,9,0,9,9,0,0,0
교육기관,교육부,성남초등학교,교육부 경기도교육청 경기도성남교육지원청 성남초등학교,27,27,0,27,12,13,1,1
교육기관,교육부,성남테크노과학고등학교,교육부 경기도교육청 경기도성남교육지원청 성남테크노과학고등학교,54,54,0,54,54,0,0,0
교육기관,교육부,성남푸른유치원,교육부 경기도교육청 경기도성남교육지원청 성남푸른유치원,9,9,0,9,3,3,1,2
교육기관,교육부,성남혜은학교,교육부 경기도교육청 경기도성남교육지원청 성남혜은학교,25,25,0,25,0,25,0,0
교육기관,교육부,성남화랑초등학교,교육부 경기도교육청 경기도성남교육지원청 성남화랑초등학교,16,16,0,16,0,16,0,0
교육기관,교육부,성보경영고등학교,교육부 경기도교육청 경기도성남교육지원청 성보경영고등학교,21,21,0,21,21,0,0,0
교육기관,교육부,성수초등학교,교육부 경기도교육청 경기도성남교육지원청 성수초등학교,8,8,0,8,8,0,0,0
교육기관,교육부,성은학교,교육부 경기도교육청 경기도성남교육지원청 성은학교,13,13,0,13,0,13,0,0
교육기관,교육부,성일고등학교,교육부 경기도교육청 경기도성남교육지원청 성일고등학교,45,45,0,45,0,45,0,0
교육기관,교육부,성일정보고등학교,교육부 경기도교육청 경기도성남교육지원청 성일정보고등학교,40,40,0,40,0,40,0,0
교육기관,교육부,성체유치원,교육부 경기도교육청 경기도성남교육지원청 성체유치원,14,0,14,0,0,0,0,0
교육기관,교육부,송림고등학교,교육부 경기도교육청 경기도성남교육지원청 송림고등학교,89,89,0,89,76,13,0,0
교육기관,교육부,송림중학교,교육부 경기도교육청 경기도성남교육지원청 송림중학교,46,46,0,46,0,46,0,0
교육기관,교육부,수내중학교,교육부 경기도교육청 경기도성남교육지원청 수내중학교,37,37,0,37,0,37,0,0
교육기관,교육부,수내초등학교,교육부 경기도교육청 경기도성남교육지원청 수내초등학교,19,13,6,13,13,0,0,0
교육기관,교육부,수진중학교,교육부 경기도교육청 경기도성남교육지원청 수진중학교,23,23,0,23,18,5,0,0
교육기관,교육부,수진초등학교,교육부 경기도교육청 경기도성남교육지원청 수진초등학교,8,8,0,8,0,8,0,0
교육기관,교육부,숭신여자고등학교,교육부 경기도교육청 경기도성남교육지원청 숭신여자고등학교,43,43,0,43,0,43,0,0
교육기관,교육부,숭신여자중학교,교육부 경기도교육청 경기도성남교육지원청 숭신여자중학교,21,21,0,21,1,20,0,0
교육기관,교육부,신구대학교부속유치원,교육부 경기도교육청 경기도성남교육지원청 신구대학교부속유치원,29,11,18,11,0,9,2,0
교육기관,교육부,신백현중학교,교육부 경기도교육청 경기도성남교육지원청 신백현중학교,14,14,0,14,7,7,0,0
교육기관,교육부,신백현초등학교,교육부 경기도교육청 경기도성남교육지원청 신백현초등학교,16,16,0,16,8,8,0,0
교육기관,교육부,신양유치원,교육부 경기도교육청 경기도성남교육지원청 신양유치원,16,0,16,0,0,0,0,0
교육기관,교육부,신흥성모유치원,교육부 경기도교육청 경기도성남교육지원청 신흥성모유치원,7,7,0,7,1,6,0,0
교육기관,교육부,안말초등학교,교육부 경기도교육청 경기도성남교육지원청 안말초등학교,12,12,0,12,0,12,0,0
교육기관,교육부,야탑고등학교,교육부 경기도교육청 경기도성남교육지원청 야탑고등학교,51,51,0,51,0,51,0,0
교육기관,교육부,야탑중학교,교육부 경기도교육청 경기도성남교육지원청 야탑중학교,36,34,2,34,9,25,0,0
교육기관,교육부,야탑초등학교,교육부 경기도교육청 경기도성남교육지원청 야탑초등학교,11,11,0,11,0,11,0,0
교육기관,교육부,양영디지털고등학교,교육부 경기도교육청 경기도성남교육지원청 양영디지털고등학교,29,29,0,29,2,27,0,0
교육기관,교육부,양영중학교,교육부 경기도교육청 경기도성남교육지원청 양영중학교,28,28,0,28,19,7,1,1
교육기관,교육부,양영초등학교,교육부 경기도교육청 경기도성남교육지원청 양영초등학교,15,15,0,15,0,15,0,0
교육기관,교육부,열린이화유치원,교육부 경기도교육청 경기도성남교육지원청 열린이화유치원,11,2,9,2,1,1,0,0
교육기관,교육부,영성중학교,교육부 경기도교육청 경기도성남교육지원청 영성중학교,15,15,0,15,7,5,3,0
교육기관,교육부,오리초등학교,교육부 경기도교육청 경기도성남교육지원청 오리초등학교,14,14,0,14,2,12,0,0
교육기관,교육부,왕남초등학교,교육부 경기도교육청 경기도성남교육지원청 왕남초등학교,33,23,10,23,11,10,1,1
교육기관,교육부,운중고등학교,교육부 경기도교육청 경기도성남교육지원청 운중고등학교,25,25,0,25,0,25,0,0
교육기관,교육부,운중중학교,교육부 경기도교육청 경기도성남교육지원청 운중중학교,25,25,0,25,0,25,0,0
교육기관,교육부,운중초등학교,교육부 경기도교육청 경기도성남교육지원청 운중초등학교,15,15,0,15,9,6,0,0
교육기관,교육부,위례고운초등학교,교육부 경기도교육청 경기도성남교육지원청 위례고운초등학교,16,16,0,16,16,0,0,0
교육기관,교육부,위례새초롱유치원,교육부 경기도교육청 경기도성남교육지원청 위례새초롱유치원,6,6,0,6,0,6,0,0
교육기관,교육부,위례중앙중학교,교육부 경기도교육청 경기도성남교육지원청 위례중앙중학교,35,34,1,34,20,14,0,0
교육기관,교육부,위례중앙초등학교,교육부 경기도교육청 경기도성남교육지원청 위례중앙초등학교,20,20,0,20,17,3,0,0
교육기관,교육부,위례푸른초등학교,교육부 경기도교육청 경기도성남교육지원청 위례푸른초등학교,18,18,0,18,18,0,0,0
교육기관,교육부,위례하늘유치원,교육부 경기도교육청 경기도성남교육지원청 위례하늘유치원,15,15,0,15,0,15,0,0
교육기관,교육부,위례한빛중학교,교육부 경기도교육청 경기도성남교육지원청 위례한빛중학교,32,32,0,32,0,32,0,0
교육기관,교육부,은솔유치원,교육부 경기도교육청 경기도성남교육지원청 은솔유치원,7,7,0,7,0,7,0,0
교육기관,교육부,은정유치원,교육부 경기도교육청 경기도성남교육지원청 은정유치원,16,16,0,16,1,15,0,0
교육기관,교육부,은행중학교,교육부 경기도교육청 경기도성남교육지원청 은행중학교,31,29,2,29,0,29,0,0
교육기관,교육부,이매고등학교,교육부 경기도교육청 경기도성남교육지원청 이매고등학교,39,39,0,39,1,36,1,1
교육기관,교육부,이매중학교,교육부 경기도교육청 경기도성남교육지원청 이매중학교,39,39,0,39,22,17,0,0
교육기관,교육부,이매초등학교,교육부 경기도교육청 경기도성남교육지원청 이매초등학교,17,17,0,17,2,15,0,0
교육기관,교육부,이솔유치원,교육부 경기도교육청 경기도성남교육지원청 이솔유치원,9,9,0,9,0,9,0,0
교육기관,교육부,이우고등학교,교육부 경기도교육청 경기도성남교육지원청 이우고등학교,12,12,0,12,0,12,0,0
교육기관,교육부,이우중학교,교육부 경기도교육청 경기도성남교육지원청 이우중학교,12,12,0,12,0,12,0,0
교육기관,교육부,장안중학교,교육부 경기도교육청 경기도성남교육지원청 장안중학교,20,20,0,20,0,20,0,0
교육기관,교육부,정자중학교,교육부 경기도교육청 경기도성남교육지원청 정자중학교,18,18,0,18,0,18,0,0
교육기관,교육부,중부초등학교,교육부 경기도교육청 경기도성남교육지원청 중부초등학교,16,16,0,16,16,0,0,0
교육기관,교육부,중원초등학교,교육부 경기도교육청 경기도성남교육지원청 중원초등학교,22,22,0,22,22,0,0,0
교육기관,교육부,중탑초등학교,교육부 경기도교육청 경기도성남교육지원청 중탑초등학교,13,13,0,13,11,2,0,0
교육기관,교육부,즐거운유치원,교육부 경기도교육청 경기도성남교육지원청 즐거운유치원,24,24,0,24,21,3,0,0
교육기관,교육부,창성중학교,교육부 경기도교육청 경기도성남교육지원청 창성중학교,32,30,2,30,30,0,0,0
교육기관,교육부,창은유치원,교육부 경기도교육청 경기도성남교육지원청 창은유치원,12,12,0,12,10,2,0,0
교육기관,교육부,창조유치원,교육부 경기도교육청 경기도성남교육지원청 창조유치원,12,12,0,12,0,12,0,0
교육기관,교육부,청솔중학교,교육부 경기도교육청 경기도성남교육지원청 청솔중학교,34,34,0,34,16,16,1,1
교육기관,교육부,청솔초등학교,교육부 경기도교육청 경기도성남교육지원청 청솔초등학교,10,10,0,10,10,0,0,0
교육기관,교육부,초림초등학교,교육부 경기도교육청 경기도성남교육지원청 초림초등학교,28,28,0,28,28,0,0,0
교육기관,교육부,탄천초등학교,교육부 경기도교육청 경기도성남교육지원청 탄천초등학교,20,20,0,20,0,20,0,0
교육기관,교육부,태원고등학교,교육부 경기도교육청 경기도성남교육지원청 태원고등학교,46,46,0,46,23,23,0,0
교육기관,교육부,태평초등학교,교육부 경기도교육청 경기도성남교육지원청 태평초등학교,21,21,0,21,10,9,0,2
교육기관,교육부,판교고등학교,교육부 경기도교육청 경기도성남교육지원청 판교고등학교,25,25,0,25,25,0,0,0
교육기관,교육부,판교대장중학교,교육부 경기도교육청 경기도성남교육지원청 판교대장중학교,43,43,0,43,0,43,0,0
교육기관,교육부,판교대장초등학교,교육부 경기도교육청 경기도성남교육지원청 판교대장초등학교,43,43,0,43,0,43,0,0
교육기관,교육부,판교반디유치원,교육부 경기도교육청 경기도성남교육지원청 판교반디유치원,29,29,0,29,7,22,0,0
교육기관,교육부,판교샘유치원,교육부 경기도교육청 경기도성남교육지원청 판교샘유치원,9,1,8,1,0,1,0,0
교육기관,교육부,판교중학교,교육부 경기도교육청 경기도성남교육지원청 판교중학교,29,29,0,29,0,29,0,0
교육기관,교육부,판교초등학교,교육부 경기도교육청 경기도성남교육지원청 판교초등학교,18,18,0,18,9,9,0,0
교육기관,교육부,풍생중학교,교육부 경기도교육청 경기도성남교육지원청 풍생중학교,24,24,0,24,12,12,0,0
교육기관,교육부,하나유치원,교육부 경기도교육청 경기도성남교육지원청 하나유치원,14,14,0,14,0,14,0,0
교육기관,교육부,하늘꿈중고등학교,교육부 경기도교육청 경기도성남교육지원청 하늘꿈중고등학교,16,16,0,16,6,10,0,0
교육기관,교육부,하원초등학교,교육부 경기도교육청 경기도성남교육지원청 하원초등학교,14,14,0,14,0,14,0,0
교육기관,교육부,하탑중학교,교육부 경기도교육청 경기도성남교육지원청 하탑중학교,21,21,0,21,0,21,0,0
교육기관,교육부,하탑초등학교,교육부 경기도교육청 경기도성남교육지원청 하탑초등학교,15,15,0,15,6,9,0,0
교육기관,교육부,한별유치원,교육부 경기도교육청 경기도성남교육지원청 한별유치원,16,7,9,7,0,7,0,0
교육기관,교육부,한솔유치원,교육부 경기도교육청 경기도성남교육지원청 한솔유치원,12,12,0,12,0,12,0,0
교육기관,교육부,한솔초등학교,교육부 경기도교육청 경기도성남교육지원청 한솔초등학교,14,14,0,14,0,14,0,0
교육기관,교육부,한울유치원,교육부 경기도교육청 경기도성남교육지원청 한울유치원,14,13,1,13,3,10,0,0
교육기관,교육부,홍하유치원,교육부 경기도교육청 경기도성남교육지원청 홍하유치원,14,0,14,0,0,0,0,0
교육기관,교육부,효성고등학교,교육부 경기도교육청 경기도성남교육지원청 효성고등학교,27,27,0,27,0,27,0,0
교육기관,교육부,효자유치원,교육부 경기도교육청 경기도성남교육지원청 효자유치원,0,0,0,0,0,0,0,0
교육기관,교육부,희소유치원,교육부 경기도교육청 경기도성남교육지원청 희소유치원,16,16,0,16,0,16,0,0
교육기관,교육부,경기도수원교육지원청,교육부 경기도교육청 경기도수원교육지원청,20,20,0,20,3,17,0,0
교육기관,교육부,가온누리유치원,교육부 경기도교육청 경기도수원교육지원청 가온누리유치원,34,34,0,34,0,34,0,0
교육기관,교육부,강남유치원,교육부 경기도교육청 경기도수원교육지원청 강남유치원,9,9,0,9,0,9,0,0
교육기관,교육부,경기과학고등학교,교육부 경기도교육청 경기도수원교육지원청 경기과학고등학교,70,31,39,31,11,13,7,0
교육기관,교육부,경기대명고등학교,교육부 경기도교육청 경기도수원교육지원청 경기대명고등학교,12,11,1,11,3,8,0,0
교육기관,교육부,경기체육고등학교,교육부 경기도교육청 경기도수원교육지원청 경기체육고등학교,47,47,0,47,0,47,0,0
교육기관,교육부,고색고등학교,교육부 경기도교육청 경기도수원교육지원청 고색고등학교,78,78,0,78,78,0,0,0
교육기관,교육부,고색중학교,교육부 경기도교육청 경기도수원교육지원청 고색중학교,8,8,0,8,8,0,0,0
교육기관,교육부,고색초등학교,교육부 경기도교육청 경기도수원교육지원청 고색초등학교,21,21,0,21,0,21,0,0
교육기관,교육부,고현초등학교,교육부 경기도교육청 경기도수원교육지원청 고현초등학교,14,14,0,14,0,14,0,0
교육기관,교육부,곡반초등학교,교육부 경기도교육청 경기도수원교육지원청 곡반초등학교,9,9,0,9,9,0,0,0
교육기관,교육부,곡선중학교,교육부 경기도교육청 경기도수원교육지원청 곡선중학교,19,17,2,17,17,0,0,0
교육기관,교육부,곡선초등학교,교육부 경기도교육청 경기도수원교육지원청 곡선초등학교,33,33,0,33,25,8,0,0
교육기관,교육부,곡정고등학교,교육부 경기도교육청 경기도수원교육지원청 곡정고등학교,49,49,0,49,3,46,0,0
교육기관,교육부,곡정초등학교,교육부 경기도교육청 경기도수원교육지원청 곡정초등학교,19,19,0,19,17,2,0,0
교육기관,교육부,광교고등학교,교육부 경기도교육청 경기도수원교육지원청 광교고등학교,27,27,0,27,0,27,0,0
교육기관,교육부,광교중학교,교육부 경기도교육청 경기도수원교육지원청 광교중학교,24,15,9,15,5,8,1,1
교육기관,교육부,광교초등학교,교육부 경기도교육청 경기도수원교육지원청 광교초등학교,16,16,0,16,9,7,0,0
교육기관,교육부,광교호수중학교,교육부 경기도교육청 경기도수원교육지원청 광교호수중학교,43,43,0,43,24,19,0,0
교육기관,교육부,광교호수초등학교,교육부 경기도교육청 경기도수원교육지원청 광교호수초등학교,23,23,0,23,23,0,0,0
교육기관,교육부,구운중학교,교육부 경기도교육청 경기도수원교육지원청 구운중학교,30,30,0,30,20,10,0,0
교육기관,교육부,구운초등학교,교육부 경기도교육청 경기도수원교육지원청 구운초등학교,25,25,0,25,16,9,0,0
교육기관,교육부,권선고등학교,교육부 경기도교육청 경기도수원교육지원청 권선고등학교,14,12,2,12,0,12,0,0
교육기관,교육부,권선중학교,교육부 경기도교육청 경기도수원교육지원청 권선중학교,22,22,0,22,0,22,0,0
교육기관,교육부,권선초등학교,교육부 경기도교육청 경기도수원교육지원청 권선초등학교,23,23,0,23,23,0,0,0
교육기관,교육부,꾸러기숲유치원,교육부 경기도교육청 경기도수원교육지원청 꾸러기숲유치원,6,0,6,0,0,0,0,0
교육기관,교육부,꿈꾸는아이들유치원,교육부 경기도교육청 경기도수원교육지원청 꿈꾸는아이들유치원,32,32,0,32,6,24,1,1
교육기관,교육부,꿈누리유치원,교육부 경기도교육청 경기도수원교육지원청 꿈누리유치원,12,12,0,12,12,0,0,0
교육기관,교육부,남수원중학교,교육부 경기도교육청 경기도수원교육지원청 남수원중학교,21,21,0,21,0,21,0,0
교육기관,교육부,남수원초등학교,교육부 경기도교육청 경기도수원교육지원청 남수원초등학교,20,20,0,20,0,20,0,0
교육기관,교육부,남창초등학교,교육부 경기도교육청 경기도수원교육지원청 남창초등학교,14,14,0,14,0,14,0,0
교육기관,교육부,늘푸른유치원,교육부 경기도교육청 경기도수원교육지원청 늘푸른유치원,15,1,14,1,0,1,0,0
교육기관,교육부,능실유치원,교육부 경기도교육청 경기도수원교육지원청 능실유치원,15,15,0,15,7,8,0,0
교육기관,교육부,능실중학교,교육부 경기도교육청 경기도수원교육지원청 능실중학교,32,32,0,32,0,32,0,0
교육기관,교육부,능실초등학교,교육부 경기도교육청 경기도수원교육지원청 능실초등학교,18,18,0,18,18,0,0,0
교육기관,교육부,다솔초등학교,교육부 경기도교육청 경기도수원교육지원청 다솔초등학교,42,42,0,42,19,23,0,0
교육기관,교육부,다정유치원,교육부 경기도교육청 경기도수원교육지원청 다정유치원,63,63,0,63,0,63,0,0
교육기관,교육부,당수초등학교,교육부 경기도교육청 경기도수원교육지원청 당수초등학교,14,14,0,14,14,0,0,0
교육기관,교육부,대선초등학교,교육부 경기도교육청 경기도수원교육지원청 대선초등학교,21,21,0,21,11,10,0,0
교육기관,교육부,대평고등학교,교육부 경기도교육청 경기도수원교육지원청 대평고등학교,32,32,0,32,21,11,0,0
교육기관,교육부,대평중학교,교육부 경기도교육청 경기도수원교육지원청 대평중학교,21,19,2,19,11,8,0,0
교육기관,교육부,대평초등학교,교육부 경기도교육청 경기도수원교육지원청 대평초등학교,13,13,0,13,9,4,0,0
교육기관,교육부,동남유치원,교육부 경기도교육청 경기도수원교육지원청 동남유치원,36,36,0,36,7,29,0,0
교육기관,교육부,동성중학교,교육부 경기도교육청 경기도수원교육지원청 동성중학교,30,28,2,28,28,0,0,0
교육기관,교육부,동수원초등학교,교육부 경기도교육청 경기도수원교육지원청 동수원초등학교,18,18,0,18,14,4,0,0
교육기관,교육부,동우여자고등학교,교육부 경기도교육청 경기도수원교육지원청 동우여자고등학교,51,51,0,51,0,51,0,0
교육기관,교육부,디딤돌유치원,교육부 경기도교육청 경기도수원교육지원청 디딤돌유치원,16,4,12,4,0,4,0,0
교육기관,교육부,라온유치원,교육부 경기도교육청 경기도수원교육지원청 라온유치원,21,21,0,21,21,0,0,0
교육기관,교육부,망포고등학교,교육부 경기도교육청 경기도수원교육지원청 망포고등학교,44,41,3,41,21,20,0,0
교육기관,교육부,망포유치원,교육부 경기도교육청 경기도수원교육지원청 망포유치원,18,18,0,18,0,18,0,0
교육기관,교육부,망포중학교,교육부 경기도교육청 경기도수원교육지원청 망포중학교,19,19,0,19,1,18,0,0
교육기관,교육부,망포초등학교,교육부 경기도교육청 경기도수원교육지원청 망포초등학교,24,22,2,22,18,4,0,0
교육기관,교육부,매산유치원,교육부 경기도교육청 경기도수원교육지원청 매산유치원,8,8,0,8,5,3,0,0
교육기관,교육부,매산초등학교,교육부 경기도교육청 경기도수원교육지원청 매산초등학교,21,21,0,21,19,2,0,0
교육기관,교육부,매여울초등학교,교육부 경기도교육청 경기도수원교육지원청 매여울초등학교,23,23,0,23,23,0,0,0
교육기관,교육부,매원고등학교,교육부 경기도교육청 경기도수원교육지원청 매원고등학교,26,23,3,23,0,23,0,0
교육기관,교육부,매원중학교,교육부 경기도교육청 경기도수원교육지원청 매원중학교,35,35,0,35,4,29,2,0
교육기관,교육부,매원초등학교,교육부 경기도교육청 경기도수원교육지원청 매원초등학교,31,31,0,31,31,0,0,0
교육기관,교육부,매탄중학교,교육부 경기도교육청 경기도수원교육지원청 매탄중학교,19,16,3,16,0,16,0,0
교육기관,교육부,매탄초등학교,교육부 경기도교육청 경기도수원교육지원청 매탄초등학교,21,21,0,21,21,0,0,0
교육기관,교육부,매향여자정보고등학교,교육부 경기도교육청 경기도수원교육지원청 매향여자정보고등학교,26,26,0,26,3,23,0,0
교육기관,교육부,매향중학교,교육부 경기도교육청 경기도수원교육지원청 매향중학교,18,17,1,17,9,8,0,0
교육기관,교육부,매현중학교,교육부 경기도교육청 경기도수원교육지원청 매현중학교,35,33,2,33,0,33,0,0
교육기관,교육부,매현초등학교,교육부 경기도교육청 경기도수원교육지원청 매현초등학교,11,11,0,11,5,6,0,0
교육기관,교육부,명인중학교,교육부 경기도교육청 경기도수원교육지원청 명인중학교,18,15,3,15,9,6,0,0
교육기관,교육부,명인초등학교,교육부 경기도교육청 경기도수원교육지원청 명인초등학교,8,8,0,8,8,0,0,0
교육기관,교육부,밤밭누리유치원,교육부 경기도교육청 경기도수원교육지원청 밤밭누리유치원,23,23,0,23,0,23,0,0
교육기관,교육부,배학유치원,교육부 경기도교육청 경기도수원교육지원청 배학유치원,32,9,23,9,4,5,0,0
교육기관,교육부,복자유치원,교육부 경기도교육청 경기도수원교육지원청 복자유치원,16,5,11,5,2,1,1,1
교육기관,교육부,빛누리유치원,교육부 경기도교육청 경기도수원교육지원청 빛누리유치원,17,17,0,17,0,17,0,0
교육기관,교육부,뽀뽀뽀유치원,교육부 경기도교육청 경기도수원교육지원청 뽀뽀뽀유치원,16,16,0,16,3,13,0,0
교육기관,교육부,산남중학교,교육부 경기도교육청 경기도수원교육지원청 산남중학교,12,12,0,12,11,1,0,0
교육기관,교육부,산남초등학교,교육부 경기도교육청 경기도수원교육지원청 산남초등학교,23,23,0,23,0,23,0,0
교육기관,교육부,산의초등학교,교육부 경기도교육청 경기도수원교육지원청 산의초등학교,27,27,0,27,0,27,0,0
교육기관,교육부,삼일공업고등학교,교육부 경기도교육청 경기도수원교육지원청 삼일공업고등학교,16,16,0,16,3,13,0,0
교육기관,교육부,삼일중학교,교육부 경기도교육청 경기도수원교육지원청 삼일중학교,12,12,0,12,9,3,0,0
교육기관,교육부,상률초등학교,교육부 경기도교육청 경기도수원교육지원청 상률초등학교,14,14,0,14,0,14,0,0
교육기관,교육부,상은유치원,교육부 경기도교육청 경기도수원교육지원청 상은유치원,18,18,0,18,1,17,0,0
교육기관,교육부,상촌중학교,교육부 경기도교육청 경기도수원교육지원청 상촌중학교,16,15,1,15,0,15,0,0
교육기관,교육부,상촌초등학교,교육부 경기도교육청 경기도수원교육지원청 상촌초등학교,16,16,0,16,16,0,0,0
교육기관,교육부,새동신유치원,교육부 경기도교육청 경기도수원교육지원청 새동신유치원,13,4,9,4,0,4,0,0
교육기관,교육부,새롬유치원,교육부 경기도교육청 경기도수원교육지원청 새롬유치원,9,8,1,8,1,5,1,1
교육기관,교육부,새알곡유치원,교육부 경기도교육청 경기도수원교육지원청 새알곡유치원,18,18,0,18,0,18,0,0
교육기관,교육부,서평초등학교,교육부 경기도교육청 경기도수원교육지원청 서평초등학교,14,14,0,14,14,0,0,0
교육기관,교육부,서호중학교,교육부 경기도교육청 경기도수원교육지원청 서호중학교,24,22,2,22,0,22,0,0
교육기관,교육부,서호초등학교,교육부 경기도교육청 경기도수원교육지원청 서호초등학교,17,17,0,17,14,3,0,0
교육기관,교육부,선경유치원,교육부 경기도교육청 경기도수원교육지원청 선경유치원,16,2,14,2,2,0,0,0
교육기관,교육부,선행초등학교,교육부 경기도교육청 경기도수원교육지원청 선행초등학교,13,13,0,13,0,13,0,0
교육기관,교육부,세곡초등학교,교육부 경기도교육청 경기도수원교육지원청 세곡초등학교,10,10,0,10,5,3,0,2
교육기관,교육부,세류유치원,교육부 경기도교육청 경기도수원교육지원청 세류유치원,18,9,9,9,0,9,0,0
교육기관,교육부,세류중학교,교육부 경기도교육청 경기도수원교육지원청 세류중학교,34,34,0,34,8,26,0,0
교육기관,교육부,세류초등학교,교육부 경기도교육청 경기도수원교육지원청 세류초등학교,26,26,0,26,12,12,1,1
교육기관,교육부,세림유치원,교육부 경기도교육청 경기도수원교육지원청 세림유치원,16,2,14,2,1,1,0,0
교육기관,교육부,송림초등학교,교육부 경기도교육청 경기도수원교육지원청 송림초등학교,16,16,0,16,0,16,0,0
교육기관,교육부,송원중학교,교육부 경기도교육청 경기도수원교육지원청 송원중학교,23,23,0,23,0,23,0,0
교육기관,교육부,송원초등학교,교육부 경기도교육청 경기도수원교육지원청 송원초등학교,13,13,0,13,8,5,0,0
교육기관,교육부,송정초등학교,교육부 경기도교육청 경기도수원교육지원청 송정초등학교,12,12,0,12,12,0,0,0
교육기관,교육부,송죽초등학교,교육부 경기도교육청 경기도수원교육지원청 송죽초등학교,8,8,0,8,8,0,0,0
교육기관,교육부,수성고등학교,교육부 경기도교육청 경기도수원교육지원청 수성고등학교,24,24,0,24,4,20,0,0
교육기관,교육부,수성중학교,교육부 경기도교육청 경기도수원교육지원청 수성중학교,16,16,0,16,3,12,1,0
교육기관,교육부,수성초등학교,교육부 경기도교육청 경기도수원교육지원청 수성초등학교,11,11,0,11,10,1,0,0
교육기관,교육부,수원가온초등학교,교육부 경기도교육청 경기도수원교육지원청 수원가온초등학교,30,30,0,30,15,10,2,3
교육기관,교육부,수원고등학교,교육부 경기도교육청 경기도수원교육지원청 수원고등학교,15,15,0,15,8,7,0,0
교육기관,교육부,수원금곡초등학교,교육부 경기도교육청 경기도수원교육지원청 수원금곡초등학교,15,15,0,15,7,8,0,0
교육기관,교육부,수원금호초등학교,교육부 경기도교육청 경기도수원교육지원청 수원금호초등학교,38,38,0,38,25,3,4,6
교육기관,교육부,수원농생명과학고등학교,교육부 경기도교육청 경기도수원교육지원청 수원농생명과학고등학교,20,20,0,20,0,20,0,0
교육기관,교육부,수원다산중학교,교육부 경기도교육청 경기도수원교육지원청 수원다산중학교,22,20,2,20,0,20,0,0
교육기관,교육부,수원동신초등학교,교육부 경기도교육청 경기도수원교육지원청 수원동신초등학교,15,15,0,15,8,7,0,0
교육기관,교육부,수원매화초등학교,교육부 경기도교육청 경기도수원교육지원청 수원매화초등학교,14,14,0,14,0,14,0,0
교육기관,교육부,수원북중학교,교육부 경기도교육청 경기도수원교육지원청 수원북중학교,24,24,0,24,22,2,0,0
교육기관,교육부,수원서광학교,교육부 경기도교육청 경기도수원교육지원청 수원서광학교,47,47,0,47,0,47,0,0
교육기관,교육부,수원선일초등학교,교육부 경기도교육청 경기도수원교육지원청 수원선일초등학교,16,16,0,16,0,16,0,0
교육기관,교육부,수원신곡초등학교,교육부 경기도교육청 경기도수원교육지원청 수원신곡초등학교,19,19,0,19,19,0,0,0
교육기관,교육부,수원여자고등학교,교육부 경기도교육청 경기도수원교육지원청 수원여자고등학교,20,20,0,20,20,0,0,0
교육기관,교육부,수원여자대학교부속유치원,교육부 경기도교육청 경기도수원교육지원청 수원여자대학교부속유치원,32,32,0,32,28,4,0,0
교육기관,교육부,수원외국어고등학교,교육부 경기도교육청 경기도수원교육지원청 수원외국어고등학교,76,76,0,76,0,76,0,0
교육기관,교육부,수원원일중학교,교육부 경기도교육청 경기도수원교육지원청 수원원일중학교,24,24,0,24,19,3,1,1
교육기관,교육부,수원정보과학고등학교,교육부 경기도교육청 경기도수원교육지원청 수원정보과학고등학교,41,40,1,40,12,28,0,0
교육기관,교육부,수원제일중학교,교육부 경기도교육청 경기도수원교육지원청 수원제일중학교,16,16,0,16,0,16,0,0
교육기관,교육부,수원중촌초등학교,교육부 경기도교육청 경기도수원교육지원청 수원중촌초등학교,25,25,0,25,0,25,0,0
교육기관,교육부,수원중학교,교육부 경기도교육청 경기도수원교육지원청 수원중학교,13,13,0,13,13,0,0,0
교육기관,교육부,수원초등학교,교육부 경기도교육청 경기도수원교육지원청 수원초등학교,13,13,0,13,13,0,0,0
교육기관,교육부,수원칠보고등학교,교육부 경기도교육청 경기도수원교육지원청 수원칠보고등학교,56,56,0,56,41,15,0,0
교육기관,교육부,수원하이텍고등학교,교육부 경기도교육청 경기도수원교육지원청 수원하이텍고등학교,59,59,0,59,2,57,0,0
교육기관,교육부,수일고등학교,교육부 경기도교육청 경기도수원교육지원청 수일고등학교,15,13,2,13,9,2,1,1
교육기관,교육부,수일여자중학교,교육부 경기도교육청 경기도수원교육지원청 수일여자중학교,26,24,2,24,24,0,0,0
교육기관,교육부,수일중학교,교육부 경기도교육청 경기도수원교육지원청 수일중학교,12,12,0,12,5,7,0,0
교육기관,교육부,수일초등학교,교육부 경기도교육청 경기도수원교육지원청 수일초등학교,10,10,0,10,10,0,0,0
교육기관,교육부,숙지중학교,교육부 경기도교육청 경기도수원교육지원청 숙지중학교,17,17,0,17,17,0,0,0
교육기관,교육부,숙지초등학교,교육부 경기도교육청 경기도수원교육지원청 숙지초등학교,16,16,0,16,12,4,0,0
교육기관,교육부,신영초등학교,교육부 경기도교육청 경기도수원교육지원청 신영초등학교,16,16,0,16,16,0,0,0
교육기관,교육부,신풍초등학교,교육부 경기도교육청 경기도수원교육지원청 신풍초등학교,33,33,0,33,31,2,0,0
교육기관,교육부,아름학교,교육부 경기도교육청 경기도수원교육지원청 아름학교,16,16,0,16,2,14,0,0
교육기관,교육부,안룡초등학교,교육부 경기도교육청 경기도수원교육지원청 안룡초등학교,20,20,0,20,17,3,0,0
교육기관,교육부,연무중학교,교육부 경기도교육청 경기도수원교육지원청 연무중학교,31,29,2,29,26,3,0,0
교육기관,교육부,연무초등학교,교육부 경기도교육청 경기도수원교육지원청 연무초등학교,17,17,0,17,11,4,2,0
교육기관,교육부,연화유치원,교육부 경기도교육청 경기도수원교육지원청 연화유치원,37,4,33,4,3,1,0,0
교육기관,교육부,영덕고등학교,교육부 경기도교육청 경기도수원교육지원청 영덕고등학교,22,0,22,0,0,0,0,0
교육기관,교육부,영덕중학교,교육부 경기도교육청 경기도수원교육지원청 영덕중학교,13,13,0,13,7,5,1,0
교육기관,교육부,영덕초등학교,교육부 경기도교육청 경기도수원교육지원청 영덕초등학교,12,12,0,12,8,4,0,0
교육기관,교육부,영동중학교,교육부 경기도교육청 경기도수원교육지원청 영동중학교,17,17,0,17,1,16,0,0
교육기관,교육부,영복여자고등학교,교육부 경기도교육청 경기도수원교육지원청 영복여자고등학교,10,10,0,10,10,0,0,0
교육기관,교육부,영복여자중학교,교육부 경기도교육청 경기도수원교육지원청 영복여자중학교,10,8,2,8,5,3,0,0
교육기관,교육부,영생고등학교,교육부 경기도교육청 경기도수원교육지원청 영생고등학교,35,16,19,16,14,2,0,0
교육기관,교육부,영신여자고등학교,교육부 경기도교육청 경기도수원교육지원청 영신여자고등학교,15,15,0,15,15,0,0,0
교육기관,교육부,영신중학교,교육부 경기도교육청 경기도수원교육지원청 영신중학교,24,22,2,22,2,20,0,0
교육기관,교육부,영일중학교,교육부 경기도교육청 경기도수원교육지원청 영일중학교,20,18,2,18,0,18,0,0
교육기관,교육부,영일초등학교,교육부 경기도교육청 경기도수원교육지원청 영일초등학교,16,16,0,16,0,16,0,0
교육기관,교육부,영통중학교,교육부 경기도교육청 경기도수원교육지원청 영통중학교,22,20,2,20,18,2,0,0
교육기관,교육부,영화초등학교,교육부 경기도교육청 경기도수원교육지원청 영화초등학교,27,27,0,27,12,15,0,0
교육기관,교육부,예그린유치원,교육부 경기도교육청 경기도수원교육지원청 예그린유치원,5,1,4,1,1,0,0,0
교육기관,교육부,예인유치원,교육부 경기도교육청 경기도수원교육지원청 예인유치원,26,3,23,3,1,2,0,0
교육기관,교육부,오목초등학교,교육부 경기도교육청 경기도수원교육지원청 오목초등학교,17,17,0,17,6,11,0,0
교육기관,교육부,오현초등학교,교육부 경기도교육청 경기도수원교육지원청 오현초등학교,8,8,0,8,0,8,0,0
교육기관,교육부,우만초등학교,교육부 경기도교육청 경기도수원교육지원청 우만초등학교,13,13,0,13,8,5,0,0
교육기관,교육부,원일초등학교,교육부 경기도교육청 경기도수원교육지원청 원일초등학교,9,9,0,9,9,0,0,0
교육기관,교육부,원천중학교,교육부 경기도교육청 경기도수원교육지원청 원천중학교,8,8,0,8,8,0,0,0
교육기관,교육부,원천초등학교,교육부 경기도교육청 경기도수원교육지원청 원천초등학교,23,23,0,23,8,7,7,1
교육기관,교육부,유신고등학교,교육부 경기도교육청 경기도수원교육지원청 유신고등학교,72,72,0,72,0,72,0,0
교육기관,교육부,율전중학교,교육부 경기도교육청 경기도수원교육지원청 율전중학교,27,27,0,27,14,9,3,1
교육기관,교육부,율전초등학교,교육부 경기도교육청 경기도수원교육지원청 율전초등학교,24,24,0,24,24,0,0,0
교육기관,교육부,율현중학교,교육부 경기도교육청 경기도수원교육지원청 율현중학교,19,18,1,18,0,18,0,0
교육기관,교육부,율현초등학교,교육부 경기도교육청 경기도수원교육지원청 율현초등학교,42,19,23,19,19,0,0,0
교육기관,교육부,이목중학교,교육부 경기도교육청 경기도수원교육지원청 이목중학교,14,12,2,12,1,11,0,0
교육기관,교육부,이의고등학교,교육부 경기도교육청 경기도수원교육지원청 이의고등학교,36,35,1,35,10,25,0,0
교육기관,교육부,이의중학교,교육부 경기도교육청 경기도수원교육지원청 이의중학교,19,19,0,19,19,0,0,0
교육기관,교육부,이의초등학교,교육부 경기도교육청 경기도수원교육지원청 이의초등학교,20,20,0,20,20,0,0,0
교육기관,교육부,일월초등학교,교육부 경기도교육청 경기도수원교육지원청 일월초등학교,18,18,0,18,0,18,0,0
교육기관,교육부,입북초등학교,교육부 경기도교육청 경기도수원교육지원청 입북초등학교,12,12,0,12,6,6,0,0
교육기관,교육부,자혜학교,교육부 경기도교육청 경기도수원교육지원청 자혜학교,15,15,0,15,3,9,2,1
교육기관,교육부,잠원중학교,교육부 경기도교육청 경기도수원교육지원청 잠원중학교,40,39,1,39,36,3,0,0
교육기관,교육부,정자초등학교,교육부 경기도교육청 경기도수원교육지원청 정자초등학교,45,45,0,45,29,16,0,0
교육기관,교육부,정천중학교,교육부 경기도교육청 경기도수원교육지원청 정천중학교,17,17,0,17,2,15,0,0
교육기관,교육부,정천초등학교,교육부 경기도교육청 경기도수원교육지원청 정천초등학교,14,14,0,14,11,3,0,0
교육기관,교육부,조원고등학교,교육부 경기도교육청 경기도수원교육지원청 조원고등학교,29,29,0,29,8,21,0,0
교육기관,교육부,조원중학교,교육부 경기도교육청 경기도수원교육지원청 조원중학교,18,18,0,18,0,18,0,0
교육기관,교육부,조원초등학교,교육부 경기도교육청 경기도수원교육지원청 조원초등학교,22,22,0,22,16,6,0,0
교육기관,교육부,조은유치원,교육부 경기도교육청 경기도수원교육지원청 조은유치원,16,16,0,16,2,14,0,0
교육기관,교육부,중앙기독초등학교,교육부 경기도교육청 경기도수원교육지원청 중앙기독초등학교,133,133,0,133,0,133,0,0
교육기관,교육부,지동초등학교,교육부 경기도교육청 경기도수원교육지원청 지동초등학교,17,17,0,17,17,0,0,0
교육기관,교육부,창용중학교,교육부 경기도교육청 경기도수원교육지원청 창용중학교,20,20,0,20,20,0,0,0
교육기관,교육부,창용초등학교,교육부 경기도교육청 경기도수원교육지원청 창용초등학교,17,17,0,17,17,0,0,0
교육기관,교육부,창현고등학교,교육부 경기도교육청 경기도수원교육지원청 창현고등학교,61,61,0,61,0,61,0,0
교육기관,교육부,천일초등학교,교육부 경기도교육청 경기도수원교육지원청 천일초등학교,11,11,0,11,11,0,0,0
교육기관,교육부,천천고등학교,교육부 경기도교육청 경기도수원교육지원청 천천고등학교,36,36,0,36,0,36,0,0
교육기관,교육부,천천중학교,교육부 경기도교육청 경기도수원교육지원청 천천중학교,17,17,0,17,17,0,0,0
교육기관,교육부,청명고등학교,교육부 경기도교육청 경기도수원교육지원청 청명고등학교,18,16,2,16,5,11,0,0
교육기관,교육부,청명중학교,교육부 경기도교육청 경기도수원교육지원청 청명중학교,32,32,0,32,8,24,0,0
교육기관,교육부,청명초등학교,교육부 경기도교육청 경기도수원교육지원청 청명초등학교,32,32,0,32,16,16,0,0
교육기관,교육부,초록별유치원,교육부 경기도교육청 경기도수원교육지원청 초록별유치원,14,14,0,14,1,13,0,0
교육기관,교육부,칠보중학교,교육부 경기도교육청 경기도수원교육지원청 칠보중학교,13,12,1,12,7,3,1,1
교육기관,교육부,칠보초등학교,교육부 경기도교육청 경기도수원교육지원청 칠보초등학교,11,11,0,11,11,0,0,0
교육기관,교육부,큰나래유치원,교육부 경기도교육청 경기도수원교육지원청 큰나래유치원,32,6,26,6,4,2,0,0
교육기관,교육부,탑동초등학교,교육부 경기도교육청 경기도수원교육지원청 탑동초등학교,16,16,0,16,0,16,0,0
교육기관,교육부,태장고등학교,교육부 경기도교육청 경기도수원교육지원청 태장고등학교,31,0,31,0,0,0,0,0
교육기관,교육부,태장중학교,교육부 경기도교육청 경기도수원교육지원청 태장중학교,12,12,0,12,4,8,0,0
교육기관,교육부,태장초등학교,교육부 경기도교육청 경기도수원교육지원청 태장초등학교,12,12,0,12,12,0,0,0
교육기관,교육부,파장유치원,교육부 경기도교육청 경기도수원교육지원청 파장유치원,8,8,0,8,4,3,1,0
교육기관,교육부,파장초등학교,교육부 경기도교육청 경기도수원교육지원청 파장초등학교,14,14,0,14,3,11,0,0
교육기관,교육부,팔달초등학교,교육부 경기도교육청 경기도수원교육지원청 팔달초등학교,14,14,0,14,0,14,0,0
교육기관,교육부,하나린유치원,교육부 경기도교육청 경기도수원교육지원청 하나린유치원,31,7,24,7,0,7,0,0
교육기관,교육부,하늘유치원,교육부 경기도교육청 경기도수원교육지원청 하늘유치원,59,5,54,5,2,3,0,0
교육기관,교육부,한누리유치원,교육부 경기도교육청 경기도수원교육지원청 한누리유치원,33,33,0,33,0,33,0,0
교육기관,교육부,한봄고등학교,교육부 경기도교육청 경기도수원교육지원청 한봄고등학교,32,31,1,31,9,22,0,0
교육기관,교육부,한일초등학교,교육부 경기도교육청 경기도수원교육지원청 한일초등학교,14,14,0,14,7,7,0,0
교육기관,교육부,해들유치원,교육부 경기도교육청 경기도수원교육지원청 해들유치원,32,32,0,32,0,32,0,0
교육기관,교육부,햇님유치원,교육부 경기도교육청 경기도수원교육지원청 햇님유치원,4,4,0,4,1,1,1,1
교육기관,교육부,호매실고등학교,교육부 경기도교육청 경기도수원교육지원청 호매실고등학교,21,21,0,21,19,2,0,0
교육기관,교육부,호매실중학교,교육부 경기도교육청 경기도수원교육지원청 호매실중학교,9,9,0,9,0,9,0,0
교육기관,교육부,호매실초등학교,교육부 경기도교육청 경기도수원교육지원청 호매실초등학교,22,22,0,22,5,15,1,1
교육기관,교육부,화서초등학교,교육부 경기도교육청 경기도수원교육지원청 화서초등학교,21,21,0,21,5,16,0,0
교육기관,교육부,화양초등학교,교육부 경기도교육청 경기도수원교육지원청 화양초등학교,13,13,0,13,3,10,0,0
교육기관,교육부,화홍고등학교,교육부 경기도교육청 경기도수원교육지원청 화홍고등학교,45,45,0,45,0,45,0,0
교육기관,교육부,화홍중학교,교육부 경기도교육청 경기도수원교육지원청 화홍중학교,13,13,0,13,13,0,0,0
교육기관,교육부,화홍초등학교,교육부 경기도교육청 경기도수원교육지원청 화홍초등학교,25,25,0,25,0,25,0,0
교육기관,교육부,황곡초등학교,교육부 경기도교육청 경기도수원교육지원청 황곡초등학교,13,12,1,12,0,12,0,0
교육기관,교육부,효동초등학교,교육부 경기도교육청 경기도수원교육지원청 효동초등학교,16,16,0,16,16,0,0,0
교육기관,교육부,효성초등학교,교육부 경기도교육청 경기도수원교육지원청 효성초등학교,10,10,0,10,10,0,0,0
교육기관,교육부,효원고등학교,교육부 경기도교육청 경기도수원교육지원청 효원고등학교,15,13,2,13,12,1,0,0
교육기관,교육부,효원초등학교,교육부 경기도교육청 경기도수원교육지원청 효원초등학교,12,12,0,12,10,2,0,0
교육기관,교육부,효정초등학교,교육부 경기도교육청 경기도수원교육지원청 효정초등학교,24,24,0,24,23,1,0,0
교육기관,교육부,효천초등학교,교육부 경기도교육청 경기도수원교육지원청 효천초등학교,15,15,0,15,15,0,0,0
교육기관,교육부,효탑초등학교,교육부 경기도교육청 경기도수원교육지원청 효탑초등학교,11,11,0,11,11,0,0,0
교육기관,교육부,검바위초등학교,교육부 경기도교육청 경기도시흥교육지원청 검바위초등학교,20,20,0,20,3,17,0,0
교육기관,교육부,경기스마트고등학교,교육부 경기도교육청 경기도시흥교육지원청 경기스마트고등학교,38,38,0,38,0,38,0,0
교육기관,교육부,계수초등학교,교육부 경기도교육청 경기도시흥교육지원청 계수초등학교,14,14,0,14,0,14,0,0
교육기관,교육부,군서고등학교,교육부 경기도교육청 경기도시흥교육지원청 군서고등학교,36,36,0,36,25,11,0,0
교육기관,교육부,군서미래국제학교,교육부 경기도교육청 경기도시흥교육지원청 군서미래국제학교,36,36,0,36,0,36,0,0
교육기관,교육부,군서초등학교,교육부 경기도교육청 경기도시흥교육지원청 군서초등학교,28,28,0,28,19,9,0,0
교육기관,교육부,군자디지털과학고등학교,교육부 경기도교육청 경기도시흥교육지원청 군자디지털과학고등학교,57,57,0,57,33,24,0,0
교육기관,교육부,군자중학교,교육부 경기도교육청 경기도시흥교육지원청 군자중학교,22,22,0,22,19,1,0,2
교육기관,교육부,군자초등학교,교육부 경기도교육청 경기도시흥교육지원청 군자초등학교,18,18,0,18,0,18,0,0
교육기관,교육부,금모래초등학교,교육부 경기도교육청 경기도시흥교육지원청 금모래초등학교,11,11,0,11,11,0,0,0
교육기관,교육부,논곡중학교,교육부 경기도교육청 경기도시흥교육지원청 논곡중학교,33,31,2,31,1,28,1,1
교육기관,교육부,대야초등학교,교육부 경기도교육청 경기도시흥교육지원청 대야초등학교,10,10,0,10,5,5,0,0
교육기관,교육부,대흥중학교,교육부 경기도교육청 경기도시흥교육지원청 대흥중학교,16,16,0,16,12,3,1,0
교육기관,교육부,도일초등학교,교육부 경기도교육청 경기도시흥교육지원청 도일초등학교,22,22,0,22,0,22,0,0
교육기관,교육부,도창초등학교,교육부 경기도교육청 경기도시흥교육지원청 도창초등학교,8,8,0,8,6,1,1,0
교육기관,교육부,목감초등학교,교육부 경기도교육청 경기도시흥교육지원청 목감초등학교,9,9,0,9,7,2,0,0
교육기관,교육부,배곧고등학교,교육부 경기도교육청 경기도시흥교육지원청 배곧고등학교,39,39,0,39,23,16,0,0
교육기관,교육부,배곧누리유치원,교육부 경기도교육청 경기도시흥교육지원청 배곧누리유치원,8,8,0,8,4,4,0,0
교육기관,교육부,배곧누리초등학교,교육부 경기도교육청 경기도시흥교육지원청 배곧누리초등학교,46,46,0,46,0,46,0,0
교육기관,교육부,배곧라온초등학교,교육부 경기도교육청 경기도시흥교육지원청 배곧라온초등학교,48,48,0,48,15,33,0,0
교육기관,교육부,배곧새봄유치원,교육부 경기도교육청 경기도시흥교육지원청 배곧새봄유치원,16,16,0,16,14,2,0,0
교육기관,교육부,배곧유치원,교육부 경기도교육청 경기도시흥교육지원청 배곧유치원,13,13,0,13,12,1,0,0
교육기관,교육부,배곧중학교,교육부 경기도교육청 경기도시흥교육지원청 배곧중학교,46,46,0,46,23,23,0,0
교육기관,교육부,배곧초등학교,교육부 경기도교육청 경기도시흥교육지원청 배곧초등학교,36,36,0,36,0,36,0,0
교육기관,교육부,배곧초록유치원,교육부 경기도교육청 경기도시흥교육지원청 배곧초록유치원,34,34,0,34,0,34,0,0
교육기관,교육부,배곧한울초등학교,교육부 경기도교육청 경기도시흥교육지원청 배곧한울초등학교,80,80,0,80,23,52,5,0
교육기관,교육부,배곧해솔중학교,교육부 경기도교육청 경기도시흥교육지원청 배곧해솔중학교,107,107,0,107,77,30,0,0
교육기관,교육부,배곧해솔초등학교,교육부 경기도교육청 경기도시흥교육지원청 배곧해솔초등학교,69,69,0,69,69,0,0,0
교육기관,교육부,빛가람유치원,교육부 경기도교육청 경기도시흥교육지원청 빛가람유치원,17,17,0,17,0,17,0,0
교육기관,교육부,산현유치원,교육부 경기도교육청 경기도시흥교육지원청 산현유치원,20,20,0,20,8,12,0,0
교육기관,교육부,산현초등학교,교육부 경기도교육청 경기도시흥교육지원청 산현초등학교,13,13,0,13,13,0,0,0
교육기관,교육부,생금초등학교 ,교육부 경기도교육청 경기도시흥교육지원청 생금초등학교 ,16,16,0,16,16,0,0,0
교육기관,교육부,서촌초등학교,교육부 경기도교육청 경기도시흥교육지원청 서촌초등학교,17,17,0,17,17,0,0,0
교육기관,교육부,서해고등학교,교육부 경기도교육청 경기도시흥교육지원청 서해고등학교,24,24,0,24,3,21,0,0
교육기관,교육부,서해중학교,교육부 경기도교육청 경기도시흥교육지원청 서해중학교,36,36,0,36,0,36,0,0
교육기관,교육부,서해초등학교,교육부 경기도교육청 경기도시흥교육지원청 서해초등학교,10,10,0,10,10,0,0,0
교육기관,교육부,소래중학교,교육부 경기도교육청 경기도시흥교육지원청 소래중학교,35,35,0,35,4,31,0,0
교육기관,교육부,소래초등학교,교육부 경기도교육청 경기도시흥교육지원청 소래초등학교,17,14,3,14,14,0,0,0
교육기관,교육부,송운중학교,교육부 경기도교육청 경기도시흥교육지원청 송운중학교,34,34,0,34,34,0,0,0
교육기관,교육부,송운초등학교,교육부 경기도교육청 경기도시흥교육지원청 송운초등학교,12,12,0,12,0,12,0,0
교육기관,교육부,승지초등학교,교육부 경기도교육청 경기도시흥교육지원청 승지초등학교,19,19,0,19,11,4,1,3
교육기관,교육부,시화나래유치원,교육부 경기도교육청 경기도시흥교육지원청 시화나래유치원,0,0,0,0,0,0,0,0
교육기관,교육부,시화나래중학교,교육부 경기도교육청 경기도시흥교육지원청 시화나래중학교,17,17,0,17,0,17,0,0
교육기관,교육부,시화나래초등학교,교육부 경기도교육청 경기도시흥교육지원청 시화나래초등학교,14,14,0,14,0,14,0,0
교육기관,교육부,시화유치원,교육부 경기도교육청 경기도시흥교육지원청 시화유치원,4,4,0,4,2,2,0,0
교육기관,교육부,시화중학교,교육부 경기도교육청 경기도시흥교육지원청 시화중학교,40,40,0,40,0,40,0,0
교육기관,교육부,시화초등학교,교육부 경기도교육청 경기도시흥교육지원청 시화초등학교,16,16,0,16,0,16,0,0
교육기관,교육부,시흥가온유치원,교육부 경기도교육청 경기도시흥교육지원청 시흥가온유치원,16,16,0,16,16,0,0,0
교육기관,교육부,시흥가온중학교,교육부 경기도교육청 경기도시흥교육지원청 시흥가온중학교,14,13,1,13,5,8,0,0
교육기관,교육부,시흥가온초등학교,교육부 경기도교육청 경기도시흥교육지원청 시흥가온초등학교,26,26,0,26,26,0,0,0
교육기관,교육부,시흥고등학교,교육부 경기도교육청 경기도시흥교육지원청 시흥고등학교,43,41,2,41,11,30,0,0
교육기관,교육부,시흥능곡고등학교,교육부 경기도교육청 경기도시흥교육지원청 시흥능곡고등학교,37,32,5,32,17,15,0,0
교육기관,교육부,시흥능곡중학교,교육부 경기도교육청 경기도시흥교육지원청 시흥능곡중학교,18,15,3,15,13,2,0,0
교육기관,교육부,시흥능곡초등학교,교육부 경기도교육청 경기도시흥교육지원청 시흥능곡초등학교,19,19,0,19,17,2,0,0
교육기관,교육부,시흥도원초등학교,교육부 경기도교육청 경기도시흥교육지원청 시흥도원초등학교,22,22,0,22,18,4,0,0
교육기관,교육부,시흥매화고등학교,교육부 경기도교육청 경기도시흥교육지원청 시흥매화고등학교,51,49,2,49,34,15,0,0
교육기관,교육부,시흥매화중학교,교육부 경기도교육청 경기도시흥교육지원청 시흥매화중학교,17,16,1,16,3,13,0,0
교육기관,교육부,시흥매화초등학교,교육부 경기도교육청 경기도시흥교육지원청 시흥매화초등학교,14,14,0,14,12,2,0,0
교육기관,교육부,시흥신일초등학교,교육부 경기도교육청 경기도시흥교육지원청 시흥신일초등학교,24,24,0,24,24,0,0,0
교육기관,교육부,시흥은행초등학교,교육부 경기도교육청 경기도시흥교육지원청 시흥은행초등학교,31,31,0,31,31,0,0,0
교육기관,교육부,시흥장현초등학교,교육부 경기도교육청 경기도시흥교육지원청 시흥장현초등학교,36,36,0,36,36,0,0,0
교육기관,교육부,시흥중학교,교육부 경기도교육청 경기도시흥교육지원청 시흥중학교,50,50,0,50,0,50,0,0
교육기관,교육부,시흥초등학교,교육부 경기도교육청 경기도시흥교육지원청 시흥초등학교,16,16,0,16,16,0,0,0
교육기관,교육부,신천고등학교,교육부 경기도교육청 경기도시흥교육지원청 신천고등학교,26,26,0,26,17,9,0,0
교육기관,교육부,신천중학교,교육부 경기도교육청 경기도시흥교육지원청 신천중학교,24,24,0,24,24,0,0,0
교육기관,교육부,신천초등학교,교육부 경기도교육청 경기도시흥교육지원청 신천초등학교,18,18,0,18,0,18,0,0
교육기관,교육부,연성중학교,교육부 경기도교육청 경기도시흥교육지원청 연성중학교,19,19,0,19,19,0,0,0
교육기관,교육부,연성초등학교,교육부 경기도교육청 경기도시흥교육지원청 연성초등학교,24,24,0,24,12,11,1,0
교육기관,교육부,옥터초등학교,교육부 경기도교육청 경기도시흥교육지원청 옥터초등학교,20,20,0,20,17,3,0,0
교육기관,교육부,운흥초등학교,교육부 경기도교육청 경기도시흥교육지원청 운흥초등학교,16,16,0,16,5,11,0,0
교육기관,교육부,웃터골초등학교,교육부 경기도교육청 경기도시흥교육지원청 웃터골초등학교,15,15,0,15,0,15,0,0
교육기관,교육부,월곶중학교,교육부 경기도교육청 경기도시흥교육지원청 월곶중학교,40,39,1,39,8,31,0,0
교육기관,교육부,월포초등학교,교육부 경기도교육청 경기도시흥교육지원청 월포초등학교,12,12,0,12,12,0,0,0
교육기관,교육부,은계유치원,교육부 경기도교육청 경기도시흥교육지원청 은계유치원,16,16,0,16,2,14,0,0
교육기관,교육부,은계중학교,교육부 경기도교육청 경기도시흥교육지원청 은계중학교,42,42,0,42,25,10,5,2
교육기관,교육부,은계초등학교,교육부 경기도교육청 경기도시흥교육지원청 은계초등학교,12,12,0,12,5,4,0,3
교육기관,교육부,은빛초등학교,교육부 경기도교육청 경기도시흥교육지원청 은빛초등학교,30,30,0,30,16,14,0,0
교육기관,교육부,은행고등학교,교육부 경기도교육청 경기도시흥교육지원청 은행고등학교,28,26,2,26,9,17,0,0
교육기관,교육부,응곡중학교,교육부 경기도교육청 경기도시흥교육지원청 응곡중학교,22,22,0,22,22,0,0,0
교육기관,교육부,장곡고등학교,교육부 경기도교육청 경기도시흥교육지원청 장곡고등학교,39,37,2,37,12,25,0,0
교육기관,교육부,장곡중학교,교육부 경기도교육청 경기도시흥교육지원청 장곡중학교,13,13,0,13,5,8,0,0
교육기관,교육부,장곡초등학교,교육부 경기도교육청 경기도시흥교육지원청 장곡초등학교,17,17,0,17,11,6,0,0
교육기관,교육부,정왕고등학교,교육부 경기도교육청 경기도시흥교육지원청 정왕고등학교,31,30,1,30,17,10,2,1
교육기관,교육부,정왕중학교,교육부 경기도교육청 경기도시흥교육지원청 정왕중학교,20,18,2,18,0,18,0,0
교육기관,교육부,정왕초등학교,교육부 경기도교육청 경기도시흥교육지원청 정왕초등학교,22,22,0,22,0,22,0,0
교육기관,교육부,조남유치원,교육부 경기도교육청 경기도시흥교육지원청 조남유치원,49,20,29,20,3,16,0,1
교육기관,교육부,조남중학교,교육부 경기도교육청 경기도시흥교육지원청 조남중학교,98,98,0,98,88,10,0,0
교육기관,교육부,조남초등학교,교육부 경기도교육청 경기도시흥교육지원청 조남초등학교,93,93,0,93,81,12,0,0
교육기관,교육부,진말초등학교,교육부 경기도교육청 경기도시흥교육지원청 진말초등학교,15,15,0,15,2,13,0,0
교육기관,교육부,포리초등학교,교육부 경기도교육청 경기도시흥교육지원청 포리초등학교,15,15,0,15,9,6,0,0
교육기관,교육부,하중초등학교,교육부 경기도교육청 경기도시흥교육지원청 하중초등학교,30,30,0,30,30,0,0,0
교육기관,교육부,한국글로벌중학교,교육부 경기도교육청 경기도시흥교육지원청 한국글로벌중학교,27,27,0,27,0,27,0,0
교육기관,교육부,한여울초등학교,교육부 경기도교육청 경기도시흥교육지원청 한여울초등학교,19,19,0,19,18,1,0,0
교육기관,교육부,함현고등학교,교육부 경기도교육청 경기도시흥교육지원청 함현고등학교,54,54,0,54,13,41,0,0
교육기관,교육부,함현중학교,교육부 경기도교육청 경기도시흥교육지원청 함현중학교,29,29,0,29,7,22,0,0
교육기관,교육부,함현초등학교,교육부 경기도교육청 경기도시흥교육지원청 함현초등학교,16,16,0,16,0,16,0,0
교육기관,교육부,(재)천주교수원교구유지재단데레사유치원,교육부 경기도교육청 경기도안산교육지원청 (재)천주교수원교구유지재단데레사유치원,8,8,0,8,0,8,0,0
교육기관,교육부,각골초등학교,교육부 경기도교육청 경기도안산교육지원청 각골초등학교,6,6,0,6,0,6,0,0
교육기관,교육부,경기모바일과학고등학교,교육부 경기도교육청 경기도안산교육지원청 경기모바일과학고등학교,17,17,0,17,17,0,0,0
교육기관,교육부,경수중학교,교육부 경기도교육청 경기도안산교육지원청 경수중학교,14,12,2,12,0,12,0,0
교육기관,교육부,경수초등학교,교육부 경기도교육청 경기도안산교육지원청 경수초등학교,26,26,0,26,12,14,0,0
교육기관,교육부,경일관광경영고등학교,교육부 경기도교육청 경기도안산교육지원청 경일관광경영고등학교,61,61,0,61,0,61,0,0
교육기관,교육부,경일초등학교,교육부 경기도교육청 경기도안산교육지원청 경일초등학교,22,22,0,22,22,0,0,0
교육기관,교육부,고잔고등학교,교육부 경기도교육청 경기도안산교육지원청 고잔고등학교,15,15,0,15,15,0,0,0
교육기관,교육부,고잔초등학교,교육부 경기도교육청 경기도안산교육지원청 고잔초등학교,25,25,0,25,10,15,0,0
교육기관,교육부,관산중학교,교육부 경기도교육청 경기도안산교육지원청 관산중학교,16,16,0,16,9,7,0,0
교육기관,교육부,관산초등학교,교육부 경기도교육청 경기도안산교육지원청 관산초등학교,26,26,0,26,23,3,0,0
교육기관,교육부,광덕고등학교,교육부 경기도교육청 경기도안산교육지원청 광덕고등학교,41,16,25,16,0,16,0,0
교육기관,교육부,광덕중학교,교육부 경기도교육청 경기도안산교육지원청 광덕중학교,30,30,0,30,16,14,0,0
교육기관,교육부,능길초등학교,교육부 경기도교육청 경기도안산교육지원청 능길초등학교,11,11,0,11,11,0,0,0
교육기관,교육부,단원중학교,교육부 경기도교육청 경기도안산교육지원청 단원중학교,27,27,0,27,27,0,0,0
교육기관,교육부,대남초등학교,교육부 경기도교육청 경기도안산교육지원청 대남초등학교,16,16,0,16,16,0,0,0
교육기관,교육부,대동초등학교,교육부 경기도교육청 경기도안산교육지원청 대동초등학교,13,13,0,13,0,13,0,0
교육기관,교육부,대부고등학교,교육부 경기도교육청 경기도안산교육지원청 대부고등학교,8,8,0,8,2,4,1,1
교육기관,교육부,대부중학교,교육부 경기도교육청 경기도안산교육지원청 대부중학교,4,4,0,4,0,4,0,0
교육기관,교육부,대부초등학교,교육부 경기도교육청 경기도안산교육지원청 대부초등학교,10,10,0,10,0,10,0,0
교육기관,교육부,덕성초등학교,교육부 경기도교육청 경기도안산교육지원청 덕성초등학교,22,22,0,22,22,0,0,0
교육기관,교육부,덕인초등학교,교육부 경기도교육청 경기도안산교육지원청 덕인초등학교,18,18,0,18,18,0,0,0
교육기관,교육부,매화초등학교,교육부 경기도교육청 경기도안산교육지원청 매화초등학교,12,12,0,12,7,5,0,0
교육기관,교육부,명혜학교,교육부 경기도교육청 경기도안산교육지원청 명혜학교,11,11,0,11,4,7,0,0
교육기관,교육부,미림유치원,교육부 경기도교육청 경기도안산교육지원청 미림유치원,16,16,0,16,2,14,0,0
교육기관,교육부,반월중학교,교육부 경기도교육청 경기도안산교육지원청 반월중학교,13,13,0,13,1,12,0,0
교육기관,교육부,반월초등학교,교육부 경기도교육청 경기도안산교육지원청 반월초등학교,16,16,0,16,12,4,0,0
교육기관,교육부,별망중학교,교육부 경기도교육청 경기도안산교육지원청 별망중학교,21,21,0,21,17,4,0,0
교육기관,교육부,본오중학교,교육부 경기도교육청 경기도안산교육지원청 본오중학교,22,22,0,22,0,22,0,0
교육기관,교육부,본오초등학교,교육부 경기도교육청 경기도안산교육지원청 본오초등학교,21,21,0,21,21,0,0,0
교육기관,교육부,본원초등학교,교육부 경기도교육청 경기도안산교육지원청 본원초등학교,18,18,0,18,13,5,0,0
교육기관,교육부,부곡고등학교,교육부 경기도교육청 경기도안산교육지원청 부곡고등학교,18,16,2,16,0,16,0,0
교육기관,교육부,뿌리유치원,교육부 경기도교육청 경기도안산교육지원청 뿌리유치원,21,21,0,21,21,0,0,0
교육기관,교육부,삼일초등학교,교육부 경기도교육청 경기도안산교육지원청 삼일초등학교,13,13,0,13,9,4,0,0
교육기관,교육부,상록고등학교,교육부 경기도교육청 경기도안산교육지원청 상록고등학교,47,47,0,47,40,7,0,0
교육기관,교육부,상록중학교,교육부 경기도교육청 경기도안산교육지원청 상록중학교,12,10,2,10,6,2,1,1
교육기관,교육부,상록초등학교,교육부 경기도교육청 경기도안산교육지원청 상록초등학교,22,22,0,22,20,2,0,0
교육기관,교육부,서원유치원,교육부 경기도교육청 경기도안산교육지원청 서원유치원,21,3,18,3,1,1,1,0
교육기관,교육부,석수중학교,교육부 경기도교육청 경기도안산교육지원청 석수중학교,19,17,2,17,15,2,0,0
교육기관,교육부,석호중학교,교육부 경기도교육청 경기도안산교육지원청 석호중학교,12,12,0,12,12,0,0,0
교육기관,교육부,석호초등학교,교육부 경기도교육청 경기도안산교육지원청 석호초등학교,24,24,0,24,24,0,0,0
교육기관,교육부,선부중학교,교육부 경기도교육청 경기도안산교육지원청 선부중학교,26,26,0,26,15,11,0,0
교육기관,교육부,선부초등학교,교육부 경기도교육청 경기도안산교육지원청 선부초등학교,20,20,0,20,0,20,0,0
교육기관,교육부,선일중학교,교육부 경기도교육청 경기도안산교육지원청 선일중학교,43,42,1,42,42,0,0,0
교육기관,교육부,선일초등학교,교육부 경기도교육청 경기도안산교육지원청 선일초등학교,19,19,0,19,19,0,0,0
교육기관,교육부,성안고등학교,교육부 경기도교육청 경기도안산교육지원청 성안고등학교,17,17,0,17,0,17,0,0
교육기관,교육부,성안중학교,교육부 경기도교육청 경기도안산교육지원청 성안중학교,16,16,0,16,14,2,0,0
교육기관,교육부,성포고등학교,교육부 경기도교육청 경기도안산교육지원청 성포고등학교,33,33,0,33,33,0,0,0
교육기관,교육부,성포중학교,교육부 경기도교육청 경기도안산교육지원청 성포중학교,19,19,0,19,10,9,0,0
교육기관,교육부,성포초등학교,교육부 경기도교육청 경기도안산교육지원청 성포초등학교,8,8,0,8,0,8,0,0
교육기관,교육부,세라숲유치원,교육부 경기도교육청 경기도안산교육지원청 세라숲유치원,32,5,27,5,2,1,1,1
교육기관,교육부,세라유치원,교육부 경기도교육청 경기도안산교육지원청 세라유치원,13,13,0,13,0,13,0,0
교육기관,교육부,송호고등학교,교육부 경기도교육청 경기도안산교육지원청 송호고등학교,16,16,0,16,16,0,0,0
교육기관,교육부,송호중학교,교육부 경기도교육청 경기도안산교육지원청 송호중학교,14,13,1,13,7,6,0,0
교육기관,교육부,송호초등학교,교육부 경기도교육청 경기도안산교육지원청 송호초등학교,11,11,0,11,11,0,0,0
교육기관,교육부,슬기초등학교,교육부 경기도교육청 경기도안산교육지원청 슬기초등학교,16,16,0,16,0,16,0,0
교육기관,교육부,시곡중학교,교육부 경기도교육청 경기도안산교육지원청 시곡중학교,23,23,0,23,0,23,0,0
교육기관,교육부,시곡초등학교,교육부 경기도교육청 경기도안산교육지원청 시곡초등학교,16,16,0,16,16,0,0,0
교육기관,교육부,시랑초등학교,교육부 경기도교육청 경기도안산교육지원청 시랑초등학교,14,14,0,14,14,0,0,0
교육기관,교육부,신길고등학교,교육부 경기도교육청 경기도안산교육지원청 신길고등학교,33,33,0,33,0,33,0,0
교육기관,교육부,신길중학교,교육부 경기도교육청 경기도안산교육지원청 신길중학교,19,17,2,17,11,6,0,0
교육기관,교육부,신길초등학교,교육부 경기도교육청 경기도안산교육지원청 신길초등학교,21,21,0,21,17,4,0,0
교육기관,교육부,안산강서고등학교,교육부 경기도교육청 경기도안산교육지원청 안산강서고등학교,77,77,0,77,17,60,0,0
교육기관,교육부,안산공업고등학교,교육부 경기도교육청 경기도안산교육지원청 안산공업고등학교,47,47,0,47,47,0,0,0
교육기관,교육부,안산광덕초등학교,교육부 경기도교육청 경기도안산교육지원청 안산광덕초등학교,20,20,0,20,20,0,0,0
교육기관,교육부,안산국제비즈니스고등학교,교육부 경기도교육청 경기도안산교육지원청 안산국제비즈니스고등학교,41,41,0,41,37,2,1,1
교육기관,교육부,안산나루유치원,교육부 경기도교육청 경기도안산교육지원청 안산나루유치원,5,5,0,5,0,5,0,0
교육기관,교육부,안산달빛유치원,교육부 경기도교육청 경기도안산교육지원청 안산달빛유치원,10,10,0,10,0,10,0,0
교육기관,교육부,안산대월초등학교,교육부 경기도교육청 경기도안산교육지원청 안산대월초등학교,21,21,0,21,21,0,0,0
교육기관,교육부,안산동산고등학교,교육부 경기도교육청 경기도안산교육지원청 안산동산고등학교,47,47,0,47,9,38,0,0
교육기관,교육부,안산디자인문화고등학교,교육부 경기도교육청 경기도안산교육지원청 안산디자인문화고등학교,43,43,0,43,0,43,0,0
교육기관,교육부,안산부곡중학교,교육부 경기도교육청 경기도안산교육지원청 안산부곡중학교,15,15,0,15,3,7,1,4
교육기관,교육부,안산서초등학교,교육부 경기도교육청 경기도안산교육지원청 안산서초등학교,20,20,0,20,7,13,0,0
교육기관,교육부,안산석수초등학교,교육부 경기도교육청 경기도안산교육지원청 안산석수초등학교,11,11,0,11,11,0,0,0
교육기관,교육부,안산성호중학교,교육부 경기도교육청 경기도안산교육지원청 안산성호중학교,22,21,1,21,4,15,2,0
교육기관,교육부,안산양지초등학교,교육부 경기도교육청 경기도안산교육지원청 안산양지초등학교,15,15,0,15,6,9,0,0
교육기관,교육부,안산원곡유치원,교육부 경기도교육청 경기도안산교육지원청 안산원곡유치원,3,3,0,3,0,3,0,0
교육기관,교육부,안산원곡초등학교,교육부 경기도교육청 경기도안산교육지원청 안산원곡초등학교,10,10,0,10,10,0,0,0
교육기관,교육부,안산중앙초등학교,교육부 경기도교육청 경기도안산교육지원청 안산중앙초등학교,15,15,0,15,0,15,0,0
교육기관,교육부,안산중학교,교육부 경기도교육청 경기도안산교육지원청 안산중학교,9,9,0,9,9,0,0,0
교육기관,교육부,안산진흥초등학교,교육부 경기도교육청 경기도안산교육지원청 안산진흥초등학교,9,9,0,9,7,2,0,0
교육기관,교육부,안산창촌초등학교,교육부 경기도교육청 경기도안산교육지원청 안산창촌초등학교,8,8,0,8,8,0,0,0
교육기관,교육부,안산청석초등학교,교육부 경기도교육청 경기도안산교육지원청 안산청석초등학교,10,10,0,10,10,0,0,0
교육기관,교육부,안산초등학교,교육부 경기도교육청 경기도안산교육지원청 안산초등학교,14,14,0,14,6,5,2,1
교육기관,교육부,안산해솔중학교,교육부 경기도교육청 경기도안산교육지원청 안산해솔중학교,14,14,0,14,1,13,0,0
교육기관,교육부,안산해솔초등학교,교육부 경기도교육청 경기도안산교육지원청 안산해솔초등학교,16,16,0,16,8,8,0,0
교육기관,교육부,안산해양중학교,교육부 경기도교육청 경기도안산교육지원청 안산해양중학교,25,25,0,25,9,16,0,0
교육기관,교육부,안산해양초등학교,교육부 경기도교육청 경기도안산교육지원청 안산해양초등학교,14,14,0,14,7,7,0,0
교육기관,교육부,안산호원초등학교,교육부 경기도교육청 경기도안산교육지원청 안산호원초등학교,12,12,0,12,0,12,0,0
교육기관,교육부,안산화정초등학교,교육부 경기도교육청 경기도안산교육지원청 안산화정초등학교,23,23,0,23,23,0,0,0
교육기관,교육부,양지고등학교,교육부 경기도교육청 경기도안산교육지원청 양지고등학교,25,25,0,25,10,15,0,0
교육기관,교육부,양지중학교,교육부 경기도교육청 경기도안산교육지원청 양지중학교,18,18,0,18,18,0,0,0
교육기관,교육부,와동중학교,교육부 경기도교육청 경기도안산교육지원청 와동중학교,12,10,2,10,0,10,0,0
교육기관,교육부,와동초등학교,교육부 경기도교육청 경기도안산교육지원청 와동초등학교,15,15,0,15,5,10,0,0
교육기관,교육부,원곡고등학교,교육부 경기도교육청 경기도안산교육지원청 원곡고등학교,33,33,0,33,5,18,5,5
교육기관,교육부,원곡중학교,교육부 경기도교육청 경기도안산교육지원청 원곡중학교,16,16,0,16,16,0,0,0
교육기관,교육부,원일중학교,교육부 경기도교육청 경기도안산교육지원청 원일중학교,17,16,1,16,16,0,0,0
교육기관,교육부,원일초등학교,교육부 경기도교육청 경기도안산교육지원청 원일초등학교,15,15,0,15,0,15,0,0
교육기관,교육부,이호중학교,교육부 경기도교육청 경기도안산교육지원청 이호중학교,23,23,0,23,17,6,0,0
교육기관,교육부,이호초등학교,교육부 경기도교육청 경기도안산교육지원청 이호초등학교,29,29,0,29,13,8,8,0
교육기관,교육부,자연유치원,교육부 경기도교육청 경기도안산교육지원청 자연유치원,32,32,0,32,6,26,0,0
교육기관,교육부,정지초등학교,교육부 경기도교육청 경기도안산교육지원청 정지초등학교,16,16,0,16,12,2,1,1
교육기관,교육부,제일유치원,교육부 경기도교육청 경기도안산교육지원청 제일유치원,32,32,0,32,3,29,0,0
교육기관,교육부,중앙유치원,교육부 경기도교육청 경기도안산교육지원청 중앙유치원,22,4,18,4,2,2,0,0
교육기관,교육부,중앙중학교,교육부 경기도교육청 경기도안산교육지원청 중앙중학교,24,24,0,24,24,0,0,0
교육기관,교육부,창의나라유치원,교육부 경기도교육청 경기도안산교육지원청 창의나라유치원,20,20,0,20,5,13,1,1
교육기관,교육부,초당초등학교,교육부 경기도교육청 경기도안산교육지원청 초당초등학교,16,16,0,16,8,8,0,0
교육기관,교육부,초원유치원,교육부 경기도교육청 경기도안산교육지원청 초원유치원,22,22,0,22,2,18,1,1
교육기관,교육부,초지고등학교,교육부 경기도교육청 경기도안산교육지원청 초지고등학교,37,37,0,37,0,37,0,0
교육기관,교육부,초지중학교,교육부 경기도교육청 경기도안산교육지원청 초지중학교,27,25,2,25,9,14,1,1
교육기관,교육부,초지초등학교,교육부 경기도교육청 경기도안산교육지원청 초지초등학교,16,16,0,16,16,0,0,0
교육기관,교육부,파란마음유치원,교육부 경기도교육청 경기도안산교육지원청 파란마음유치원,16,16,0,16,4,12,0,0
교육기관,교육부,팔곡초등학교,교육부 경기도교육청 경기도안산교육지원청 팔곡초등학교,15,15,0,15,15,0,0,0
교육기관,교육부,학현초등학교,교육부 경기도교육청 경기도안산교육지원청 학현초등학교,15,15,0,15,15,0,0,0
교육기관,교육부,해양유치원,교육부 경기도교육청 경기도안산교육지원청 해양유치원,7,7,0,7,5,2,0,0
교육기관,교육부,행복한유치원,교육부 경기도교육청 경기도안산교육지원청 행복한유치원,38,0,38,0,0,0,0,0
교육기관,교육부,호동초등학교,교육부 경기도교육청 경기도안산교육지원청 호동초등학교,23,23,0,23,5,18,0,0
교육기관,교육부,화랑초등학교,교육부 경기도교육청 경기도안산교육지원청 화랑초등학교,12,12,0,12,12,0,0,0
교육기관,교육부,경기도안성교육지원청,교육부 경기도교육청 경기도안성교육지원청,8,8,0,8,5,3,0,0
교육기관,교육부,가온고등학교,교육부 경기도교육청 경기도안성교육지원청 가온고등학교,122,122,0,122,122,0,0,0
교육기관,교육부,개산초등학교,교육부 경기도교육청 경기도안성교육지원청 개산초등학교,16,16,0,16,14,2,0,0
교육기관,교육부,개정초등학교,교육부 경기도교육청 경기도안성교육지원청 개정초등학교,16,16,0,16,16,0,0,0
교육기관,교육부,경기도교직원안성수덕원,교육부 경기도교육청 경기도안성교육지원청 경기도교직원안성수덕원,12,12,0,12,0,12,0,0
교육기관,교육부,경기창조고등학교,교육부 경기도교육청 경기도안성교육지원청 경기창조고등학교,50,50,0,50,10,40,0,0
교육기관,교육부,고삼초등학교,교육부 경기도교육청 경기도안성교육지원청 고삼초등학교,11,11,0,11,0,11,0,0
교육기관,교육부,공도중학교,교육부 경기도교육청 경기도안성교육지원청 공도중학교,41,41,0,41,20,21,0,0
교육기관,교육부,공도초등학교,교육부 경기도교육청 경기도안성교육지원청 공도초등학교,18,18,0,18,0,18,0,0
교육기관,교육부,광덕초등학교,교육부 경기도교육청 경기도안성교육지원청 광덕초등학교,29,29,0,29,0,29,0,0
교육기관,교육부,광선초등학교,교육부 경기도교육청 경기도안성교육지원청 광선초등학교,12,12,0,12,10,2,0,0
교육기관,교육부,금광초등학교,교육부 경기도교육청 경기도안성교육지원청 금광초등학교,14,14,0,14,14,0,0,0
교육기관,교육부,내혜홀초등학교,교육부 경기도교육청 경기도안성교육지원청 내혜홀초등학교,16,16,0,16,16,0,0,0
교육기관,교육부,대덕초등학교,교육부 경기도교육청 경기도안성교육지원청 대덕초등학교,14,14,0,14,7,7,0,0
교육기관,교육부,동신초등학교,교육부 경기도교육청 경기도안성교육지원청 동신초등학교,15,15,0,15,7,8,0,0
교육기관,교육부,두원공업고등학교,교육부 경기도교육청 경기도안성교육지원청 두원공업고등학교,53,53,0,53,13,40,0,0
교육기관,교육부,마전초등학교,교육부 경기도교육청 경기도안성교육지원청 마전초등학교,14,14,0,14,7,7,0,0
교육기관,교육부,만정중학교,교육부 경기도교육청 경기도안성교육지원청 만정중학교,41,40,1,40,22,18,0,0
교육기관,교육부,만정초등학교,교육부 경기도교육청 경기도안성교육지원청 만정초등학교,31,31,0,31,31,0,0,0
교육기관,교육부,명덕초등학교,교육부 경기도교육청 경기도안성교육지원청 명덕초등학교,12,10,2,10,3,5,1,1
교육기관,교육부,명륜여자중학교,교육부 경기도교육청 경기도안성교육지원청 명륜여자중학교,14,5,9,5,5,0,0,0
교육기관,교육부,문기초등학교,교육부 경기도교육청 경기도안성교육지원청 문기초등학교,9,9,0,9,9,0,0,0
교육기관,교육부,미곡초등학교,교육부 경기도교육청 경기도안성교육지원청 미곡초등학교,8,8,0,8,2,6,0,0
교육기관,교육부,미양초등학교,교육부 경기도교육청 경기도안성교육지원청 미양초등학교,12,12,0,12,0,12,0,0
교육기관,교육부,백성초등학교,교육부 경기도교육청 경기도안성교육지원청 백성초등학교,26,26,0,26,0,26,0,0
교육기관,교육부,별빛누리유치원,교육부 경기도교육청 경기도안성교육지원청 별빛누리유치원,16,7,9,7,2,2,2,1
교육기관,교육부,보개초등학교,교육부 경기도교육청 경기도안성교육지원청 보개초등학교,15,15,0,15,0,15,0,0
교육기관,교육부,보체초등학교,교육부 경기도교육청 경기도안성교육지원청 보체초등학교,17,17,0,17,17,0,0,0
교육기관,교육부,봄누리유치원,교육부 경기도교육청 경기도안성교육지원청 봄누리유치원,10,10,0,10,3,7,0,0
교육기관,교육부,비룡중학교,교육부 경기도교육청 경기도안성교육지원청 비룡중학교,51,50,1,50,0,50,0,0
교육기관,교육부,비룡초등학교,교육부 경기도교육청 경기도안성교육지원청 비룡초등학교,18,18,0,18,18,0,0,0
교육기관,교육부,산평초등학교,교육부 경기도교육청 경기도안성교육지원청 산평초등학교,8,8,0,8,8,0,0,0
교육기관,교육부,삼죽초등학교,교육부 경기도교육청 경기도안성교육지원청 삼죽초등학교,10,10,0,10,10,0,0,0
교육기관,교육부,서운중학교,교육부 경기도교육청 경기도안성교육지원청 서운중학교,10,8,2,8,4,4,0,0
교육기관,교육부,서운초등학교,교육부 경기도교육청 경기도안성교육지원청 서운초등학교,13,13,0,13,6,6,1,0
교육기관,교육부,성모유치원,교육부 경기도교육청 경기도안성교육지원청 성모유치원,11,11,0,11,2,9,0,0
교육기관,교육부,안법고등학교,교육부 경기도교육청 경기도안성교육지원청 안법고등학교,68,20,48,20,14,6,0,0
교육기관,교육부,안성고등학교,교육부 경기도교육청 경기도안성교육지원청 안성고등학교,27,27,0,27,27,0,0,0
교육기관,교육부,안성여자고등학교,교육부 경기도교육청 경기도안성교육지원청 안성여자고등학교,29,29,0,29,27,2,0,0
교육기관,교육부,안성여자중학교,교육부 경기도교육청 경기도안성교육지원청 안성여자중학교,43,43,0,43,33,10,0,0
교육기관,교육부,안성중학교,교육부 경기도교육청 경기도안성교육지원청 안성중학교,21,21,0,21,15,6,0,0
교육기관,교육부,안성초등학교,교육부 경기도교육청 경기도안성교육지원청 안성초등학교,24,24,0,24,0,24,0,0
교육기관,교육부,안청중학교,교육부 경기도교육청 경기도안성교육지원청 안청중학교,40,2,38,2,1,1,0,0
교육기관,교육부,양성중학교,교육부 경기도교육청 경기도안성교육지원청 양성중학교,12,11,1,11,3,8,0,0
교육기관,교육부,양성초등학교,교육부 경기도교육청 경기도안성교육지원청 양성초등학교,12,12,0,12,12,0,0,0
교육기관,교육부,양진중학교,교육부 경기도교육청 경기도안성교육지원청 양진중학교,30,29,1,29,15,14,0,0
교육기관,교육부,어울초등학교,교육부 경기도교육청 경기도안성교육지원청 어울초등학교,21,21,0,21,11,10,0,0
교육기관,교육부,엄마사랑유치원,교육부 경기도교육청 경기도안성교육지원청 엄마사랑유치원,30,30,0,30,0,30,0,0
교육기관,교육부,용머리초등학교,교육부 경기도교육청 경기도안성교육지원청 용머리초등학교,12,12,0,12,0,12,0,0
교육기관,교육부,원곡초등학교,교육부 경기도교육청 경기도안성교육지원청 원곡초등학교,14,14,0,14,0,14,0,0
교육기관,교육부,일죽고등학교,교육부 경기도교육청 경기도안성교육지원청 일죽고등학교,23,23,0,23,0,23,0,0
교육기관,교육부,일죽중학교,교육부 경기도교육청 경기도안성교육지원청 일죽중학교,24,24,0,24,0,24,0,0
교육기관,교육부,일죽초등학교,교육부 경기도교육청 경기도안성교육지원청 일죽초등학교,21,21,0,21,11,10,0,0
교육기관,교육부,죽산고등학교,교육부 경기도교육청 경기도안성교육지원청 죽산고등학교,14,14,0,14,0,14,0,0
교육기관,교육부,죽산초등학교,교육부 경기도교육청 경기도안성교육지원청 죽산초등학교,13,13,0,13,13,0,0,0
교육기관,교육부,죽화초등학교,교육부 경기도교육청 경기도안성교육지원청 죽화초등학교,10,10,0,10,7,3,0,0
교육기관,교육부,파랑새유치원,교육부 경기도교육청 경기도안성교육지원청 파랑새유치원,21,21,0,21,1,16,2,2
교육기관,교육부,한겨레고등학교,교육부 경기도교육청 경기도안성교육지원청 한겨레고등학교,85,83,2,83,6,75,1,1
교육기관,교육부,한길학교,교육부 경기도교육청 경기도안성교육지원청 한길학교,30,30,0,30,7,23,0,0
교육기관,교육부,현매초등학교,교육부 경기도교육청 경기도안성교육지원청 현매초등학교,11,11,0,11,9,2,0,0
교육기관,교육부,건영무궁화유치원,교육부 경기도교육청 경기도안양과천교육지원청 건영무궁화유치원,9,9,0,9,8,1,0,0
교육기관,교육부,경기게임마이스터고등학교,교육부 경기도교육청 경기도안양과천교육지원청 경기게임마이스터고등학교,86,85,1,85,9,72,4,0
교육기관,교육부,과천갈현초등학교,교육부 경기도교육청 경기도안양과천교육지원청 과천갈현초등학교,32,32,0,32,16,16,0,0
교육기관,교육부,과천고등학교,교육부 경기도교육청 경기도안양과천교육지원청 과천고등학교,38,37,1,37,2,30,2,3
교육기관,교육부,과천노들유치원,교육부 경기도교육청 경기도안양과천교육지원청 과천노들유치원,16,2,14,2,1,1,0,0
교육기관,교육부,과천문원중학교,교육부 경기도교육청 경기도안양과천교육지원청 과천문원중학교,11,11,0,11,5,6,0,0
교육기관,교육부,과천여자고등학교,교육부 경기도교육청 경기도안양과천교육지원청 과천여자고등학교,47,46,1,46,0,46,0,0
교육기관,교육부,과천외국어고등학교,교육부 경기도교육청 경기도안양과천교육지원청 과천외국어고등학교,50,50,0,50,0,50,0,0
교육기관,교육부,과천중앙고등학교,교육부 경기도교육청 경기도안양과천교육지원청 과천중앙고등학교,31,31,0,31,22,9,0,0
교육기관,교육부,과천중학교,교육부 경기도교육청 경기도안양과천교육지원청 과천중학교,29,27,2,27,15,8,4,0
교육기관,교육부,과천초등학교,교육부 경기도교육청 경기도안양과천교육지원청 과천초등학교,25,25,0,25,25,0,0,0
교육기관,교육부,관문초등학교,교육부 경기도교육청 경기도안양과천교육지원청 관문초등학교,11,11,0,11,11,0,0,0
교육기관,교육부,관양고등학교,교육부 경기도교육청 경기도안양과천교육지원청 관양고등학교,38,38,0,38,38,0,0,0
교육기관,교육부,관양중학교,교육부 경기도교육청 경기도안양과천교육지원청 관양중학교,18,16,2,16,14,2,0,0
교육기관,교육부,관양초등학교,교육부 경기도교육청 경기도안양과천교육지원청 관양초등학교,19,19,0,19,19,0,0,0
교육기관,교육부,귀인중학교,교육부 경기도교육청 경기도안양과천교육지원청 귀인중학교,9,9,0,9,4,5,0,0
교육기관,교육부,귀인초등학교,교육부 경기도교육청 경기도안양과천교육지원청 귀인초등학교,15,15,0,15,0,15,0,0
교육기관,교육부,근명고등학교,교육부 경기도교육청 경기도안양과천교육지원청 근명고등학교,38,38,0,38,21,13,2,2
교육기관,교육부,근명중학교,교육부 경기도교육청 경기도안양과천교육지원청 근명중학교,64,64,0,64,16,48,0,0
교육기관,교육부,금빛유치원,교육부 경기도교육청 경기도안양과천교육지원청 금빛유치원,20,20,0,20,4,16,0,0
교육기관,교육부,꿈마을유치원,교육부 경기도교육청 경기도안양과천교육지원청 꿈마을유치원,16,0,16,0,0,0,0,0
교육기관,교육부,꿈열매유치원,교육부 경기도교육청 경기도안양과천교육지원청 꿈열매유치원,12,0,12,0,0,0,0,0
교육기관,교육부,나눔초등학교,교육부 경기도교육청 경기도안양과천교육지원청 나눔초등학교,10,10,0,10,0,10,0,0
교육기관,교육부,늘푸른유치원,교육부 경기도교육청 경기도안양과천교육지원청 늘푸른유치원,16,16,0,16,4,12,0,0
교육기관,교육부,달안초등학교,교육부 경기도교육청 경기도안양과천교육지원청 달안초등학교,30,30,0,30,30,0,0,0
교육기관,교육부,대림유치원,교육부 경기도교육청 경기도안양과천교육지원청 대림유치원,16,16,0,16,8,8,0,0
교육기관,교육부,대안여자중학교,교육부 경기도교육청 경기도안양과천교육지원청 대안여자중학교,9,8,1,8,0,4,2,2
교육기관,교육부,대안중학교,교육부 경기도교육청 경기도안양과천교육지원청 대안중학교,20,20,0,20,10,6,2,2
교육기관,교육부,덕천초등학교,교육부 경기도교육청 경기도안양과천교육지원청 덕천초등학교,13,13,0,13,7,6,0,0
교육기관,교육부,돈보스코유치원,교육부 경기도교육청 경기도안양과천교육지원청 돈보스코유치원,8,4,4,4,1,3,0,0
교육기관,교육부,동안고등학교,교육부 경기도교육청 경기도안양과천교육지원청 동안고등학교,16,14,2,14,13,1,0,0
교육기관,교육부,동안초등학교,교육부 경기도교육청 경기도안양과천교육지원청 동안초등학교,16,16,0,16,16,0,0,0
교육기관,교육부,동은유치원,교육부 경기도교육청 경기도안양과천교육지원청 동은유치원,12,12,0,12,3,9,0,0
교육기관,교육부,동편유치원,교육부 경기도교육청 경기도안양과천교육지원청 동편유치원,8,4,4,4,0,4,0,0
교육기관,교육부,만안유치원,교육부 경기도교육청 경기도안양과천교육지원청 만안유치원,16,5,11,5,1,2,1,1
교육기관,교육부,만안초등학교,교육부 경기도교육청 경기도안양과천교육지원청 만안초등학교,20,20,0,20,14,6,0,0
교육기관,교육부,명학초등학교,교육부 경기도교육청 경기도안양과천교육지원청 명학초등학교,14,14,0,14,14,0,0,0
교육기관,교육부,모심유치원,교육부 경기도교육청 경기도안양과천교육지원청 모심유치원,11,2,9,2,2,0,0,0
교육기관,교육부,문원초등학교,교육부 경기도교육청 경기도안양과천교육지원청 문원초등학교,15,15,0,15,7,3,4,1
교육기관,교육부,미림유치원,교육부 경기도교육청 경기도안양과천교육지원청 미림유치원,23,23,0,23,4,17,1,1
교육기관,교육부,민들레유치원,교육부 경기도교육청 경기도안양과천교육지원청 민들레유치원,13,2,11,2,1,1,0,0
교육기관,교육부,민백유치원,교육부 경기도교육청 경기도안양과천교육지원청 민백유치원,12,12,0,12,0,12,0,0
교육기관,교육부,민백초등학교,교육부 경기도교육청 경기도안양과천교육지원청 민백초등학교,14,14,0,14,14,0,0,0
교육기관,교육부,박달중학교,교육부 경기도교육청 경기도안양과천교육지원청 박달중학교,17,17,0,17,11,6,0,0
교육기관,교육부,박달초등학교,교육부 경기도교육청 경기도안양과천교육지원청 박달초등학교,15,15,0,15,0,15,0,0
교육기관,교육부,백영고등학교,교육부 경기도교육청 경기도안양과천교육지원청 백영고등학교,29,29,0,29,27,2,0,0
교육기관,교육부,벌말초등학교,교육부 경기도교육청 경기도안양과천교육지원청 벌말초등학교,18,18,0,18,18,0,0,0
교육기관,교육부,범계중학교,교육부 경기도교육청 경기도안양과천교육지원청 범계중학교,16,16,0,16,10,6,0,0
교육기관,교육부,범계초등학교,교육부 경기도교육청 경기도안양과천교육지원청 범계초등학교,14,12,2,12,2,8,1,1
교육기관,교육부,보라유치원,교육부 경기도교육청 경기도안양과천교육지원청 보라유치원,10,6,4,6,0,6,0,0
교육기관,교육부,부림중학교,교육부 경기도교육청 경기도안양과천교육지원청 부림중학교,23,21,2,21,21,0,0,0
교육기관,교육부,부림초등학교,교육부 경기도교육청 경기도안양과천교육지원청 부림초등학교,43,16,27,16,0,16,0,0
교육기관,교육부,부안중학교,교육부 경기도교육청 경기도안양과천교육지원청 부안중학교,15,14,1,14,14,0,0,0
교육기관,교육부,부흥고등학교,교육부 경기도교육청 경기도안양과천교육지원청 부흥고등학교,15,15,0,15,7,6,1,1
교육기관,교육부,비산성모유치원,교육부 경기도교육청 경기도안양과천교육지원청 비산성모유치원,22,22,0,22,0,22,0,0
교육기관,교육부,비산중학교,교육부 경기도교육청 경기도안양과천교육지원청 비산중학교,34,34,0,34,10,20,4,0
교육기관,교육부,비산초등학교,교육부 경기도교육청 경기도안양과천교육지원청 비산초등학교,16,16,0,16,0,16,0,0
교육기관,교육부,삼봉초등학교,교육부 경기도교육청 경기도안양과천교육지원청 삼봉초등학교,13,13,0,13,8,5,0,0
교육기관,교육부,삼성초등학교,교육부 경기도교육청 경기도안양과천교육지원청 삼성초등학교,21,21,0,21,16,5,0,0
교육기관,교육부,샘모루초등학교,교육부 경기도교육청 경기도안양과천교육지원청 샘모루초등학교,9,9,0,9,9,0,0,0
교육기관,교육부,석수초등학교,교육부 경기도교육청 경기도안양과천교육지원청 석수초등학교,16,16,0,16,16,0,0,0
교육기관,교육부,성결유치원,교육부 경기도교육청 경기도안양과천교육지원청 성결유치원,21,21,0,21,0,21,0,0
교육기관,교육부,성문고등학교,교육부 경기도교육청 경기도안양과천교육지원청 성문고등학교,16,16,0,16,0,16,0,0
교육기관,교육부,성문중학교,교육부 경기도교육청 경기도안양과천교육지원청 성문중학교,20,20,0,20,20,0,0,0
교육기관,교육부,성원유치원,교육부 경기도교육청 경기도안양과천교육지원청 성원유치원,16,3,13,3,2,0,0,1
교육기관,교육부,신기중학교,교육부 경기도교육청 경기도안양과천교육지원청 신기중학교,17,17,0,17,17,0,0,0
교육기관,교육부,신성고등학교,교육부 경기도교육청 경기도안양과천교육지원청 신성고등학교,112,112,0,112,57,50,3,2
교육기관,교육부,신성중학교,교육부 경기도교육청 경기도안양과천교육지원청 신성중학교,71,71,0,71,42,29,0,0
교육기관,교육부,신안중학교,교육부 경기도교육청 경기도안양과천교육지원청 신안중학교,9,8,1,8,3,5,0,0
교육기관,교육부,신안초등학교,교육부 경기도교육청 경기도안양과천교육지원청 신안초등학교,17,17,0,17,7,10,0,0
교육기관,교육부,신일유치원,교육부 경기도교육청 경기도안양과천교육지원청 신일유치원,11,11,0,11,0,11,0,0
교육기관,교육부,아이비유치원,교육부 경기도교육청 경기도안양과천교육지원청 아이비유치원,12,12,0,12,7,5,0,0
교육기관,교육부,안양고등학교,교육부 경기도교육청 경기도안양과천교육지원청 안양고등학교,36,36,0,36,12,24,0,0
교육기관,교육부,안양공업고등학교,교육부 경기도교육청 경기도안양과천교육지원청 안양공업고등학교,88,88,0,88,0,88,0,0
교육기관,교육부,안양관악초등학교,교육부 경기도교육청 경기도안양과천교육지원청 안양관악초등학교,14,14,0,14,10,4,0,0
교육기관,교육부,안양남초등학교,교육부 경기도교육청 경기도안양과천교육지원청 안양남초등학교,20,20,0,20,10,10,0,0
교육기관,교육부,안양덕현초등학교,교육부 경기도교육청 경기도안양과천교육지원청 안양덕현초등학교,16,16,0,16,14,2,0,0
교육기관,교육부,안양동초등학교,교육부 경기도교육청 경기도안양과천교육지원청 안양동초등학교,25,25,0,25,15,10,0,0
교육기관,교육부,안양문화고등학교,교육부 경기도교육청 경기도안양과천교육지원청 안양문화고등학교,20,20,0,20,0,20,0,0
교육기관,교육부,안양부안초등학교,교육부 경기도교육청 경기도안양과천교육지원청 안양부안초등학교,12,12,0,12,6,5,1,0
교육기관,교육부,안양부흥초등학교,교육부 경기도교육청 경기도안양과천교육지원청 안양부흥초등학교,12,12,0,12,12,0,0,0
교육기관,교육부,안양상업고등학교,교육부 경기도교육청 경기도안양과천교육지원청 안양상업고등학교,10,10,0,10,10,0,0,0
교육기관,교육부,안양샘유치원,교육부 경기도교육청 경기도안양과천교육지원청 안양샘유치원,8,8,0,8,2,6,0,0
교육기관,교육부,안양서중학교,교육부 경기도교육청 경기도안양과천교육지원청 안양서중학교,20,20,0,20,14,6,0,0
교육기관,교육부,안양서초등학교,교육부 경기도교육청 경기도안양과천교육지원청 안양서초등학교,23,23,0,23,23,0,0,0
교육기관,교육부,안양신기초등학교,교육부 경기도교육청 경기도안양과천교육지원청 안양신기초등학교,16,16,0,16,16,0,0,0
교육기관,교육부,안양양지초등학교,교육부 경기도교육청 경기도안양과천교육지원청 안양양지초등학교,20,20,0,20,20,0,0,0
교육기관,교육부,안양여자고등학교,교육부 경기도교육청 경기도안양과천교육지원청 안양여자고등학교,19,18,1,18,13,5,0,0
교육기관,교육부,안양여자중학교,교육부 경기도교육청 경기도안양과천교육지원청 안양여자중학교,24,24,0,24,24,0,0,0
교육기관,교육부,안양예술고등학교,교육부 경기도교육청 경기도안양과천교육지원청 안양예술고등학교,46,46,0,46,4,42,0,0
교육기관,교육부,안양외국어고등학교,교육부 경기도교육청 경기도안양과천교육지원청 안양외국어고등학교,8,8,0,8,8,0,0,0
교육기관,교육부,안양유치원,교육부 경기도교육청 경기도안양과천교육지원청 안양유치원,14,5,9,5,0,5,0,0
교육기관,교육부,안양중앙초등학교,교육부 경기도교육청 경기도안양과천교육지원청 안양중앙초등학교,10,10,0,10,5,5,0,0
교육기관,교육부,안양중학교,교육부 경기도교육청 경기도안양과천교육지원청 안양중학교,30,30,0,30,0,30,0,0
교육기관,교육부,안양초등학교,교육부 경기도교육청 경기도안양과천교육지원청 안양초등학교,24,24,0,24,2,22,0,0
교육기관,교육부,안양해솔학교,교육부 경기도교육청 경기도안양과천교육지원청 안양해솔학교,18,18,0,18,18,0,0,0
교육기관,교육부,안양호암초등학교,교육부 경기도교육청 경기도안양과천교육지원청 안양호암초등학교,10,10,0,10,5,5,0,0
교육기관,교육부,안일초등학교,교육부 경기도교육청 경기도안양과천교육지원청 안일초등학교,17,17,0,17,17,0,0,0
교육기관,교육부,양명고등학교,교육부 경기도교육청 경기도안양과천교육지원청 양명고등학교,57,57,0,57,0,57,0,0
교육기관,교육부,양명여자고등학교,교육부 경기도교육청 경기도안양과천교육지원청 양명여자고등학교,67,67,0,67,0,67,0,0
교육기관,교육부,연성대학교부속유치원,교육부 경기도교육청 경기도안양과천교육지원청 연성대학교부속유치원,27,7,20,7,0,7,0,0
교육기관,교육부,연현중학교,교육부 경기도교육청 경기도안양과천교육지원청 연현중학교,18,17,1,17,12,5,0,0
교육기관,교육부,연현초등학교,교육부 경기도교육청 경기도안양과천교육지원청 연현초등학교,13,13,0,13,13,0,0,0
교육기관,교육부,예나유치원,교육부 경기도교육청 경기도안양과천교육지원청 예나유치원,12,1,11,1,1,0,0,0
교육기관,교육부,예인유치원,교육부 경기도교육청 경기도안양과천교육지원청 예인유치원,15,15,0,15,8,7,0,0
교육기관,교육부,예지유치원,교육부 경기도교육청 경기도안양과천교육지원청 예지유치원,12,12,0,12,0,12,0,0
교육기관,교육부,우암숲유치원,교육부 경기도교육청 경기도안양과천교육지원청 우암숲유치원,8,3,5,3,1,1,0,1
교육기관,교육부,유일유치원,교육부 경기도교육청 경기도안양과천교육지원청 유일유치원,19,19,0,19,0,19,0,0
교육기관,교육부,은하수숲유치원,교육부 경기도교육청 경기도안양과천교육지원청 은하수숲유치원,10,1,9,1,0,1,0,0
교육기관,교육부,인덕원고등학교,교육부 경기도교육청 경기도안양과천교육지원청 인덕원고등학교,29,28,1,28,8,20,0,0
교육기관,교육부,인덕원중학교,교육부 경기도교육청 경기도안양과천교육지원청 인덕원중학교,16,16,0,16,1,15,0,0
교육기관,교육부,인덕원초등학교,교육부 경기도교육청 경기도안양과천교육지원청 인덕원초등학교,9,9,0,9,8,1,0,0
교육기관,교육부,일심유치원,교육부 경기도교육청 경기도안양과천교육지원청 일심유치원,16,10,6,10,1,9,0,0
교육기관,교육부,임곡중학교,교육부 경기도교육청 경기도안양과천교육지원청 임곡중학교,39,39,0,39,0,39,0,0
교육기관,교육부,중원유치원,교육부 경기도교육청 경기도안양과천교육지원청 중원유치원,16,16,0,16,1,15,0,0
교육기관,교육부,창의나라유치원,교육부 경기도교육청 경기도안양과천교육지원청 창의나라유치원,16,2,14,2,0,2,0,0
교육기관,교육부,천사유치원,교육부 경기도교육청 경기도안양과천교육지원청 천사유치원,4,4,0,4,2,2,0,0
교육기관,교육부,청계초등학교,교육부 경기도교육청 경기도안양과천교육지원청 청계초등학교,16,16,0,16,2,14,0,0
교육기관,교육부,충훈고등학교,교육부 경기도교육청 경기도안양과천교육지원청 충훈고등학교,24,23,1,23,8,15,0,0
교육기관,교육부,키즈브라운유치원,교육부 경기도교육청 경기도안양과천교육지원청 키즈브라운유치원,8,8,0,8,2,6,0,0
교육기관,교육부,평촌경영고등학교,교육부 경기도교육청 경기도안양과천교육지원청 평촌경영고등학교,14,14,0,14,0,14,0,0
교육기관,교육부,평촌고등학교,교육부 경기도교육청 경기도안양과천교육지원청 평촌고등학교,41,40,1,40,1,39,0,0
교육기관,교육부,평촌공업고등학교,교육부 경기도교육청 경기도안양과천교육지원청 평촌공업고등학교,56,56,0,56,46,10,0,0
교육기관,교육부,평촌중학교,교육부 경기도교육청 경기도안양과천교육지원청 평촌중학교,46,46,0,46,0,46,0,0
교육기관,교육부,평촌초등학교,교육부 경기도교육청 경기도안양과천교육지원청 평촌초등학교,15,15,0,15,12,3,0,0
교육기관,교육부,하나유치원,교육부 경기도교육청 경기도안양과천교육지원청 하나유치원,12,12,0,12,10,2,0,0
교육기관,교육부,한라유치원,교육부 경기도교육청 경기도안양과천교육지원청 한라유치원,16,16,0,16,0,16,0,0
교육기관,교육부,한림유치원,교육부 경기도교육청 경기도안양과천교육지원청 한림유치원,16,5,11,5,2,1,1,1
교육기관,교육부,한별유치원,교육부 경기도교육청 경기도안양과천교육지원청 한별유치원,8,8,0,8,3,5,0,0
교육기관,교육부,한양샛별유치원,교육부 경기도교육청 경기도안양과천교육지원청 한양샛별유치원,8,0,8,0,0,0,0,0
교육기관,교육부,해관유치원,교육부 경기도교육청 경기도안양과천교육지원청 해관유치원,16,16,0,16,0,16,0,0
교육기관,교육부,해오름초등학교,교육부 경기도교육청 경기도안양과천교육지원청 해오름초등학교,13,13,0,13,12,1,0,0
교육기관,교육부,햇빛유치원,교육부 경기도교육청 경기도안양과천교육지원청 햇빛유치원,15,15,0,15,2,13,0,0
교육기관,교육부,호계중학교,교육부 경기도교육청 경기도안양과천교육지원청 호계중학교,21,20,1,20,15,5,0,0
교육기관,교육부,호계초등학교,교육부 경기도교육청 경기도안양과천교육지원청 호계초등학교,15,15,0,15,15,0,0,0
교육기관,교육부,호성중학교,교육부 경기도교육청 경기도안양과천교육지원청 호성중학교,12,11,1,11,11,0,0,0
교육기관,교육부,호성초등학교,교육부 경기도교육청 경기도안양과천교육지원청 호성초등학교,16,16,0,16,2,14,0,0
교육기관,교육부,호원초등학교,교육부 경기도교육청 경기도안양과천교육지원청 호원초등학교,20,20,0,20,10,10,0,0
교육기관,교육부,화창초등학교,교육부 경기도교육청 경기도안양과천교육지원청 화창초등학교,13,13,0,13,13,0,0,0
교육기관,교육부,희성초등학교,교육부 경기도교육청 경기도안양과천교육지원청 희성초등학교,16,15,1,15,8,7,0,0
교육기관,교육부,강상초등학교,교육부 경기도교육청 경기도양평교육지원청 강상초등학교,17,17,0,17,11,6,0,0
교육기관,교육부,강하중학교,교육부 경기도교육청 경기도양평교육지원청 강하중학교,18,17,1,17,0,17,0,0
교육기관,교육부,강하초등학교,교육부 경기도교육청 경기도양평교육지원청 강하초등학교,21,21,0,21,13,8,0,0
교육기관,교육부,개군중학교,교육부 경기도교육청 경기도양평교육지원청 개군중학교,11,11,0,11,6,5,0,0
교육기관,교육부,개군초등학교,교육부 경기도교육청 경기도양평교육지원청 개군초등학교,8,8,0,8,8,0,0,0
교육기관,교육부,곡수초등학교,교육부 경기도교육청 경기도양평교육지원청 곡수초등학교,8,8,0,8,8,0,0,0
교육기관,교육부,국수중학교,교육부 경기도교육청 경기도양평교육지원청 국수중학교,9,0,9,0,0,0,0,0
교육기관,교육부,다문초등학교,교육부 경기도교육청 경기도양평교육지원청 다문초등학교,19,19,0,19,15,2,1,1
교육기관,교육부,단월중학교,교육부 경기도교육청 경기도양평교육지원청 단월중학교,14,13,1,13,0,13,0,0
교육기관,교육부,대아초등학교,교육부 경기도교육청 경기도양평교육지원청 대아초등학교,10,10,0,10,5,5,0,0
교육기관,교육부,동산유치원,교육부 경기도교육청 경기도양평교육지원청 동산유치원,7,7,0,7,3,2,1,1
교육기관,교육부,서종중학교,교육부 경기도교육청 경기도양평교육지원청 서종중학교,27,27,0,27,18,9,0,0
교육기관,교육부,서종초등학교,교육부 경기도교육청 경기도양평교육지원청 서종초등학교,16,16,0,16,0,16,0,0
교육기관,교육부,세월초등학교,교육부 경기도교육청 경기도양평교육지원청 세월초등학교,12,12,0,12,0,12,0,0
교육기관,교육부,수입초등학교,교육부 경기도교육청 경기도양평교육지원청 수입초등학교,15,15,0,15,0,15,0,0
교육기관,교육부,양동고등학교,교육부 경기도교육청 경기도양평교육지원청 양동고등학교,8,8,0,8,5,3,0,0
교육기관,교육부,양동중학교,교육부 경기도교육청 경기도양평교육지원청 양동중학교,8,8,0,8,4,4,0,0
교육기관,교육부,양동초등학교,교육부 경기도교육청 경기도양평교육지원청 양동초등학교,10,10,0,10,10,0,0,0
교육기관,교육부,양동초등학교고송분교장,교육부 경기도교육청 경기도양평교육지원청 양동초등학교고송분교장,8,8,0,8,8,0,0,0
교육기관,교육부,양서고등학교,교육부 경기도교육청 경기도양평교육지원청 양서고등학교,120,120,0,120,0,120,0,0
교육기관,교육부,양서초등학교,교육부 경기도교육청 경기도양평교육지원청 양서초등학교,6,6,0,6,6,0,0,0
교육기관,교육부,양수중학교,교육부 경기도교육청 경기도양평교육지원청 양수중학교,16,16,0,16,16,0,0,0
교육기관,교육부,양수초등학교,교육부 경기도교육청 경기도양평교육지원청 양수초등학교,17,17,0,17,1,16,0,0
교육기관,교육부,양일고등학교,교육부 경기도교육청 경기도양평교육지원청 양일고등학교,43,43,0,43,33,10,0,0
교육기관,교육부,양평고등학교,교육부 경기도교육청 경기도양평교육지원청 양평고등학교,38,38,0,38,0,38,0,0
교육기관,교육부,양평단월초등학교,교육부 경기도교육청 경기도양평교육지원청 양평단월초등학교,9,9,0,9,9,0,0,0
교육기관,교육부,양평유치원,교육부 경기도교육청 경기도양평교육지원청 양평유치원,8,8,0,8,5,3,0,0
교육기관,교육부,양평전자과학고등학교,교육부 경기도교육청 경기도양평교육지원청 양평전자과학고등학교,10,10,0,10,10,0,0,0
교육기관,교육부,양평중학교,교육부 경기도교육청 경기도양평교육지원청 양평중학교,32,31,1,31,0,31,0,0
교육기관,교육부,양평초등학교,교육부 경기도교육청 경기도양평교육지원청 양평초등학교,25,25,0,25,14,11,0,0
교육기관,교육부,옥천초등학교,교육부 경기도교육청 경기도양평교육지원청 옥천초등학교,14,14,0,14,14,0,0,0
교육기관,교육부,용문고등학교,교육부 경기도교육청 경기도양평교육지원청 용문고등학교,71,71,0,71,41,30,0,0
교육기관,교육부,용문중학교,교육부 경기도교육청 경기도양평교육지원청 용문중학교,19,18,1,18,1,15,1,1
교육기관,교육부,용문초등학교,교육부 경기도교육청 경기도양평교육지원청 용문초등학교,16,16,0,16,16,0,0,0
교육기관,교육부,원덕초등학교,교육부 경기도교육청 경기도양평교육지원청 원덕초등학교,8,8,0,8,5,3,0,0
교육기관,교육부,정배초등학교,교육부 경기도교육청 경기도양평교육지원청 정배초등학교,19,19,0,19,19,0,0,0
교육기관,교육부,조현초등학교,교육부 경기도교육청 경기도양평교육지원청 조현초등학교,7,6,1,6,6,0,0,0
교육기관,교육부,지평고등학교,교육부 경기도교육청 경기도양평교육지원청 지평고등학교,14,13,1,13,5,6,1,1
교육기관,교육부,지평중학교,교육부 경기도교육청 경기도양평교육지원청 지평중학교,3,3,0,3,3,0,0,0
교육기관,교육부,지평초등학교,교육부 경기도교육청 경기도양평교육지원청 지평초등학교,9,9,0,9,9,0,0,0
교육기관,교육부,창인학교,교육부 경기도교육청 경기도양평교육지원청 창인학교,40,40,0,40,10,30,0,0
교육기관,교육부,청운고등학교,교육부 경기도교육청 경기도양평교육지원청 청운고등학교,8,8,0,8,6,1,1,0
교육기관,교육부,청운중학교,교육부 경기도교육청 경기도양평교육지원청 청운중학교,5,5,0,5,5,0,0,0
교육기관,교육부,청운초등학교,교육부 경기도교육청 경기도양평교육지원청 청운초등학교,12,12,0,12,12,0,0,0
교육기관,교육부,경기도여주교육지원청,교육부 경기도교육청 경기도여주교육지원청,11,11,0,11,11,0,0,0
교육기관,교육부,가남초등학교,교육부 경기도교육청 경기도여주교육지원청 가남초등학교,18,18,0,18,0,18,0,0
교육기관,교육부,강천중학교,교육부 경기도교육청 경기도여주교육지원청 강천중학교,22,22,0,22,13,9,0,0
교육기관,교육부,강천초등학교,교육부 경기도교육청 경기도여주교육지원청 강천초등학교,9,9,0,9,9,0,0,0
교육기관,교육부,경기관광고등학교,교육부 경기도교육청 경기도여주교육지원청 경기관광고등학교,47,46,1,46,33,13,0,0
교육기관,교육부,금당초등학교,교육부 경기도교육청 경기도여주교육지원청 금당초등학교,4,4,0,4,3,1,0,0
교육기관,교육부,능북초등학교,교육부 경기도교육청 경기도여주교육지원청 능북초등학교,15,15,0,15,8,7,0,0
교육기관,교육부,능서초등학교,교육부 경기도교육청 경기도여주교육지원청 능서초등학교,8,8,0,8,4,4,0,0
교육기관,교육부,능현유치원,교육부 경기도교육청 경기도여주교육지원청 능현유치원,4,4,0,4,4,0,0,0
교육기관,교육부,대신고등학교,교육부 경기도교육청 경기도여주교육지원청 대신고등학교,37,37,0,37,0,37,0,0
교육기관,교육부,대신중학교,교육부 경기도교육청 경기도여주교육지원청 대신중학교,21,21,0,21,0,21,0,0
교육기관,교육부,대신초등학교,교육부 경기도교육청 경기도여주교육지원청 대신초등학교,12,12,0,12,8,4,0,0
교육기관,교육부,매류초등학교,교육부 경기도교육청 경기도여주교육지원청 매류초등학교,8,8,0,8,3,3,1,1
교육기관,교육부,문장초등학교,교육부 경기도교육청 경기도여주교육지원청 문장초등학교,16,16,0,16,8,8,0,0
교육기관,교육부,북내초등학교,교육부 경기도교육청 경기도여주교육지원청 북내초등학교,8,8,0,8,8,0,0,0
교육기관,교육부,북내초등학교도전분교장,교육부 경기도교육청 경기도여주교육지원청 북내초등학교도전분교장,12,12,0,12,12,0,0,0
교육기관,교육부,북내초등학교운암분교장,교육부 경기도교육청 경기도여주교육지원청 북내초등학교운암분교장,13,13,0,13,13,0,0,0
교육기관,교육부,상품중학교,교육부 경기도교육청 경기도여주교육지원청 상품중학교,16,15,1,15,15,0,0,0
교육기관,교육부,상품초등학교,교육부 경기도교육청 경기도여주교육지원청 상품초등학교,12,12,0,12,0,12,0,0
교육기관,교육부,세정중학교,교육부 경기도교육청 경기도여주교육지원청 세정중학교,8,8,0,8,6,2,0,0
교육기관,교육부,세종고등학교,교육부 경기도교육청 경기도여주교육지원청 세종고등학교,23,23,0,23,8,15,0,0
교육기관,교육부,세종중학교,교육부 경기도교육청 경기도여주교육지원청 세종중학교,36,36,0,36,9,27,0,0
교육기관,교육부,세종초등학교,교육부 경기도교육청 경기도여주교육지원청 세종초등학교,38,38,0,38,38,0,0,0
교육기관,교육부,송삼초등학교,교육부 경기도교육청 경기도여주교육지원청 송삼초등학교,9,9,0,9,5,3,1,0
교육기관,교육부,송촌초등학교,교육부 경기도교육청 경기도여주교육지원청 송촌초등학교,12,12,0,12,6,6,0,0
교육기관,교육부,여강고등학교,교육부 경기도교육청 경기도여주교육지원청 여강고등학교,22,22,0,22,22,0,0,0
교육기관,교육부,여강중학교,교육부 경기도교육청 경기도여주교육지원청 여강중학교,14,14,0,14,0,14,0,0
교육기관,교육부,여주고등학교,교육부 경기도교육청 경기도여주교육지원청 여주고등학교,38,38,0,38,6,29,2,1
교육기관,교육부,여주대학교부속유치원,교육부 경기도교육청 경기도여주교육지원청 여주대학교부속유치원,16,16,0,16,16,0,0,0
교육기관,교육부,여주여자중학교,교육부 경기도교육청 경기도여주교육지원청 여주여자중학교,8,7,1,7,0,7,0,0
교육기관,교육부,여주자영농업고등학교,교육부 경기도교육청 경기도여주교육지원청 여주자영농업고등학교,65,65,0,65,33,32,0,0
교육기관,교육부,여주제일고등학교,교육부 경기도교육청 경기도여주교육지원청 여주제일고등학교,18,18,0,18,8,10,0,0
교육기관,교육부,여주제일중학교,교육부 경기도교육청 경기도여주교육지원청 여주제일중학교,22,22,0,22,5,17,0,0
교육기관,교육부,여주중학교,교육부 경기도교육청 경기도여주교육지원청 여주중학교,28,27,1,27,0,27,0,0
교육기관,교육부,여주초등학교,교육부 경기도교육청 경기도여주교육지원청 여주초등학교,12,12,0,12,7,5,0,0
교육기관,교육부,여흥초등학교,교육부 경기도교육청 경기도여주교육지원청 여흥초등학교,27,27,0,27,9,13,4,1
교육기관,교육부,연라초등학교,교육부 경기도교육청 경기도여주교육지원청 연라초등학교,12,12,0,12,2,9,1,0
교육기관,교육부,오산초등학교,교육부 경기도교육청 경기도여주교육지원청 오산초등학교,8,8,0,8,8,0,0,0
교육기관,교육부,오학초등학교,교육부 경기도교육청 경기도여주교육지원청 오학초등학교,16,16,0,16,7,8,1,0
교육기관,교육부,이포고등학교,교육부 경기도교육청 경기도여주교육지원청 이포고등학교,33,33,0,33,15,18,0,0
교육기관,교육부,이포중학교,교육부 경기도교육청 경기도여주교육지원청 이포중학교,4,4,0,4,2,2,0,0
교육기관,교육부,이포초등학교,교육부 경기도교육청 경기도여주교육지원청 이포초등학교,16,16,0,16,0,16,0,0
교육기관,교육부,이포초등학교하호분교장,교육부 경기도교육청 경기도여주교육지원청 이포초등학교하호분교장,8,8,0,8,8,0,0,0
교육기관,교육부,임당유치원,교육부 경기도교육청 경기도여주교육지원청 임당유치원,8,8,0,8,3,5,0,0
교육기관,교육부,점동고등학교,교육부 경기도교육청 경기도여주교육지원청 점동고등학교,15,15,0,15,13,2,0,0
교육기관,교육부,점동중학교,교육부 경기도교육청 경기도여주교육지원청 점동중학교,12,12,0,12,12,0,0,0
교육기관,교육부,점동초등학교,교육부 경기도교육청 경기도여주교육지원청 점동초등학교,8,8,0,8,0,8,0,0
교육기관,교육부,점봉초등학교,교육부 경기도교육청 경기도여주교육지원청 점봉초등학교,16,16,0,16,0,16,0,0
교육기관,교육부,창명여자중학교,교육부 경기도교육청 경기도여주교육지원청 창명여자중학교,17,17,0,17,8,9,0,0
교육기관,교육부,흥천초등학교,교육부 경기도교육청 경기도여주교육지원청 흥천초등학교,11,11,0,11,11,0,0,0
교육기관,교육부,경기도연천교육지원청,교육부 경기도교육청 경기도연천교육지원청,8,8,0,8,0,8,0,0
교육기관,교육부,경기도교직원연천수덕원,교육부 경기도교육청 경기도연천교육지원청 경기도교직원연천수덕원,4,4,0,4,0,4,0,0
교육기관,교육부,군남중학교,교육부 경기도교육청 경기도연천교육지원청 군남중학교,16,16,0,16,16,0,0,0
교육기관,교육부,궁평초등학교,교육부 경기도교육청 경기도연천교육지원청 궁평초등학교,13,13,0,13,0,13,0,0
교육기관,교육부,대광중학교,교육부 경기도교육청 경기도연천교육지원청 대광중학교,10,10,0,10,4,5,1,0
교육기관,교육부,대광초등학교,교육부 경기도교육청 경기도연천교육지원청 대광초등학교,8,8,0,8,0,8,0,0
교육기관,교육부,백의초등학교,교육부 경기도교육청 경기도연천교육지원청 백의초등학교,8,8,0,8,4,4,0,0
교육기관,교육부,백학중학교,교육부 경기도교육청 경기도연천교육지원청 백학중학교,10,10,0,10,10,0,0,0
교육기관,교육부,백학초등학교,교육부 경기도교육청 경기도연천교육지원청 백학초등학교,22,22,0,22,22,0,0,0
교육기관,교육부,본원유치원,교육부 경기도교육청 경기도연천교육지원청 본원유치원,10,2,8,2,1,1,0,0
교육기관,교육부,상리초등학교,교육부 경기도교육청 경기도연천교육지원청 상리초등학교,14,14,0,14,7,7,0,0
교육기관,교육부,연천고등학교,교육부 경기도교육청 경기도연천교육지원청 연천고등학교,18,17,1,17,0,17,0,0
교육기관,교육부,연천노곡초등학교,교육부 경기도교육청 경기도연천교육지원청 연천노곡초등학교,12,12,0,12,6,6,0,0
교육기관,교육부,연천노곡초등학교병설유치원,교육부 경기도교육청 경기도연천교육지원청 연천노곡초등학교병설유치원,12,12,0,12,6,6,0,0
교육기관,교육부,연천왕산초등학교,교육부 경기도교육청 경기도연천교육지원청 연천왕산초등학교,10,7,3,7,7,0,0,0
교육기관,교육부,연천중학교,교육부 경기도교육청 경기도연천교육지원청 연천중학교,10,10,0,10,2,8,0,0
교육기관,교육부,연천초등학교,교육부 경기도교육청 경기도연천교육지원청 연천초등학교,12,12,0,12,8,4,0,0
교육기관,교육부,온골유치원,교육부 경기도교육청 경기도연천교육지원청 온골유치원,29,29,0,29,0,29,0,0
교육기관,교육부,은대초등학교,교육부 경기도교육청 경기도연천교육지원청 은대초등학교,16,16,0,16,10,6,0,0
교육기관,교육부,전곡고등학교,교육부 경기도교육청 경기도연천교육지원청 전곡고등학교,48,48,0,48,18,30,0,0
교육기관,교육부,전곡중학교,교육부 경기도교육청 경기도연천교육지원청 전곡중학교,21,21,0,21,21,0,0,0
교육기관,교육부,전곡초등학교,교육부 경기도교육청 경기도연천교육지원청 전곡초등학교,14,14,0,14,14,0,0,0
교육기관,교육부,청산중학교,교육부 경기도교육청 경기도연천교육지원청 청산중학교,9,8,1,8,3,3,1,1
교육기관,교육부,초성초등학교,교육부 경기도교육청 경기도연천교육지원청 초성초등학교,12,12,0,12,0,12,0,0
교육기관,교육부,한여울유치원,교육부 경기도교육청 경기도연천교육지원청 한여울유치원,22,6,16,6,3,3,0,0
교육기관,교육부,화요일아침예술학교,교육부 경기도교육청 경기도연천교육지원청 화요일아침예술학교,10,10,0,10,1,9,0,0
교육기관,교육부,화진초등학교,교육부 경기도교육청 경기도연천교육지원청 화진초등학교,7,7,0,7,0,7,0,0
교육기관,교육부,갈곡초등학교,교육부 경기도교육청 경기도용인교육지원청 갈곡초등학교,17,17,0,17,16,1,0,0
교육기관,교육부,고기초등학교,교육부 경기도교육청 경기도용인교육지원청 고기초등학교,25,25,0,25,25,0,0,0
교육기관,교육부,고림고등학교,교육부 경기도교육청 경기도용인교육지원청 고림고등학교,20,20,0,20,0,20,0,0
교육기관,교육부,고림중학교,교육부 경기도교육청 경기도용인교육지원청 고림중학교,64,64,0,64,32,32,0,0
교육기관,교육부,고림초등학교,교육부 경기도교육청 경기도용인교육지원청 고림초등학교,20,20,0,20,14,6,0,0
교육기관,교육부,공세초등학교,교육부 경기도교육청 경기도용인교육지원청 공세초등학교,23,23,0,23,15,8,0,0
교육기관,교육부,관곡초등학교,교육부 경기도교육청 경기도용인교육지원청 관곡초등학교,8,8,0,8,5,1,1,1
교육기관,교육부,교동초등학교,교육부 경기도교육청 경기도용인교육지원청 교동초등학교,18,18,0,18,17,1,0,0
교육기관,교육부,구갈중학교,교육부 경기도교육청 경기도용인교육지원청 구갈중학교,21,21,0,21,11,9,1,0
교육기관,교육부,구갈초등학교,교육부 경기도교육청 경기도용인교육지원청 구갈초등학교,18,18,0,18,18,0,0,0
교육기관,교육부,구성고등학교,교육부 경기도교육청 경기도용인교육지원청 구성고등학교,23,23,0,23,11,12,0,0
교육기관,교육부,구성중학교,교육부 경기도교육청 경기도용인교육지원청 구성중학교,67,19,48,19,19,0,0,0
교육기관,교육부,구성초등학교,교육부 경기도교육청 경기도용인교육지원청 구성초등학교,15,15,0,15,4,11,0,0
교육기관,교육부,기흥초등학교,교육부 경기도교육청 경기도용인교육지원청 기흥초등학교,15,15,0,15,10,5,0,0
교육기관,교육부,나곡중학교,교육부 경기도교육청 경기도용인교육지원청 나곡중학교,22,22,0,22,19,3,0,0
교육기관,교육부,나곡초등학교,교육부 경기도교육청 경기도용인교육지원청 나곡초등학교,15,15,0,15,7,8,0,0
교육기관,교육부,나산초등학교,교육부 경기도교육청 경기도용인교육지원청 나산초등학교,17,17,0,17,9,8,0,0
교육기관,교육부,남곡초등학교,교육부 경기도교육청 경기도용인교육지원청 남곡초등학교,30,30,0,30,10,20,0,0
교육기관,교육부,남사중학교,교육부 경기도교육청 경기도용인교육지원청 남사중학교,9,6,3,6,6,0,0,0
교육기관,교육부,남사초등학교,교육부 경기도교육청 경기도용인교육지원청 남사초등학교,9,9,0,9,0,9,0,0
교육기관,교육부,남촌초등학교,교육부 경기도교육청 경기도용인교육지원청 남촌초등학교,19,19,0,19,15,4,0,0
교육기관,교육부,능원초등학교,교육부 경기도교육청 경기도용인교육지원청 능원초등학교,15,15,0,15,8,7,0,0
교육기관,교육부,대지고등학교,교육부 경기도교육청 경기도용인교육지원청 대지고등학교,48,42,6,42,42,0,0,0
교육기관,교육부,대지중학교,교육부 경기도교육청 경기도용인교육지원청 대지중학교,24,24,0,24,24,0,0,0
교육기관,교육부,대지초등학교,교육부 경기도교육청 경기도용인교육지원청 대지초등학교,14,14,0,14,12,2,0,0
교육기관,교육부,대청초등학교,교육부 경기도교육청 경기도용인교육지원청 대청초등학교,13,13,0,13,0,13,0,0
교육기관,교육부,대현초등학교,교육부 경기도교육청 경기도용인교육지원청 대현초등학교,12,12,0,12,12,0,0,0
교육기관,교육부,독정초등학교,교육부 경기도교육청 경기도용인교육지원청 독정초등학교,13,13,0,13,11,2,0,0
교육기관,교육부,동막초등학교,교육부 경기도교육청 경기도용인교육지원청 동막초등학교,11,11,0,11,11,0,0,0
교육기관,교육부,동백고등학교,교육부 경기도교육청 경기도용인교육지원청 동백고등학교,39,37,2,37,30,5,2,0
교육기관,교육부,동백유치원,교육부 경기도교육청 경기도용인교육지원청 동백유치원,16,0,16,0,0,0,0,0
교육기관,교육부,동백중학교,교육부 경기도교육청 경기도용인교육지원청 동백중학교,37,37,0,37,37,0,0,0
교육기관,교육부,동백초등학교,교육부 경기도교육청 경기도용인교육지원청 동백초등학교,16,16,0,16,5,11,0,0
교육기관,교육부,동천초등학교,교육부 경기도교육청 경기도용인교육지원청 동천초등학교,40,40,0,40,7,33,0,0
교육기관,교육부,두창초등학교,교육부 경기도교육청 경기도용인교육지원청 두창초등학교,11,11,0,11,9,2,0,0
교육기관,교육부,둔전제일초등학교,교육부 경기도교육청 경기도용인교육지원청 둔전제일초등학교,30,30,0,30,6,24,0,0
교육기관,교육부,마북초등학교,교육부 경기도교육청 경기도용인교육지원청 마북초등학교,16,16,0,16,16,0,0,0
교육기관,교육부,마성초등학교,교육부 경기도교육청 경기도용인교육지원청 마성초등학교,9,9,0,9,7,2,0,0
교육기관,교육부,매봉초등학교,교육부 경기도교육청 경기도용인교육지원청 매봉초등학교,16,16,0,16,16,0,0,0
교육기관,교육부,모현중학교,교육부 경기도교육청 경기도용인교육지원청 모현중학교,9,9,0,9,0,9,0,0
교육기관,교육부,모현초등학교,교육부 경기도교육청 경기도용인교육지원청 모현초등학교,19,19,0,19,19,0,0,0
교육기관,교육부,문정중학교,교육부 경기도교육청 경기도용인교육지원청 문정중학교,8,8,0,8,8,0,0,0
교육기관,교육부,백봉초등학교,교육부 경기도교육청 경기도용인교육지원청 백봉초등학교,9,9,0,9,9,0,0,0
교육기관,교육부,백암고등학교,교육부 경기도교육청 경기도용인교육지원청 백암고등학교,12,12,0,12,2,10,0,0
교육기관,교육부,백암중학교,교육부 경기도교육청 경기도용인교육지원청 백암중학교,10,10,0,10,10,0,0,0
교육기관,교육부,백암초등학교,교육부 경기도교육청 경기도용인교육지원청 백암초등학교,8,8,0,8,2,6,0,0
교육기관,교육부,보라고등학교,교육부 경기도교육청 경기도용인교육지원청 보라고등학교,42,42,0,42,35,5,1,1
교육기관,교육부,보라중학교,교육부 경기도교육청 경기도용인교육지원청 보라중학교,46,44,2,44,26,16,0,2
교육기관,교육부,보라초등학교,교육부 경기도교육청 경기도용인교육지원청 보라초등학교,11,11,0,11,6,5,0,0
교육기관,교육부,보정고등학교,교육부 경기도교육청 경기도용인교육지원청 보정고등학교,35,35,0,35,22,13,0,0
교육기관,교육부,보정초등학교,교육부 경기도교육청 경기도용인교육지원청 보정초등학교,15,15,0,15,3,12,0,0
교육기관,교육부,산양초등학교,교육부 경기도교육청 경기도용인교육지원청 산양초등학교,13,13,0,13,13,0,0,0
교육기관,교육부,삼가초등학교,교육부 경기도교육청 경기도용인교육지원청 삼가초등학교,16,16,0,16,0,16,0,0
교육기관,교육부,상하중학교,교육부 경기도교육청 경기도용인교육지원청 상하중학교,13,13,0,13,12,1,0,0
교육기관,교육부,상하초등학교,교육부 경기도교육청 경기도용인교육지원청 상하초등학교,17,17,0,17,14,3,0,0
교육기관,교육부,상현고등학교,교육부 경기도교육청 경기도용인교육지원청 상현고등학교,49,48,1,48,7,41,0,0
교육기관,교육부,상현중학교,교육부 경기도교육청 경기도용인교육지원청 상현중학교,18,18,0,18,8,10,0,0
교육기관,교육부,상현초등학교,교육부 경기도교육청 경기도용인교육지원청 상현초등학교,21,21,0,21,21,0,0,0
교육기관,교육부,새빛초등학교,교육부 경기도교육청 경기도용인교육지원청 새빛초등학교,33,31,2,31,0,31,0,0
교육기관,교육부,샘말초등학교,교육부 경기도교육청 경기도용인교육지원청 샘말초등학교,15,15,0,15,6,9,0,0
교육기관,교육부,서농초등학교,교육부 경기도교육청 경기도용인교육지원청 서농초등학교,25,25,0,25,14,11,0,0
교육기관,교육부,서룡초등학교,교육부 경기도교육청 경기도용인교육지원청 서룡초등학교,9,9,0,9,0,9,0,0
교육기관,교육부,서원고등학교,교육부 경기도교육청 경기도용인교육지원청 서원고등학교,22,20,2,20,14,5,1,0
교육기관,교육부,서원중학교,교육부 경기도교육청 경기도용인교육지원청 서원중학교,18,17,1,17,0,17,0,0
교육기관,교육부,서원초등학교,교육부 경기도교육청 경기도용인교육지원청 서원초등학교,26,26,0,26,0,26,0,0
교육기관,교육부,서천고등학교,교육부 경기도교육청 경기도용인교육지원청 서천고등학교,46,46,0,46,43,3,0,0
교육기관,교육부,서천중학교,교육부 경기도교육청 경기도용인교육지원청 서천중학교,24,12,12,12,6,6,0,0
교육기관,교육부,석성숲유치원,교육부 경기도교육청 경기도용인교육지원청 석성숲유치원,32,4,28,4,4,0,0,0
교육기관,교육부,석성초등학교,교육부 경기도교육청 경기도용인교육지원청 석성초등학교,18,18,0,18,18,0,0,0
교육기관,교육부,석현초등학교,교육부 경기도교육청 경기도용인교육지원청 석현초등학교,13,13,0,13,1,10,2,0
교육기관,교육부,성복고등학교,교육부 경기도교육청 경기도용인교육지원청 성복고등학교,28,26,2,26,12,14,0,0
교육기관,교육부,성복중학교,교육부 경기도교육청 경기도용인교육지원청 성복중학교,36,36,0,36,1,35,0,0
교육기관,교육부,성복초등학교,교육부 경기도교육청 경기도용인교육지원청 성복초등학교,14,14,0,14,0,14,0,0
교육기관,교육부,성서중학교,교육부 경기도교육청 경기도용인교육지원청 성서중학교,20,20,0,20,0,20,0,0
교육기관,교육부,성서초등학교,교육부 경기도교육청 경기도용인교육지원청 성서초등학교,16,16,0,16,16,0,0,0
교육기관,교육부,성지고등학교,교육부 경기도교육청 경기도용인교육지원청 성지고등학교,32,32,0,32,23,9,0,0
교육기관,교육부,성지중학교,교육부 경기도교육청 경기도용인교육지원청 성지중학교,31,12,19,12,6,6,0,0
교육기관,교육부,성체유치원,교육부 경기도교육청 경기도용인교육지원청 성체유치원,34,33,1,33,27,3,0,3
교육기관,교육부,소현초등학교,교육부 경기도교육청 경기도용인교육지원청 소현초등학교,15,15,0,15,15,0,0,0
교육기관,교육부,손곡중학교,교육부 경기도교육청 경기도용인교육지원청 손곡중학교,16,9,7,9,1,6,1,1
교육기관,교육부,손곡초등학교,교육부 경기도교육청 경기도용인교육지원청 손곡초등학교,13,13,0,13,1,12,0,0
교육기관,교육부,솔개초등학교,교육부 경기도교육청 경기도용인교육지원청 솔개초등학교,25,25,0,25,25,0,0,0
교육기관,교육부,송전중학교,교육부 경기도교육청 경기도용인교육지원청 송전중학교,15,15,0,15,0,15,0,0
교육기관,교육부,송전초등학교,교육부 경기도교육청 경기도용인교육지원청 송전초등학교,16,16,0,16,12,4,0,0
교육기관,교육부,송전초등학교병설유치원,교육부 경기도교육청 경기도용인교육지원청 송전초등학교병설유치원,16,16,0,16,12,4,0,0
교육기관,교육부,수지고등학교,교육부 경기도교육청 경기도용인교육지원청 수지고등학교,14,14,0,14,14,0,0,0
교육기관,교육부,수지누리유치원,교육부 경기도교육청 경기도용인교육지원청 수지누리유치원,11,11,0,11,11,0,0,0
교육기관,교육부,수지아이뜰유치원,교육부 경기도교육청 경기도용인교육지원청 수지아이뜰유치원,58,5,53,5,2,3,0,0
교육기관,교육부,수지중학교,교육부 경기도교육청 경기도용인교육지원청 수지중학교,23,23,0,23,10,13,0,0
교육기관,교육부,수지초등학교,교육부 경기도교육청 경기도용인교육지원청 수지초등학교,25,25,0,25,15,10,0,0
교육기관,교육부,수지초등학교병설유치원,교육부 경기도교육청 경기도용인교육지원청 수지초등학교병설유치원,25,25,0,25,15,10,0,0
교육기관,교육부,신갈고등학교,교육부 경기도교육청 경기도용인교육지원청 신갈고등학교,47,4,43,4,4,0,0,0
교육기관,교육부,신갈초등학교,교육부 경기도교육청 경기도용인교육지원청 신갈초등학교,15,15,0,15,15,0,0,0
교육기관,교육부,신리초등학교,교육부 경기도교육청 경기도용인교육지원청 신리초등학교,9,9,0,9,9,0,0,0
교육기관,교육부,신봉고등학교,교육부 경기도교육청 경기도용인교육지원청 신봉고등학교,36,36,0,36,17,17,1,1
교육기관,교육부,신봉중학교,교육부 경기도교육청 경기도용인교육지원청 신봉중학교,25,25,0,25,25,0,0,0
교육기관,교육부,신월초등학교,교육부 경기도교육청 경기도용인교육지원청 신월초등학교,32,32,0,32,0,32,0,0
교육기관,교육부,신일초등학교,교육부 경기도교육청 경기도용인교육지원청 신일초등학교,8,8,0,8,4,4,0,0
교육기관,교육부,아이원유치원,교육부 경기도교육청 경기도용인교육지원청 아이원유치원,23,23,0,23,3,16,2,2
교육기관,교육부,아이유치원,교육부 경기도교육청 경기도용인교육지원청 아이유치원,20,6,14,6,3,2,0,1
교육기관,교육부,양지초등학교,교육부 경기도교육청 경기도용인교육지원청 양지초등학교,16,16,0,16,0,16,0,0
교육기관,교육부,어정중학교,교육부 경기도교육청 경기도용인교육지원청 어정중학교,25,17,8,17,16,1,0,0
교육기관,교육부,어정초등학교,교육부 경기도교육청 경기도용인교육지원청 어정초등학교,19,19,0,19,16,3,0,0
교육기관,교육부,언남초등학교,교육부 경기도교육청 경기도용인교육지원청 언남초등학교,25,25,0,25,15,10,0,0
교육기관,교육부,언동중학교,교육부 경기도교육청 경기도용인교육지원청 언동중학교,51,49,2,49,0,49,0,0
교육기관,교육부,언동초등학교,교육부 경기도교육청 경기도용인교육지원청 언동초등학교,11,11,0,11,11,0,0,0
교육기관,교육부,역북초등학교,교육부 경기도교육청 경기도용인교육지원청 역북초등학교,12,12,0,12,0,12,0,0
교육기관,교육부,영문중학교,교육부 경기도교육청 경기도용인교육지원청 영문중학교,48,44,4,44,32,12,0,0
교육기관,교육부,예일유치원,교육부 경기도교육청 경기도용인교육지원청 예일유치원,16,16,0,16,0,16,0,0
교육기관,교육부,왕산초등학교,교육부 경기도교육청 경기도용인교육지원청 왕산초등학교,15,15,0,15,10,5,0,0
교육기관,교육부,용동중학교,교육부 경기도교육청 경기도용인교육지원청 용동중학교,15,15,0,15,15,0,0,0
교육기관,교육부,용마초등학교,교육부 경기도교육청 경기도용인교육지원청 용마초등학교,24,24,0,24,12,8,4,0
교육기관,교육부,용신중학교,교육부 경기도교육청 경기도용인교육지원청 용신중학교,26,26,0,26,13,13,0,0
교육기관,교육부,용인강남학교,교육부 경기도교육청 경기도용인교육지원청 용인강남학교,99,14,85,14,0,14,0,0
교육기관,교육부,용인다움학교,교육부 경기도교육청 경기도용인교육지원청 용인다움학교,39,37,2,37,31,2,4,0
교육기관,교육부,용인대덕중학교,교육부 경기도교육청 경기도용인교육지원청 용인대덕중학교,29,29,0,29,0,29,0,0
교육기관,교육부,용인대덕초등학교,교육부 경기도교육청 경기도용인교육지원청 용인대덕초등학교,10,10,0,10,0,10,0,0
교육기관,교육부,용인대일초등학교,교육부 경기도교육청 경기도용인교육지원청 용인대일초등학교,13,13,0,13,0,13,0,0
교육기관,교육부,용인바이오고등학교,교육부 경기도교육청 경기도용인교육지원청 용인바이오고등학교,17,17,0,17,4,8,3,2
교육기관,교육부,용인백현고등학교,교육부 경기도교육청 경기도용인교육지원청 용인백현고등학교,24,24,0,24,13,11,0,0
교육기관,교육부,용인백현중학교,교육부 경기도교육청 경기도용인교육지원청 용인백현중학교,29,29,0,29,22,7,0,0
교육기관,교육부,용인백현초등학교,교육부 경기도교육청 경기도용인교육지원청 용인백현초등학교,15,15,0,15,0,15,0,0
교육기관,교육부,용인삼계고등학교,교육부 경기도교육청 경기도용인교육지원청 용인삼계고등학교,25,25,0,25,0,25,0,0
교육기관,교육부,용인성산초등학교,교육부 경기도교육청 경기도용인교육지원청 용인성산초등학교,14,14,0,14,8,4,1,1
교육기관,교육부,용인신릉중학교,교육부 경기도교육청 경기도용인교육지원청 용인신릉중학교,37,37,0,37,19,18,0,0
교육기관,교육부,용인신릉초등학교,교육부 경기도교육청 경기도용인교육지원청 용인신릉초등학교,16,16,0,16,0,16,0,0
교육기관,교육부,용인신봉초등학교,교육부 경기도교육청 경기도용인교육지원청 용인신봉초등학교,24,24,0,24,24,0,0,0
교육기관,교육부,용인신촌중학교,교육부 경기도교육청 경기도용인교육지원청 용인신촌중학교,17,17,0,17,3,12,1,1
교육기관,교육부,용인신촌초등학교,교육부 경기도교육청 경기도용인교육지원청 용인신촌초등학교,16,16,0,16,8,8,0,0
교육기관,교육부,용인심곡초등학교,교육부 경기도교육청 경기도용인교육지원청 용인심곡초등학교,10,10,0,10,10,0,0,0
교육기관,교육부,용인아람유치원,교육부 경기도교육청 경기도용인교육지원청 용인아람유치원,16,16,0,16,0,16,0,0
교육기관,교육부,용인이동초등학교,교육부 경기도교육청 경기도용인교육지원청 용인이동초등학교,9,9,0,9,5,4,0,0
교육기관,교육부,용인초등학교,교육부 경기도교육청 경기도용인교육지원청 용인초등학교,25,25,0,25,21,4,0,0
교육기관,교육부,용인한국외국어대학교부설고등학교,교육부 경기도교육청 경기도용인교육지원청 용인한국외국어대학교부설고등학교,307,307,0,307,0,307,0,0
교육기관,교육부,용인한얼초등학교,교육부 경기도교육청 경기도용인교육지원청 용인한얼초등학교,30,30,0,30,15,15,0,0
교육기관,교육부,용인한일초등학교,교육부 경기도교육청 경기도용인교육지원청 용인한일초등학교,13,13,0,13,13,0,0,0
교육기관,교육부,용인홍천고등학교,교육부 경기도교육청 경기도용인교육지원청 용인홍천고등학교,46,45,1,45,38,7,0,0
교육기관,교육부,용천중학교,교육부 경기도교육청 경기도용인교육지원청 용천중학교,19,19,0,19,10,5,2,2
교육기관,교육부,용천초등학교,교육부 경기도교육청 경기도용인교육지원청 용천초등학교,16,16,0,16,13,3,0,0
교육기관,교육부,운학초등학교,교육부 경기도교육청 경기도용인교육지원청 운학초등학교,14,14,0,14,0,14,0,0
교육기관,교육부,원삼중학교,교육부 경기도교육청 경기도용인교육지원청 원삼중학교,14,10,4,10,4,6,0,0
교육기관,교육부,이현중학교,교육부 경기도교육청 경기도용인교육지원청 이현중학교,21,19,2,19,15,4,0,0
교육기관,교육부,이현초등학교,교육부 경기도교육청 경기도용인교육지원청 이현초등학교,12,12,0,12,0,12,0,0
교육기관,교육부,장평초등학교,교육부 경기도교육청 경기도용인교육지원청 장평초등학교,13,13,0,13,5,8,0,0
교육기관,교육부,정평중학교,교육부 경기도교육청 경기도용인교육지원청 정평중학교,18,18,0,18,2,12,4,0
교육기관,교육부,정평초등학교,교육부 경기도교육청 경기도용인교육지원청 정평초등학교,16,16,0,16,0,16,0,0
교육기관,교육부,제일초등학교,교육부 경기도교육청 경기도용인교육지원청 제일초등학교,11,11,0,11,3,8,0,0
교육기관,교육부,좌항초등학교,교육부 경기도교육청 경기도용인교육지원청 좌항초등학교,21,21,0,21,11,10,0,0
교육기관,교육부,죽전고등학교,교육부 경기도교육청 경기도용인교육지원청 죽전고등학교,16,16,0,16,0,16,0,0
교육기관,교육부,죽전중학교,교육부 경기도교육청 경기도용인교육지원청 죽전중학교,13,13,0,13,2,11,0,0
교육기관,교육부,죽전초등학교,교육부 경기도교육청 경기도용인교육지원청 죽전초등학교,11,11,0,11,6,5,0,0
교육기관,교육부,중앙예닮학교,교육부 경기도교육청 경기도용인교육지원청 중앙예닮학교,127,127,0,127,0,127,0,0
교육기관,교육부,중일초등학교,교육부 경기도교육청 경기도용인교육지원청 중일초등학교,22,22,0,22,8,14,0,0
교육기관,교육부,지곡초등학교,교육부 경기도교육청 경기도용인교육지원청 지곡초등학교,15,15,0,15,0,15,0,0
교육기관,교육부,지석초등학교,교육부 경기도교육청 경기도용인교육지원청 지석초등학교,13,13,0,13,0,13,0,0
교육기관,교육부,처인성유치원,교육부 경기도교육청 경기도용인교육지원청 처인성유치원,16,16,0,16,8,8,0,0
교육기관,교육부,청곡초등학교,교육부 경기도교육청 경기도용인교육지원청 청곡초등학교,17,17,0,17,17,0,0,0
교육기관,교육부,청덕고등학교,교육부 경기도교육청 경기도용인교육지원청 청덕고등학교,32,25,7,25,18,7,0,0
교육기관,교육부,청덕중학교,교육부 경기도교육청 경기도용인교육지원청 청덕중학교,12,12,0,12,12,0,0,0
교육기관,교육부,청덕초등학교,교육부 경기도교육청 경기도용인교육지원청 청덕초등학교,20,20,0,20,20,0,0,0
교육기관,교육부,초당중학교,교육부 경기도교육청 경기도용인교육지원청 초당중학교,26,25,1,25,0,25,0,0
교육기관,교육부,초당초등학교,교육부 경기도교육청 경기도용인교육지원청 초당초등학교,14,14,0,14,13,1,0,0
교육기관,교육부,초롱유치원,교육부 경기도교육청 경기도용인교육지원청 초롱유치원,21,21,0,21,0,21,0,0
교육기관,교육부,태성고등학교,교육부 경기도교육청 경기도용인교육지원청 태성고등학교,49,40,9,40,0,40,0,0
교육기관,교육부,태성중학교,교육부 경기도교육청 경기도용인교육지원청 태성중학교,29,29,0,29,0,29,0,0
교육기관,교육부,토월초등학교,교육부 경기도교육청 경기도용인교육지원청 토월초등학교,16,16,0,16,16,0,0,0
교육기관,교육부,포곡고등학교,교육부 경기도교육청 경기도용인교육지원청 포곡고등학교,59,59,0,59,0,59,0,0
교육기관,교육부,포곡중학교,교육부 경기도교육청 경기도용인교육지원청 포곡중학교,18,18,0,18,5,11,1,1
교육기관,교육부,포곡초등학교,교육부 경기도교육청 경기도용인교육지원청 포곡초등학교,16,16,0,16,16,0,0,0
교육기관,교육부,풍덕고등학교,교육부 경기도교육청 경기도용인교육지원청 풍덕고등학교,37,37,0,37,21,16,0,0
교육기관,교육부,풍덕초등학교,교육부 경기도교육청 경기도용인교육지원청 풍덕초등학교,16,16,0,16,10,2,4,0
교육기관,교육부,풍천초등학교,교육부 경기도교육청 경기도용인교육지원청 풍천초등학교,12,12,0,12,5,5,1,1
교육기관,교육부,풍천초등학교병설유치원,교육부 경기도교육청 경기도용인교육지원청 풍천초등학교병설유치원,12,12,0,12,5,5,1,1
교육기관,교육부,한숲중학교,교육부 경기도교육청 경기도용인교육지원청 한숲중학교,33,33,0,33,0,33,0,0
교육기관,교육부,한터초등학교,교육부 경기도교육청 경기도용인교육지원청 한터초등학교,18,18,0,18,0,18,0,0
교육기관,교육부,함박초등학교,교육부 경기도교육청 경기도용인교육지원청 함박초등학교,29,29,0,29,29,0,0,0
교육기관,교육부,현대유치원,교육부 경기도교육청 경기도용인교육지원청 현대유치원,18,18,0,18,0,18,0,0
교육기관,교육부,현암고등학교,교육부 경기도교육청 경기도용인교육지원청 현암고등학교,16,16,0,16,7,7,1,1
교육기관,교육부,현암중학교,교육부 경기도교육청 경기도용인교육지원청 현암중학교,16,16,0,16,0,16,0,0
교육기관,교육부,현암초등학교,교육부 경기도교육청 경기도용인교육지원청 현암초등학교,16,16,0,16,0,16,0,0
교육기관,교육부,홍천중학교,교육부 경기도교육청 경기도용인교육지원청 홍천중학교,34,34,0,34,18,16,0,0
교육기관,교육부,홍천초등학교,교육부 경기도교육청 경기도용인교육지원청 홍천초등학교,13,13,0,13,13,0,0,0
교육기관,교육부,효자초등학교,교육부 경기도교육청 경기도용인교육지원청 효자초등학교,9,9,0,9,2,7,0,0
교육기관,교육부,흥덕고등학교,교육부 경기도교육청 경기도용인교육지원청 흥덕고등학교,48,48,0,48,15,33,0,0
교육기관,교육부,흥덕중학교,교육부 경기도교육청 경기도용인교육지원청 흥덕중학교,47,47,0,47,14,33,0,0
교육기관,교육부,흥덕초등학교,교육부 경기도교육청 경기도용인교육지원청 흥덕초등학교,18,18,0,18,4,14,0,0
교육기관,교육부,경기도유아체험교육원,교육부 경기도교육청 경기도유아체험교육원,12,12,0,12,12,0,0,0
교육기관,교육부,경기도융합과학교육원,교육부 경기도교육청 경기도융합과학교육원,39,39,0,39,0,39,0,0
교육기관,교육부,경기도의정부교육지원청,교육부 경기도교육청 경기도의정부교육지원청,47,47,0,47,0,47,0,0
교육기관,교육부,가능초등학교,교육부 경기도교육청 경기도의정부교육지원청 가능초등학교,23,23,0,23,8,13,2,0
교육기관,교육부,경민IT고등학교,교육부 경기도교육청 경기도의정부교육지원청 경민IT고등학교,32,32,0,32,24,8,0,0
교육기관,교육부,경민고등학교,교육부 경기도교육청 경기도의정부교육지원청 경민고등학교,52,52,0,52,52,0,0,0
교육기관,교육부,경민비즈니스고등학교,교육부 경기도교육청 경기도의정부교육지원청 경민비즈니스고등학교,34,33,1,33,29,4,0,0
교육기관,교육부,경민여자중학교,교육부 경기도교육청 경기도의정부교육지원청 경민여자중학교,28,28,0,28,0,28,0,0
교육기관,교육부,경민중학교,교육부 경기도교육청 경기도의정부교육지원청 경민중학교,33,33,0,33,33,0,0,0
교육기관,교육부,경의유치원,교육부 경기도교육청 경기도의정부교육지원청 경의유치원,8,8,0,8,3,5,0,0
교육기관,교육부,경의초등학교,교육부 경기도교육청 경기도의정부교육지원청 경의초등학교,9,9,0,9,9,0,0,0
교육기관,교육부,고산초등학교,교육부 경기도교육청 경기도의정부교육지원청 고산초등학교,9,9,0,9,9,0,0,0
교육기관,교육부,금오중학교,교육부 경기도교육청 경기도의정부교육지원청 금오중학교,9,9,0,9,0,9,0,0
교육기관,교육부,금오초등학교,교육부 경기도교육청 경기도의정부교육지원청 금오초등학교,14,11,3,11,5,4,1,1
교육기관,교육부,녹양유치원,교육부 경기도교육청 경기도의정부교육지원청 녹양유치원,6,6,0,6,3,3,0,0
교육기관,교육부,녹양중학교,교육부 경기도교육청 경기도의정부교육지원청 녹양중학교,24,23,1,23,11,11,1,0
교육기관,교육부,녹양초등학교,교육부 경기도교육청 경기도의정부교육지원청 녹양초등학교,22,22,0,22,12,10,0,0
교육기관,교육부,다온중학교,교육부 경기도교육청 경기도의정부교육지원청 다온중학교,23,23,0,23,0,23,0,0
교육기관,교육부,동국대학교사범대학부속영석고등학교,교육부 경기도교육청 경기도의정부교육지원청 동국대학교사범대학부속영석고등학교,36,31,5,31,5,24,2,0
교육기관,교육부,동암중학교,교육부 경기도교육청 경기도의정부교육지원청 동암중학교,29,29,0,29,11,16,0,2
교육기관,교육부,동암초등학교,교육부 경기도교육청 경기도의정부교육지원청 동암초등학교,16,16,0,16,16,0,0,0
교육기관,교육부,동오초등학교,교육부 경기도교육청 경기도의정부교육지원청 동오초등학교,19,19,0,19,15,4,0,0
교육기관,교육부,민락중학교,교육부 경기도교육청 경기도의정부교육지원청 민락중학교,15,15,0,15,7,8,0,0
교육기관,교육부,민락초등학교,교육부 경기도교육청 경기도의정부교육지원청 민락초등학교,34,34,0,34,0,34,0,0
교육기관,교육부,발곡고등학교,교육부 경기도교육청 경기도의정부교육지원청 발곡고등학교,64,64,0,64,17,47,0,0
교육기관,교육부,발곡중학교,교육부 경기도교육청 경기도의정부교육지원청 발곡중학교,23,23,0,23,14,6,2,1
교육기관,교육부,발곡초등학교,교육부 경기도교육청 경기도의정부교육지원청 발곡초등학교,20,20,0,20,0,20,0,0
교육기관,교육부,배영초등학교,교육부 경기도교육청 경기도의정부교육지원청 배영초등학교,14,14,0,14,7,7,0,0
교육기관,교육부,버들개초등학교,교육부 경기도교육청 경기도의정부교육지원청 버들개초등학교,21,21,0,21,21,0,0,0
교육기관,교육부,부용고등학교,교육부 경기도교육청 경기도의정부교육지원청 부용고등학교,14,14,0,14,8,3,3,0
교육기관,교육부,부용중학교,교육부 경기도교육청 경기도의정부교육지원청 부용중학교,20,20,0,20,5,13,1,1
교육기관,교육부,상우고등학교,교육부 경기도교육청 경기도의정부교육지원청 상우고등학교,51,51,0,51,35,16,0,0
교육기관,교육부,새말초등학교,교육부 경기도교육청 경기도의정부교육지원청 새말초등학교,16,16,0,16,0,16,0,0
교육기관,교육부,솔뫼중학교,교육부 경기도교육청 경기도의정부교육지원청 솔뫼중학교,24,24,0,24,12,12,0,0
교육기관,교육부,솔뫼초등학교,교육부 경기도교육청 경기도의정부교육지원청 솔뫼초등학교,11,11,0,11,0,11,0,0
교육기관,교육부,송민학교,교육부 경기도교육청 경기도의정부교육지원청 송민학교,40,40,0,40,0,40,0,0
교육기관,교육부,송양고등학교,교육부 경기도교육청 경기도의정부교육지원청 송양고등학교,43,43,0,43,0,43,0,0
교육기관,교육부,송양유치원,교육부 경기도교육청 경기도의정부교육지원청 송양유치원,57,12,45,12,2,8,2,0
교육기관,교육부,송양중학교,교육부 경기도교육청 경기도의정부교육지원청 송양중학교,41,40,1,40,32,8,0,0
교육기관,교육부,송양초등학교,교육부 경기도교육청 경기도의정부교육지원청 송양초등학교,26,20,6,20,20,0,0,0
교육기관,교육부,송현고등학교,교육부 경기도교육청 경기도의정부교육지원청 송현고등학교,32,32,0,32,16,16,0,0
교육기관,교육부,신곡중학교,교육부 경기도교육청 경기도의정부교육지원청 신곡중학교,29,29,0,29,2,27,0,0
교육기관,교육부,신동초등학교,교육부 경기도교육청 경기도의정부교육지원청 신동초등학교,10,10,0,10,6,4,0,0
교육기관,교육부,어룡초등학교,교육부 경기도교육청 경기도의정부교육지원청 어룡초등학교,15,15,0,15,15,0,0,0
교육기관,교육부,오동초등학교,교육부 경기도교육청 경기도의정부교육지원청 오동초등학교,16,16,0,16,0,16,0,0
교육기관,교육부,의순초등학교,교육부 경기도교육청 경기도의정부교육지원청 의순초등학교,20,20,0,20,0,20,0,0
교육기관,교육부,의정부고등학교,교육부 경기도교육청 경기도의정부교육지원청 의정부고등학교,62,62,0,62,30,32,0,0
교육기관,교육부,의정부공업고등학교,교육부 경기도교육청 경기도의정부교육지원청 의정부공업고등학교,113,113,0,113,63,50,0,0
교육기관,교육부,의정부광동고등학교,교육부 경기도교육청 경기도의정부교육지원청 의정부광동고등학교,15,9,6,9,0,9,0,0
교육기관,교육부,의정부부용초등학교,교육부 경기도교육청 경기도의정부교육지원청 의정부부용초등학교,12,12,0,12,12,0,0,0
교육기관,교육부,의정부서초등학교,교육부 경기도교육청 경기도의정부교육지원청 의정부서초등학교,12,12,0,12,10,2,0,0
교육기관,교육부,의정부송산초등학교,교육부 경기도교육청 경기도의정부교육지원청 의정부송산초등학교,19,19,0,19,19,0,0,0
교육기관,교육부,의정부신곡초등학교,교육부 경기도교육청 경기도의정부교육지원청 의정부신곡초등학교,18,18,0,18,18,0,0,0
교육기관,교육부,의정부여자고등학교,교육부 경기도교육청 경기도의정부교육지원청 의정부여자고등학교,22,20,2,20,0,20,0,0
교육기관,교육부,의정부용현초등학교,교육부 경기도교육청 경기도의정부교육지원청 의정부용현초등학교,19,19,0,19,19,0,0,0
교육기관,교육부,의정부장암초등학교,교육부 경기도교육청 경기도의정부교육지원청 의정부장암초등학교,13,13,0,13,6,7,0,0
교육기관,교육부,의정부중앙초등학교,교육부 경기도교육청 경기도의정부교육지원청 의정부중앙초등학교,21,21,0,21,21,0,0,0
교육기관,교육부,의정부중학교,교육부 경기도교육청 경기도의정부교육지원청 의정부중학교,17,17,0,17,1,16,0,0
교육기관,교육부,의정부청룡초등학교,교육부 경기도교육청 경기도의정부교육지원청 의정부청룡초등학교,23,23,0,23,9,14,0,0
교육기관,교육부,의정부초등학교,교육부 경기도교육청 경기도의정부교육지원청 의정부초등학교,14,14,0,14,0,14,0,0
교육기관,교육부,의정부호동초등학교,교육부 경기도교육청 경기도의정부교육지원청 의정부호동초등학교,16,16,0,16,16,0,0,0
교육기관,교육부,의정부호원초등학교,교육부 경기도교육청 경기도의정부교육지원청 의정부호원초등학교,17,17,0,17,0,17,0,0
교육기관,교육부,정음유치원,교육부 경기도교육청 경기도의정부교육지원청 정음유치원,35,8,27,8,4,4,0,0
교육기관,교육부,천보중학교,교육부 경기도교육청 경기도의정부교육지원청 천보중학교,26,26,0,26,16,10,0,0
교육기관,교육부,충의중학교,교육부 경기도교육청 경기도의정부교육지원청 충의중학교,19,19,0,19,0,19,0,0
교육기관,교육부,호암유치원,교육부 경기도교육청 경기도의정부교육지원청 호암유치원,19,19,0,19,3,15,1,0
교육기관,교육부,호암초등학교,교육부 경기도교육청 경기도의정부교육지원청 호암초등학교,15,15,0,15,0,15,0,0
교육기관,교육부,호원고등학교,교육부 경기도교육청 경기도의정부교육지원청 호원고등학교,36,36,0,36,29,7,0,0
교육기관,교육부,호원중학교,교육부 경기도교육청 경기도의정부교육지원청 호원중학교,28,28,0,28,0,28,0,0
교육기관,교육부,회룡초등학교,교육부 경기도교육청 경기도의정부교육지원청 회룡초등학교,24,24,0,24,24,0,0,0
교육기관,교육부,효자고등학교,교육부 경기도교육청 경기도의정부교육지원청 효자고등학교,41,40,1,40,3,33,2,2
교육기관,교육부,효자중학교,교육부 경기도교육청 경기도의정부교육지원청 효자중학교,38,38,0,38,0,38,0,0
교육기관,교육부,훈민중학교,교육부 경기도교육청 경기도의정부교육지원청 훈민중학교,45,45,0,45,20,25,0,0
교육기관,교육부,훈민초등학교,교육부 경기도교육청 경기도의정부교육지원청 훈민초등학교,17,17,0,17,7,10,0,0
교육기관,교육부,희망학교,교육부 경기도교육청 경기도의정부교육지원청 희망학교,27,27,0,27,23,4,0,0
교육기관,교육부,경기도이천교육지원청,교육부 경기도교육청 경기도이천교육지원청,16,16,0,16,16,0,0,0
교육기관,교육부,경기새울학교,교육부 경기도교육청 경기도이천교육지원청 경기새울학교,38,38,0,38,10,28,0,0
교육기관,교육부,나래초등학교,교육부 경기도교육청 경기도이천교육지원청 나래초등학교,12,12,0,12,12,0,0,0
교육기관,교육부,다원학교,교육부 경기도교육청 경기도이천교육지원청 다원학교,17,0,17,0,0,0,0,0
교육기관,교육부,대서초등학교,교육부 경기도교육청 경기도이천교육지원청 대서초등학교,25,25,0,25,5,20,0,0
교육기관,교육부,대서초등학교병설유치원,교육부 경기도교육청 경기도이천교육지원청 대서초등학교병설유치원,25,25,0,25,5,20,0,0
교육기관,교육부,대월중학교,교육부 경기도교육청 경기도이천교육지원청 대월중학교,16,16,0,16,4,12,0,0
교육기관,교육부,대월초등학교,교육부 경기도교육청 경기도이천교육지원청 대월초등학교,14,14,0,14,14,0,0,0
교육기관,교육부,도암초등학교,교육부 경기도교육청 경기도이천교육지원청 도암초등학교,21,21,0,21,21,0,0,0
교육기관,교육부,도지초등학교,교육부 경기도교육청 경기도이천교육지원청 도지초등학교,12,12,0,12,12,0,0,0
교육기관,교육부,마장고등학교,교육부 경기도교육청 경기도이천교육지원청 마장고등학교,6,6,0,6,3,3,0,0
교육기관,교육부,마장중학교,교육부 경기도교육청 경기도이천교육지원청 마장중학교,41,41,0,41,21,20,0,0
교육기관,교육부,마장초등학교,교육부 경기도교육청 경기도이천교육지원청 마장초등학교,23,23,0,23,23,0,0,0
교육기관,교육부,모가중학교,교육부 경기도교육청 경기도이천교육지원청 모가중학교,16,16,0,16,16,0,0,0
교육기관,교육부,백사중학교,교육부 경기도교육청 경기도이천교육지원청 백사중학교,10,10,0,10,8,0,2,0
교육기관,교육부,백사초등학교,교육부 경기도교육청 경기도이천교육지원청 백사초등학교,9,9,0,9,9,0,0,0
교육기관,교육부,부발중학교,교육부 경기도교육청 경기도이천교육지원청 부발중학교,18,18,0,18,10,6,2,0
교육기관,교육부,부발초등학교,교육부 경기도교육청 경기도이천교육지원청 부발초등학교,15,15,0,15,0,15,0,0
교육기관,교육부,부원고등학교,교육부 경기도교육청 경기도이천교육지원청 부원고등학교,50,33,17,33,13,20,0,0
교육기관,교육부,삼성숲유치원,교육부 경기도교육청 경기도이천교육지원청 삼성숲유치원,18,18,0,18,15,2,1,0
교육기관,교육부,설봉중학교,교육부 경기도교육청 경기도이천교육지원청 설봉중학교,25,25,0,25,6,17,1,1
교육기관,교육부,설봉초등학교,교육부 경기도교육청 경기도이천교육지원청 설봉초등학교,21,21,0,21,19,2,0,0
교육기관,교육부,설성초등학교,교육부 경기도교육청 경기도이천교육지원청 설성초등학교,16,16,0,16,10,6,0,0
교육기관,교육부,성모유치원,교육부 경기도교육청 경기도이천교육지원청 성모유치원,16,16,0,16,4,12,0,0
교육기관,교육부,송곡초등학교,교육부 경기도교육청 경기도이천교육지원청 송곡초등학교,9,9,0,9,9,0,0,0
교육기관,교육부,신둔초등학교,교육부 경기도교육청 경기도이천교육지원청 신둔초등학교,5,5,0,5,2,2,1,0
교육기관,교육부,신하초등학교,교육부 경기도교육청 경기도이천교육지원청 신하초등학교,14,0,14,0,0,0,0,0
교육기관,교육부,아미초등학교,교육부 경기도교육청 경기도이천교육지원청 아미초등학교,16,16,0,16,3,13,0,0
교육기관,교육부,아미하늘땅별땅유치원,교육부 경기도교육청 경기도이천교육지원청 아미하늘땅별땅유치원,23,23,0,23,23,0,0,0
교육기관,교육부,안흥초등학교,교육부 경기도교육청 경기도이천교육지원청 안흥초등학교,29,29,0,29,19,10,0,0
교육기관,교육부,율면고등학교,교육부 경기도교육청 경기도이천교육지원청 율면고등학교,12,12,0,12,1,11,0,0
교육기관,교육부,율면중학교,교육부 경기도교육청 경기도이천교육지원청 율면중학교,12,12,0,12,0,12,0,0
교육기관,교육부,율면초등학교,교육부 경기도교육청 경기도이천교육지원청 율면초등학교,8,8,0,8,6,2,0,0
교육기관,교육부,이천가산초등학교,교육부 경기도교육청 경기도이천교육지원청 이천가산초등학교,18,18,0,18,18,0,0,0
교육기관,교육부,이천경남중학교,교육부 경기도교육청 경기도이천교육지원청 이천경남중학교,18,18,0,18,14,4,0,0
교육기관,교육부,이천고등학교,교육부 경기도교육청 경기도이천교육지원청 이천고등학교,31,31,0,31,29,2,0,0
교육기관,교육부,이천남초등학교,교육부 경기도교육청 경기도이천교육지원청 이천남초등학교,20,20,0,20,20,0,0,0
교육기관,교육부,이천단월초등학교,교육부 경기도교육청 경기도이천교육지원청 이천단월초등학교,13,13,0,13,7,6,0,0
교육기관,교육부,이천매곡초등학교,교육부 경기도교육청 경기도이천교육지원청 이천매곡초등학교,8,8,0,8,3,5,0,0
교육기관,교육부,이천사동중학교,교육부 경기도교육청 경기도이천교육지원청 이천사동중학교,29,28,1,28,0,28,0,0
교육기관,교육부,이천사동초등학교,교육부 경기도교육청 경기도이천교육지원청 이천사동초등학교,21,21,0,21,12,7,2,0
교육기관,교육부,이천세무고등학교,교육부 경기도교육청 경기도이천교육지원청 이천세무고등학교,16,16,0,16,8,8,0,0
교육기관,교육부,이천송정중학교,교육부 경기도교육청 경기도이천교육지원청 이천송정중학교,27,27,0,27,23,2,1,1
교육기관,교육부,이천송정초등학교,교육부 경기도교육청 경기도이천교육지원청 이천송정초등학교,27,27,0,27,15,11,1,0
교육기관,교육부,이천양정여자고등학교,교육부 경기도교육청 경기도이천교육지원청 이천양정여자고등학교,26,26,0,26,18,8,0,0
교육기관,교육부,이천양정여자중학교,교육부 경기도교육청 경기도이천교육지원청 이천양정여자중학교,12,10,2,10,10,0,0,0
교육기관,교육부,이천제일고등학교,교육부 경기도교육청 경기도이천교육지원청 이천제일고등학교,47,45,2,45,25,20,0,0
교육기관,교육부,이천중학교,교육부 경기도교육청 경기도이천교육지원청 이천중학교,24,24,0,24,0,24,0,0
교육기관,교육부,이천초등학교,교육부 경기도교육청 경기도이천교육지원청 이천초등학교,15,15,0,15,10,5,0,0
교육기관,교육부,이현고등학교,교육부 경기도교육청 경기도이천교육지원청 이현고등학교,47,47,0,47,21,26,0,0
교육기관,교육부,이황초등학교,교육부 경기도교육청 경기도이천교육지원청 이황초등학교,14,14,0,14,7,7,0,0
교육기관,교육부,장천초등학교,교육부 경기도교육청 경기도이천교육지원청 장천초등학교,24,24,0,24,16,8,0,0
교육기관,교육부,장호원고등학교,교육부 경기도교육청 경기도이천교육지원청 장호원고등학교,16,16,0,16,8,8,0,0
교육기관,교육부,장호원중학교,교육부 경기도교육청 경기도이천교육지원청 장호원중학교,33,33,0,33,33,0,0,0
교육기관,교육부,증포중학교,교육부 경기도교육청 경기도이천교육지원청 증포중학교,85,85,0,85,85,0,0,0
교육기관,교육부,증포초등학교,교육부 경기도교육청 경기도이천교육지원청 증포초등학교,14,14,0,14,10,4,0,0
교육기관,교육부,진가초등학교,교육부 경기도교육청 경기도이천교육지원청 진가초등학교,8,8,0,8,6,2,0,0
교육기관,교육부,토마토유치원,교육부 경기도교육청 경기도이천교육지원청 토마토유치원,7,3,4,3,2,1,0,0
교육기관,교육부,표교초등학교,교육부 경기도교육청 경기도이천교육지원청 표교초등학교,12,12,0,12,4,4,4,0
교육기관,교육부,한국도예고등학교,교육부 경기도교육청 경기도이천교육지원청 한국도예고등학교,51,51,0,51,44,3,2,2
교육기관,교육부,한내초등학교,교육부 경기도교육청 경기도이천교육지원청 한내초등학교,12,12,0,12,6,5,0,1
교육기관,교육부,한마음유치원,교육부 경기도교육청 경기도이천교육지원청 한마음유치원,15,15,0,15,9,6,0,0
교육기관,교육부,한울숲유치원,교육부 경기도교육청 경기도이천교육지원청 한울숲유치원,20,20,0,20,0,20,0,0
교육기관,교육부,호법초등학교,교육부 경기도교육청 경기도이천교육지원청 호법초등학교,12,12,0,12,8,4,0,0
교육기관,교육부,효양고등학교,교육부 경기도교육청 경기도이천교육지원청 효양고등학교,16,16,0,16,8,8,0,0
교육기관,교육부,효양중학교,교육부 경기도교육청 경기도이천교육지원청 효양중학교,30,9,21,9,5,4,0,0
교육기관,교육부,경기도파주교육지원청,교육부 경기도교육청 경기도파주교육지원청,12,12,0,12,7,5,0,0
교육기관,교육부,가온유치원,교육부 경기도교육청 경기도파주교육지원청 가온유치원,4,4,0,4,0,4,0,0
교육기관,교육부,가온초등학교,교육부 경기도교육청 경기도파주교육지원청 가온초등학교,21,21,0,21,21,0,0,0
교육기관,교육부,갈현초등학교,교육부 경기도교육청 경기도파주교육지원청 갈현초등학교,9,9,0,9,0,9,0,0
교육기관,교육부,검산초등학교,교육부 경기도교육청 경기도파주교육지원청 검산초등학교,12,12,0,12,12,0,0,0
교육기관,교육부,광탄고등학교,교육부 경기도교육청 경기도파주교육지원청 광탄고등학교,44,44,0,44,0,44,0,0
교육기관,교육부,광탄중학교,교육부 경기도교육청 경기도파주교육지원청 광탄중학교,16,16,0,16,0,16,0,0
교육기관,교육부,교하고등학교,교육부 경기도교육청 경기도파주교육지원청 교하고등학교,43,43,0,43,0,43,0,0
교육기관,교육부,교하중학교,교육부 경기도교육청 경기도파주교육지원청 교하중학교,51,51,0,51,0,51,0,0
교육기관,교육부,교하초등학교,교육부 경기도교육청 경기도파주교육지원청 교하초등학교,12,12,0,12,6,6,0,0
교육기관,교육부,군내초등학교,교육부 경기도교육청 경기도파주교육지원청 군내초등학교,17,17,0,17,17,0,0,0
교육기관,교육부,금릉중학교,교육부 경기도교육청 경기도파주교육지원청 금릉중학교,42,42,0,42,42,0,0,0
교육기관,교육부,금릉초등학교,교육부 경기도교육청 경기도파주교육지원청 금릉초등학교,12,12,0,12,7,3,1,1
교육기관,교육부,금신초등학교,교육부 경기도교육청 경기도파주교육지원청 금신초등학교,19,19,0,19,0,19,0,0
교육기관,교육부,금촌고등학교,교육부 경기도교육청 경기도파주교육지원청 금촌고등학교,48,48,0,48,32,16,0,0
교육기관,교육부,금촌유치원,교육부 경기도교육청 경기도파주교육지원청 금촌유치원,4,4,0,4,2,2,0,0
교육기관,교육부,금촌중학교,교육부 경기도교육청 경기도파주교육지원청 금촌중학교,82,80,2,80,0,80,0,0
교육기관,교육부,금촌초등학교,교육부 경기도교육청 경기도파주교육지원청 금촌초등학교,14,14,0,14,14,0,0,0
교육기관,교육부,금향초등학교,교육부 경기도교육청 경기도파주교육지원청 금향초등학교,17,17,0,17,0,17,0,0
교육기관,교육부,금화초등학교,교육부 경기도교육청 경기도파주교육지원청 금화초등학교,14,14,0,14,0,14,0,0
교육기관,교육부,능안초등학교,교육부 경기도교육청 경기도파주교육지원청 능안초등학교,31,31,0,31,19,12,0,0
교육기관,교육부,다율유치원,교육부 경기도교육청 경기도파주교육지원청 다율유치원,12,12,0,12,6,6,0,0
교육기관,교육부,다율초등학교,교육부 경기도교육청 경기도파주교육지원청 다율초등학교,21,21,0,21,0,21,0,0
교육기관,교육부,덕암초등학교,교육부 경기도교육청 경기도파주교육지원청 덕암초등학교,8,8,0,8,8,0,0,0
교육기관,교육부,도마산초등학교,교육부 경기도교육청 경기도파주교육지원청 도마산초등학교,8,8,0,8,0,8,0,0
교육기관,교육부,동패고등학교,교육부 경기도교육청 경기도파주교육지원청 동패고등학교,50,50,0,50,0,50,0,0
교육기관,교육부,동패유치원,교육부 경기도교육청 경기도파주교육지원청 동패유치원,15,15,0,15,0,15,0,0
교육기관,교육부,동패중학교,교육부 경기도교육청 경기도파주교육지원청 동패중학교,47,47,0,47,0,47,0,0
교육기관,교육부,동패초등학교,교육부 경기도교육청 경기도파주교육지원청 동패초등학교,37,37,0,37,25,12,0,0
교육기관,교육부,두일유치원,교육부 경기도교육청 경기도파주교육지원청 두일유치원,6,6,0,6,0,6,0,0
교육기관,교육부,두일중학교,교육부 경기도교육청 경기도파주교육지원청 두일중학교,26,26,0,26,2,20,3,1
교육기관,교육부,두일초등학교,교육부 경기도교육청 경기도파주교육지원청 두일초등학교,25,25,0,25,0,25,0,0
교육기관,교육부,마정초등학교,교육부 경기도교육청 경기도파주교육지원청 마정초등학교,12,12,0,12,2,8,1,1
교육기관,교육부,마지초등학교,교육부 경기도교육청 경기도파주교육지원청 마지초등학교,13,13,0,13,0,13,0,0
교육기관,교육부,문발유치원,교육부 경기도교육청 경기도파주교육지원청 문발유치원,4,4,0,4,0,4,0,0
교육기관,교육부,문발초등학교,교육부 경기도교육청 경기도파주교육지원청 문발초등학교,18,18,0,18,16,2,0,0
교육기관,교육부,문산고등학교,교육부 경기도교육청 경기도파주교육지원청 문산고등학교,20,17,3,17,0,17,0,0
교육기관,교육부,문산동중학교,교육부 경기도교육청 경기도파주교육지원청 문산동중학교,14,14,0,14,0,14,0,0
교육기관,교육부,문산동초등학교,교육부 경기도교육청 경기도파주교육지원청 문산동초등학교,16,16,0,16,16,0,0,0
교육기관,교육부,문산북중학교,교육부 경기도교육청 경기도파주교육지원청 문산북중학교,38,38,0,38,0,38,0,0
교육기관,교육부,문산수억고등학교,교육부 경기도교육청 경기도파주교육지원청 문산수억고등학교,48,48,0,48,28,18,1,1
교육기관,교육부,문산수억중학교,교육부 경기도교육청 경기도파주교육지원청 문산수억중학교,32,32,0,32,0,32,0,0
교육기관,교육부,문산제일고등학교,교육부 경기도교육청 경기도파주교육지원청 문산제일고등학교,37,37,0,37,9,28,0,0
교육기관,교육부,문산중학교,교육부 경기도교육청 경기도파주교육지원청 문산중학교,29,29,0,29,29,0,0,0
교육기관,교육부,문산초등학교,교육부 경기도교육청 경기도파주교육지원청 문산초등학교,16,16,0,16,0,16,0,0
교육기관,교육부,법원여자중학교,교육부 경기도교육청 경기도파주교육지원청 법원여자중학교,9,8,1,8,1,7,0,0
교육기관,교육부,봉일천고등학교,교육부 경기도교육청 경기도파주교육지원청 봉일천고등학교,31,31,0,31,0,31,0,0
교육기관,교육부,봉일천중학교,교육부 경기도교육청 경기도파주교육지원청 봉일천중학교,33,33,0,33,33,0,0,0
교육기관,교육부,봉일천초등학교,교육부 경기도교육청 경기도파주교육지원청 봉일천초등학교,24,24,0,24,7,17,0,0
교육기관,교육부,산내중학교,교육부 경기도교육청 경기도파주교육지원청 산내중학교,51,51,0,51,30,21,0,0
교육기관,교육부,산내초등학교,교육부 경기도교육청 경기도파주교육지원청 산내초등학교,48,48,0,48,16,32,0,0
교육기관,교육부,산들중학교,교육부 경기도교육청 경기도파주교육지원청 산들중학교,25,25,0,25,25,0,0,0
교육기관,교육부,산들초등학교,교육부 경기도교육청 경기도파주교육지원청 산들초등학교,19,19,0,19,14,5,0,0
교육기관,교육부,삼광고등학교,교육부 경기도교육청 경기도파주교육지원청 삼광고등학교,13,12,1,12,0,12,0,0
교육기관,교육부,삼광중학교,교육부 경기도교육청 경기도파주교육지원청 삼광중학교,12,11,1,11,0,11,0,0
교육기관,교육부,삼성초등학교,교육부 경기도교육청 경기도파주교육지원청 삼성초등학교,12,12,0,12,0,12,0,0
교육기관,교육부,새금초등학교,교육부 경기도교육청 경기도파주교육지원청 새금초등학교,11,11,0,11,8,3,0,0
교육기관,교육부,새얼학교,교육부 경기도교육청 경기도파주교육지원청 새얼학교,20,20,0,20,0,20,0,0
교육기관,교육부,석곶초등학교,교육부 경기도교육청 경기도파주교육지원청 석곶초등학교,29,29,0,29,0,29,0,0
교육기관,교육부,선유중학교,교육부 경기도교육청 경기도파주교육지원청 선유중학교,16,16,0,16,16,0,0,0
교육기관,교육부,세경고등학교,교육부 경기도교육청 경기도파주교육지원청 세경고등학교,125,125,0,125,78,47,0,0
교육기관,교육부,신산초등학교,교육부 경기도교육청 경기도파주교육지원청 신산초등학교,30,30,0,30,20,10,0,0
교육기관,교육부,심학중학교,교육부 경기도교육청 경기도파주교육지원청 심학중학교,23,23,0,23,10,13,0,0
교육기관,교육부,심학초등학교,교육부 경기도교육청 경기도파주교육지원청 심학초등학교,9,9,0,9,4,5,0,0
교육기관,교육부,어유중학교,교육부 경기도교육청 경기도파주교육지원청 어유중학교,8,8,0,8,0,8,0,0
교육기관,교육부,연풍초등학교,교육부 경기도교육청 경기도파주교육지원청 연풍초등학교,20,20,0,20,20,0,0,0
교육기관,교육부,영도초등학교,교육부 경기도교육청 경기도파주교육지원청 영도초등학교,9,9,0,9,8,1,0,0
교육기관,교육부,와석초등학교,교육부 경기도교육청 경기도파주교육지원청 와석초등학교,21,21,0,21,12,9,0,0
교육기관,교육부,용미초등학교,교육부 경기도교육청 경기도파주교육지원청 용미초등학교,11,11,0,11,0,11,0,0
교육기관,교육부,용연초등학교,교육부 경기도교육청 경기도파주교육지원청 용연초등학교,10,10,0,10,0,10,0,0
교육기관,교육부,운광초등학교,교육부 경기도교육청 경기도파주교육지원청 운광초등학교,29,29,0,29,16,13,0,0
교육기관,교육부,운정고등학교,교육부 경기도교육청 경기도파주교육지원청 운정고등학교,19,19,0,19,7,7,4,1
교육기관,교육부,운정중학교,교육부 경기도교육청 경기도파주교육지원청 운정중학교,19,19,0,19,10,9,0,0
교육기관,교육부,운정초등학교,교육부 경기도교육청 경기도파주교육지원청 운정초등학교,14,14,0,14,0,14,0,0
교육기관,교육부,운정초롱유치원,교육부 경기도교육청 경기도파주교육지원청 운정초롱유치원,8,8,0,8,0,8,0,0
교육기관,교육부,웅담초등학교,교육부 경기도교육청 경기도파주교육지원청 웅담초등학교,11,11,0,11,6,5,0,0
교육기관,교육부,월롱초등학교,교육부 경기도교육청 경기도파주교육지원청 월롱초등학교,14,14,0,14,0,14,0,0
교육기관,교육부,율곡고등학교,교육부 경기도교육청 경기도파주교육지원청 율곡고등학교,21,21,0,21,18,3,0,0
교육기관,교육부,율곡중학교,교육부 경기도교육청 경기도파주교육지원청 율곡중학교,8,8,0,8,7,1,0,0
교육기관,교육부,임진초등학교,교육부 경기도교육청 경기도파주교육지원청 임진초등학교,29,29,0,29,0,29,0,0
교육기관,교육부,자운학교,교육부 경기도교육청 경기도파주교육지원청 자운학교,12,12,0,12,0,12,0,0
교육기관,교육부,자유초등학교,교육부 경기도교육청 경기도파주교육지원청 자유초등학교,16,16,0,16,16,0,0,0
교육기관,교육부,장파초등학교,교육부 경기도교육청 경기도파주교육지원청 장파초등학교,7,7,0,7,7,0,0,0
교육기관,교육부,적서초등학교,교육부 경기도교육청 경기도파주교육지원청 적서초등학교,7,7,0,7,0,7,0,0
교육기관,교육부,적성융합고등학교,교육부 경기도교육청 경기도파주교육지원청 적성융합고등학교,26,26,0,26,13,13,0,0
교육기관,교육부,적암초등학교,교육부 경기도교육청 경기도파주교육지원청 적암초등학교,6,6,0,6,6,0,0,0
교육기관,교육부,지산고등학교,교육부 경기도교육청 경기도파주교육지원청 지산고등학교,33,33,0,33,5,28,0,0
교육기관,교육부,지산중학교,교육부 경기도교육청 경기도파주교육지원청 지산중학교,23,23,0,23,23,0,0,0
교육기관,교육부,지산초등학교,교육부 경기도교육청 경기도파주교육지원청 지산초등학교,28,28,0,28,13,13,1,1
교육기관,교육부,천현초등학교,교육부 경기도교육청 경기도파주교육지원청 천현초등학교,16,16,0,16,0,16,0,0
교육기관,교육부,청석초등학교,교육부 경기도교육청 경기도파주교육지원청 청석초등학교,32,32,0,32,0,32,0,0
교육기관,교육부,청암초등학교,교육부 경기도교육청 경기도파주교육지원청 청암초등학교,22,22,0,22,8,8,4,2
교육기관,교육부,초롱초등학교,교육부 경기도교육청 경기도파주교육지원청 초롱초등학교,23,23,0,23,11,12,0,0
교육기관,교육부,탄현중학교,교육부 경기도교육청 경기도파주교육지원청 탄현중학교,17,17,0,17,8,7,1,1
교육기관,교육부,탄현초등학교,교육부 경기도교육청 경기도파주교육지원청 탄현초등학교,14,14,0,14,10,4,0,0
교육기관,교육부,통일초등학교,교육부 경기도교육청 경기도파주교육지원청 통일초등학교,12,12,0,12,6,6,0,0
교육기관,교육부,파양초등학교,교육부 경기도교육청 경기도파주교육지원청 파양초등학교,14,14,0,14,10,4,0,0
교육기관,교육부,파주고등학교,교육부 경기도교육청 경기도파주교육지원청 파주고등학교,24,24,0,24,0,24,0,0
교육기관,교육부,파주광일중학교,교육부 경기도교육청 경기도파주교육지원청 파주광일중학교,11,11,0,11,0,11,0,0
교육기관,교육부,파주대원초등학교,교육부 경기도교육청 경기도파주교육지원청 파주대원초등학교,22,22,0,22,13,9,0,0
교육기관,교육부,파주송화초등학교,교육부 경기도교육청 경기도파주교육지원청 파주송화초등학교,16,16,0,16,0,16,0,0
교육기관,교육부,파주여자고등학교,교육부 경기도교육청 경기도파주교육지원청 파주여자고등학교,23,23,0,23,0,23,0,0
교육기관,교육부,파주와동초등학교,교육부 경기도교육청 경기도파주교육지원청 파주와동초등학교,23,23,0,23,0,23,0,0
교육기관,교육부,파주중학교,교육부 경기도교육청 경기도파주교육지원청 파주중학교,9,8,1,8,4,4,0,0
교육기관,교육부,파주초등학교,교육부 경기도교육청 경기도파주교육지원청 파주초등학교,12,12,0,12,6,6,0,0
교육기관,교육부,파평중학교,교육부 경기도교육청 경기도파주교육지원청 파평중학교,16,16,0,16,0,16,0,0
교육기관,교육부,파평초등학교,교육부 경기도교육청 경기도파주교육지원청 파평초등학교,10,10,0,10,5,5,0,0
교육기관,교육부,한가람유치원,교육부 경기도교육청 경기도파주교육지원청 한가람유치원,8,4,4,4,4,0,0,0
교육기관,교육부,한가람중학교,교육부 경기도교육청 경기도파주교육지원청 한가람중학교,51,51,0,51,0,51,0,0
교육기관,교육부,한가람초등학교,교육부 경기도교육청 경기도파주교육지원청 한가람초등학교,20,20,0,20,20,0,0,0
교육기관,교육부,한민고등학교,교육부 경기도교육청 경기도파주교육지원청 한민고등학교,108,108,0,108,0,108,0,0
교육기관,교육부,한빛고등학교,교육부 경기도교육청 경기도파주교육지원청 한빛고등학교,93,93,0,93,93,0,0,0
교육기관,교육부,한빛중학교,교육부 경기도교육청 경기도파주교육지원청 한빛중학교,61,61,0,61,59,2,0,0
교육기관,교육부,한빛초등학교,교육부 경기도교육청 경기도파주교육지원청 한빛초등학교,21,21,0,21,21,0,0,0
교육기관,교육부,해솔빛유치원,교육부 경기도교육청 경기도파주교육지원청 해솔빛유치원,23,23,0,23,0,23,0,0
교육기관,교육부,해솔중학교,교육부 경기도교육청 경기도파주교육지원청 해솔중학교,32,32,0,32,0,32,0,0
교육기관,교육부,해솔초등학교,교육부 경기도교육청 경기도파주교육지원청 해솔초등학교,19,19,0,19,0,19,0,0
교육기관,교육부,경기도평택교육지원청,교육부 경기도교육청 경기도평택교육지원청,14,14,0,14,0,14,0,0
교육기관,교육부,가내초등학교,교육부 경기도교육청 경기도평택교육지원청 가내초등학교,20,20,0,20,20,0,0,0
교육기관,교육부,가사초등학교,교육부 경기도교육청 경기도평택교육지원청 가사초등학교,18,18,0,18,18,0,0,0
교육기관,교육부,갈곶초등학교,교육부 경기도교육청 경기도평택교육지원청 갈곶초등학교,8,8,0,8,8,0,0,0
교육기관,교육부,경기물류고등학교,교육부 경기도교육청 경기도평택교육지원청 경기물류고등학교,21,21,0,21,11,10,0,0
교육기관,교육부,계성초등학교,교육부 경기도교육청 경기도평택교육지원청 계성초등학교,14,14,0,14,8,6,0,0
교육기관,교육부,고덕초등학교,교육부 경기도교육청 경기도평택교육지원청 고덕초등학교,32,32,0,32,32,0,0,0
교육기관,교육부,군문유치원,교육부 경기도교육청 경기도평택교육지원청 군문유치원,5,5,0,5,5,0,0,0
교육기관,교육부,군문초등학교,교육부 경기도교육청 경기도평택교육지원청 군문초등학교,15,15,0,15,15,0,0,0
교육기관,교육부,기린유치원,교육부 경기도교육청 경기도평택교육지원청 기린유치원,9,0,9,0,0,0,0,0
교육기관,교육부,나사렛유치원,교육부 경기도교육청 경기도평택교육지원청 나사렛유치원,16,5,11,5,2,1,1,1
교육기관,교육부,내기초등학교,교육부 경기도교육청 경기도평택교육지원청 내기초등학교,12,12,0,12,12,0,0,0
교육기관,교육부,덕동초등학교,교육부 경기도교육청 경기도평택교육지원청 덕동초등학교,19,19,0,19,19,0,0,0
교육기관,교육부,도곡중학교,교육부 경기도교육청 경기도평택교육지원청 도곡중학교,17,17,0,17,17,0,0,0
교육기관,교육부,동방학교,교육부 경기도교육청 경기도평택교육지원청 동방학교,16,16,0,16,16,0,0,0
교육기관,교육부,동삭초등학교,교육부 경기도교육청 경기도평택교육지원청 동삭초등학교,15,15,0,15,6,9,0,0
교육기관,교육부,동일공업고등학교,교육부 경기도교육청 경기도평택교육지원청 동일공업고등학교,25,25,0,25,4,21,0,0
교육기관,교육부,라온고등학교,교육부 경기도교육청 경기도평택교육지원청 라온고등학교,48,48,0,48,30,18,0,0
교육기관,교육부,라온중학교,교육부 경기도교육청 경기도평택교육지원청 라온중학교,38,38,0,38,0,38,0,0
교육기관,교육부,반지초등학교,교육부 경기도교육청 경기도평택교육지원청 반지초등학교,34,34,0,34,34,0,0,0
교육기관,교육부,배다리초등학교,교육부 경기도교육청 경기도평택교육지원청 배다리초등학교,30,30,0,30,30,0,0,0
교육기관,교육부,복창초등학교,교육부 경기도교육청 경기도평택교육지원청 복창초등학교,9,9,0,9,9,0,0,0
교육기관,교육부,부용초등학교,교육부 경기도교육청 경기도평택교육지원청 부용초등학교,19,19,0,19,19,0,0,0
교육기관,교육부,비전고등학교,교육부 경기도교육청 경기도평택교육지원청 비전고등학교,47,47,0,47,0,47,0,0
교육기관,교육부,비전중학교,교육부 경기도교육청 경기도평택교육지원청 비전중학교,44,44,0,44,28,16,0,0
교육기관,교육부,비전초등학교,교육부 경기도교육청 경기도평택교육지원청 비전초등학교,13,13,0,13,1,12,0,0
교육기관,교육부,삼덕초등학교,교육부 경기도교육청 경기도평택교육지원청 삼덕초등학교,2,2,0,2,0,2,0,0
교육기관,교육부,새말유치원,교육부 경기도교육청 경기도평택교육지원청 새말유치원,24,24,0,24,1,23,0,0
교육기관,교육부,서정리초등학교,교육부 경기도교육청 경기도평택교육지원청 서정리초등학교,27,27,0,27,0,27,0,0
교육기관,교육부,서탄초등학교,교육부 경기도교육청 경기도평택교육지원청 서탄초등학교,13,13,0,13,10,3,0,0
교육기관,교육부,서탄초등학교내수분교장,교육부 경기도교육청 경기도평택교육지원청 서탄초등학교내수분교장,13,13,0,13,10,3,0,0
교육기관,교육부,세교중학교,교육부 경기도교육청 경기도평택교육지원청 세교중학교,33,33,0,33,15,18,0,0
교육기관,교육부,세교초등학교,교육부 경기도교육청 경기도평택교육지원청 세교초등학교,21,21,0,21,0,21,0,0
교육기관,교육부,세아초등학교,교육부 경기도교육청 경기도평택교육지원청 세아초등학교,22,20,2,20,5,15,0,0
교육기관,교육부,소사벌초등학교,교육부 경기도교육청 경기도평택교육지원청 소사벌초등학교,26,26,0,26,7,19,0,0
교육기관,교육부,소화데레사유치원,교육부 경기도교육청 경기도평택교육지원청 소화데레사유치원,23,14,9,14,1,11,1,1
교육기관,교육부,송북초등학교,교육부 경기도교육청 경기도평택교육지원청 송북초등학교,32,32,0,32,32,0,0,0
교육기관,교육부,송신초등학교,교육부 경기도교육청 경기도평택교육지원청 송신초등학교,12,12,0,12,12,0,0,0
교육기관,교육부,송일초등학교,교육부 경기도교육청 경기도평택교육지원청 송일초등학교,20,20,0,20,10,10,0,0
교육기관,교육부,송탄고등학교,교육부 경기도교육청 경기도평택교육지원청 송탄고등학교,36,35,1,35,14,21,0,0
교육기관,교육부,송탄중학교,교육부 경기도교육청 경기도평택교육지원청 송탄중학교,12,12,0,12,6,6,0,0
교육기관,교육부,송탄초등학교,교육부 경기도교육청 경기도평택교육지원청 송탄초등학교,16,16,0,16,16,0,0,0
교육기관,교육부,송현초등학교,교육부 경기도교육청 경기도평택교육지원청 송현초등학교,12,12,0,12,8,4,0,0
교육기관,교육부,숲아이유치원,교육부 경기도교육청 경기도평택교육지원청 숲아이유치원,20,4,16,4,1,1,1,1
교육기관,교육부,신한고등학교,교육부 경기도교육청 경기도평택교육지원청 신한고등학교,15,15,0,15,0,15,0,0
교육기관,교육부,신한중학교,교육부 경기도교육청 경기도평택교육지원청 신한중학교,8,8,0,8,0,8,0,0
교육기관,교육부,안일중학교,교육부 경기도교육청 경기도평택교육지원청 안일중학교,54,54,0,54,14,40,0,0
교육기관,교육부,안중고등학교,교육부 경기도교육청 경기도평택교육지원청 안중고등학교,9,7,2,7,7,0,0,0
교육기관,교육부,안중유치원,교육부 경기도교육청 경기도평택교육지원청 안중유치원,11,11,0,11,2,8,1,0
교육기관,교육부,안중중학교,교육부 경기도교육청 경기도평택교육지원청 안중중학교,13,13,0,13,3,10,0,0
교육기관,교육부,안중파랑새유치원,교육부 경기도교육청 경기도평택교육지원청 안중파랑새유치원,24,3,21,3,2,1,0,0
교육기관,교육부,어연초등학교,교육부 경기도교육청 경기도평택교육지원청 어연초등학교,13,13,0,13,13,0,0,0
교육기관,교육부,에바다학교,교육부 경기도교육청 경기도평택교육지원청 에바다학교,20,20,0,20,20,0,0,0
교육기관,교육부,예림유치원,교육부 경기도교육청 경기도평택교육지원청 예림유치원,14,3,11,3,1,2,0,0
교육기관,교육부,오성중학교,교육부 경기도교육청 경기도평택교육지원청 오성중학교,12,12,0,12,12,0,0,0
교육기관,교육부,오성초등학교,교육부 경기도교육청 경기도평택교육지원청 오성초등학교,17,17,0,17,17,0,0,0
교육기관,교육부,용이중학교,교육부 경기도교육청 경기도평택교육지원청 용이중학교,22,20,2,20,16,4,0,0
교육기관,교육부,용이초등학교,교육부 경기도교육청 경기도평택교육지원청 용이초등학교,30,30,0,30,30,0,0,0
교육기관,교육부,용죽초등학교,교육부 경기도교육청 경기도평택교육지원청 용죽초등학교,28,28,0,28,28,0,0,0
교육기관,교육부,은혜고등학교,교육부 경기도교육청 경기도평택교육지원청 은혜고등학교,40,40,0,40,22,12,4,2
교육기관,교육부,은혜중학교,교육부 경기도교육청 경기도평택교육지원청 은혜중학교,49,49,0,49,2,46,0,1
교육기관,교육부,이충초등학교,교육부 경기도교육청 경기도평택교육지원청 이충초등학교,15,15,0,15,0,15,0,0
교육기관,교육부,자란초등학교,교육부 경기도교육청 경기도평택교육지원청 자란초등학교,17,17,0,17,17,0,0,0
교육기관,교육부,장당중학교,교육부 경기도교육청 경기도평택교육지원청 장당중학교,17,17,0,17,10,7,0,0
교육기관,교육부,장당초등학교,교육부 경기도교육청 경기도평택교육지원청 장당초등학교,14,14,0,14,4,10,0,0
교육기관,교육부,종덕초등학교,교육부 경기도교육청 경기도평택교육지원청 종덕초등학교,35,35,0,35,35,0,0,0
교육기관,교육부,죽백초등학교,교육부 경기도교육청 경기도평택교육지원청 죽백초등학교,14,14,0,14,7,7,0,0
교육기관,교육부,지장초등학교,교육부 경기도교육청 경기도평택교육지원청 지장초등학교,22,22,0,22,22,0,0,0
교육기관,교육부,지제초등학교,교육부 경기도교육청 경기도평택교육지원청 지제초등학교,32,32,0,32,0,32,0,0
교육기관,교육부,진위초등학교,교육부 경기도교육청 경기도평택교육지원청 진위초등학교,14,14,0,14,0,14,0,0
교육기관,교육부,진위초등학교산대분교장,교육부 경기도교육청 경기도평택교육지원청 진위초등학교산대분교장,8,8,0,8,4,4,0,0
교육기관,교육부,창신초등학교,교육부 경기도교육청 경기도평택교육지원청 창신초등학교,10,10,0,10,0,10,0,0
교육기관,교육부,청담고등학교,교육부 경기도교육청 경기도평택교육지원청 청담고등학교,57,57,0,57,57,0,0,0
교육기관,교육부,청담중학교,교육부 경기도교육청 경기도평택교육지원청 청담중학교,40,40,0,40,20,20,0,0
교육기관,교육부,청북고등학교,교육부 경기도교육청 경기도평택교육지원청 청북고등학교,52,52,0,52,10,40,2,0
교육기관,교육부,청북유치원,교육부 경기도교육청 경기도평택교육지원청 청북유치원,18,7,11,7,0,7,0,0
교육기관,교육부,청북중학교,교육부 경기도교육청 경기도평택교육지원청 청북중학교,10,10,0,10,0,10,0,0
교육기관,교육부,청북초등학교,교육부 경기도교육청 경기도평택교육지원청 청북초등학교,18,18,0,18,0,18,0,0
교육기관,교육부,청옥중학교,교육부 경기도교육청 경기도평택교육지원청 청옥중학교,15,15,0,15,15,0,0,0
교육기관,교육부,청옥초등학교,교육부 경기도교육청 경기도평택교육지원청 청옥초등학교,18,18,0,18,0,18,0,0
교육기관,교육부,태광고등학교,교육부 경기도교육청 경기도평택교육지원청 태광고등학교,23,23,0,23,12,11,0,0
교육기관,교육부,태광중학교,교육부 경기도교육청 경기도평택교육지원청 태광중학교,13,13,0,13,13,0,0,0
교육기관,교육부,팽성초등학교,교육부 경기도교육청 경기도평택교육지원청 팽성초등학교,12,12,0,12,0,12,0,0
교육기관,교육부,평일초등학교,교육부 경기도교육청 경기도평택교육지원청 평일초등학교,41,41,0,41,38,2,0,1
교육기관,교육부,평택고덕유치원,교육부 경기도교육청 경기도평택교육지원청 평택고덕유치원,16,16,0,16,0,16,0,0
교육기관,교육부,평택고등학교,교육부 경기도교육청 경기도평택교육지원청 평택고등학교,65,65,0,65,0,65,0,0
교육기관,교육부,평택대동유치원,교육부 경기도교육청 경기도평택교육지원청 평택대동유치원,12,12,0,12,0,12,0,0
교육기관,교육부,평택대동초등학교,교육부 경기도교육청 경기도평택교육지원청 평택대동초등학교,29,29,0,29,16,10,2,1
교육기관,교육부,평택도곡초등학교,교육부 경기도교육청 경기도평택교육지원청 평택도곡초등학교,16,16,0,16,6,8,1,1
교육기관,교육부,평택마이스터고등학교,교육부 경기도교육청 경기도평택교육지원청 평택마이스터고등학교,103,103,0,103,0,103,0,0
교육기관,교육부,평택새빛초등학교,교육부 경기도교육청 경기도평택교육지원청 평택새빛초등학교,26,26,0,26,0,26,0,0
교육기관,교육부,평택서재초등학교,교육부 경기도교육청 경기도평택교육지원청 평택서재초등학교,22,22,0,22,16,6,0,0
교육기관,교육부,평택성동유치원,교육부 경기도교육청 경기도평택교육지원청 평택성동유치원,14,14,0,14,7,7,0,0
교육기관,교육부,평택성동초등학교,교육부 경기도교육청 경기도평택교육지원청 평택성동초등학교,38,38,0,38,38,0,0,0
교육기관,교육부,평택소화유치원,교육부 경기도교육청 경기도평택교육지원청 평택소화유치원,10,10,0,10,1,9,0,0
교육기관,교육부,평택송화초등학교,교육부 경기도교육청 경기도평택교육지원청 평택송화초등학교,34,34,0,34,33,1,0,0
교육기관,교육부,평택안일초등학교,교육부 경기도교육청 경기도평택교육지원청 평택안일초등학교,23,23,0,23,0,23,0,0
교육기관,교육부,평택여자고등학교,교육부 경기도교육청 경기도평택교육지원청 평택여자고등학교,20,20,0,20,20,0,0,0
교육기관,교육부,평택여자중학교,교육부 경기도교육청 경기도평택교육지원청 평택여자중학교,27,27,0,27,27,0,0,0
교육기관,교육부,평택이화초등학교,교육부 경기도교육청 경기도평택교육지원청 평택이화초등학교,29,29,0,29,29,0,0,0
교육기관,교육부,평택중앙초등학교,교육부 경기도교육청 경기도평택교육지원청 평택중앙초등학교,16,16,0,16,10,6,0,0
교육기관,교육부,평택중학교,교육부 경기도교육청 경기도평택교육지원청 평택중학교,44,41,3,41,0,41,0,0
교육기관,교육부,평택지산초등학교,교육부 경기도교육청 경기도평택교육지원청 평택지산초등학교,19,19,0,19,15,4,0,0
교육기관,교육부,평택청아초등학교,교육부 경기도교육청 경기도평택교육지원청 평택청아초등학교,20,20,0,20,16,4,0,0
교육기관,교육부,평택초등학교,교육부 경기도교육청 경기도평택교육지원청 평택초등학교,14,14,0,14,14,0,0,0
교육기관,교육부,평택파랑새유치원,교육부 경기도교육청 경기도평택교육지원청 평택파랑새유치원,39,39,0,39,0,39,0,0
교육기관,교육부,포승중학교,교육부 경기도교육청 경기도평택교육지원청 포승중학교,9,9,0,9,3,6,0,0
교육기관,교육부,피터팬유치원,교육부 경기도교육청 경기도평택교육지원청 피터팬유치원,18,0,18,0,0,0,0,0
교육기관,교육부,한광고등학교,교육부 경기도교육청 경기도평택교육지원청 한광고등학교,24,24,0,24,0,24,0,0
교육기관,교육부,한광여자고등학교,교육부 경기도교육청 경기도평택교육지원청 한광여자고등학교,61,14,47,14,5,9,0,0
교육기관,교육부,한광여자중학교,교육부 경기도교육청 경기도평택교육지원청 한광여자중학교,36,36,0,36,36,0,0,0
교육기관,교육부,한광중학교,교육부 경기도교육청 경기도평택교육지원청 한광중학교,40,40,0,40,0,40,0,0
교육기관,교육부,한국관광고등학교,교육부 경기도교육청 경기도평택교육지원청 한국관광고등학교,40,40,0,40,0,40,0,0
교육기관,교육부,합정초등학교,교육부 경기도교육청 경기도평택교육지원청 합정초등학교,16,16,0,16,16,0,0,0
교육기관,교육부,현덕초등학교,교육부 경기도교육청 경기도평택교육지원청 현덕초등학교,14,14,0,14,6,8,0,0
교육기관,교육부,현덕초등학교광덕분교장,교육부 경기도교육청 경기도평택교육지원청 현덕초등학교광덕분교장,9,9,0,9,4,5,0,0
교육기관,교육부,현일초등학교,교육부 경기도교육청 경기도평택교육지원청 현일초등학교,16,16,0,16,2,14,0,0
교육기관,교육부,현촌유치원,교육부 경기도교육청 경기도평택교육지원청 현촌유치원,16,16,0,16,0,16,0,0
교육기관,교육부,현촌초등학교,교육부 경기도교육청 경기도평택교육지원청 현촌초등학교,33,33,0,33,20,8,2,3
교육기관,교육부,현화고등학교,교육부 경기도교육청 경기도평택교육지원청 현화고등학교,25,16,9,16,14,2,0,0
교육기관,교육부,현화유치원,교육부 경기도교육청 경기도평택교육지원청 현화유치원,14,5,9,5,2,3,0,0
교육기관,교육부,현화중학교,교육부 경기도교육청 경기도평택교육지원청 현화중학교,31,30,1,30,20,10,0,0
교육기관,교육부,현화초등학교,교육부 경기도교육청 경기도평택교육지원청 현화초등학교,12,12,0,12,12,0,0,0
교육기관,교육부,홍원초등학교,교육부 경기도교육청 경기도평택교육지원청 홍원초등학교,13,13,0,13,0,13,0,0
교육기관,교육부,효덕초등학교,교육부 경기도교육청 경기도평택교육지원청 효덕초등학교,7,7,0,7,7,0,0,0
교육기관,교육부,효명고등학교,교육부 경기도교육청 경기도평택교육지원청 효명고등학교,32,20,12,20,12,8,0,0
교육기관,교육부,효명중학교,교육부 경기도교육청 경기도평택교육지원청 효명중학교,35,35,0,35,0,35,0,0
교육기관,교육부,경기도평화교육연수원,교육부 경기도교육청 경기도평화교육연수원,34,34,0,34,0,34,0,0
교육기관,교육부,경기도포천교육지원청,교육부 경기도교육청 경기도포천교육지원청,16,16,0,16,0,16,0,0
교육기관,교육부,갈월중학교,교육부 경기도교육청 경기도포천교육지원청 갈월중학교,10,9,1,9,9,0,0,0
교육기관,교육부,경북중학교,교육부 경기도교육청 경기도포천교육지원청 경북중학교,15,15,0,15,10,5,0,0
교육기관,교육부,관인고등학교,교육부 경기도교육청 경기도포천교육지원청 관인고등학교,10,10,0,10,8,2,0,0
교육기관,교육부,관인초등학교,교육부 경기도교육청 경기도포천교육지원청 관인초등학교,11,11,0,11,11,0,0,0
교육기관,교육부,내촌중학교,교육부 경기도교육청 경기도포천교육지원청 내촌중학교,10,9,1,9,3,3,1,2
교육기관,교육부,내촌초등학교,교육부 경기도교육청 경기도포천교육지원청 내촌초등학교,9,9,0,9,9,0,0,0
교육기관,교육부,대경중학교,교육부 경기도교육청 경기도포천교육지원청 대경중학교,42,42,0,42,42,0,0,0
교육기관,교육부,도평초등학교,교육부 경기도교육청 경기도포천교육지원청 도평초등학교,9,9,0,9,4,4,1,0
교육기관,교육부,동남고등학교,교육부 경기도교육청 경기도포천교육지원청 동남고등학교,21,21,0,21,7,10,3,1
교육기관,교육부,동남중학교,교육부 경기도교육청 경기도포천교육지원청 동남중학교,17,16,1,16,16,0,0,0
교육기관,교육부,삼성중학교,교육부 경기도교육청 경기도포천교육지원청 삼성중학교,8,8,0,8,2,2,2,2
교육기관,교육부,서일유치원,교육부 경기도교육청 경기도포천교육지원청 서일유치원,20,7,13,7,0,7,0,0
교육기관,교육부,선단초등학교,교육부 경기도교육청 경기도포천교육지원청 선단초등학교,22,22,0,22,17,5,0,0
교육기관,교육부,송우중학교,교육부 경기도교육청 경기도포천교육지원청 송우중학교,22,22,0,22,22,0,0,0
교육기관,교육부,송우초등학교,교육부 경기도교육청 경기도포천교육지원청 송우초등학교,20,20,0,20,20,0,0,0
교육기관,교육부,신봉초등학교,교육부 경기도교육청 경기도포천교육지원청 신봉초등학교,17,17,0,17,10,7,0,0
교육기관,교육부,신북초등학교,교육부 경기도교육청 경기도포천교육지원청 신북초등학교,12,12,0,12,8,4,0,0
교육기관,교육부,영북고등학교,교육부 경기도교육청 경기도포천교육지원청 영북고등학교,26,26,0,26,19,7,0,0
교육기관,교육부,영북중학교,교육부 경기도교육청 경기도포천교육지원청 영북중학교,16,15,1,15,15,0,0,0
교육기관,교육부,영북초등학교,교육부 경기도교육청 경기도포천교육지원청 영북초등학교,12,12,0,12,0,12,0,0
교육기관,교육부,영중중학교,교육부 경기도교육청 경기도포천교육지원청 영중중학교,20,20,0,20,10,10,0,0
교육기관,교육부,왕방초등학교,교육부 경기도교육청 경기도포천교육지원청 왕방초등학교,14,14,0,14,11,3,0,0
교육기관,교육부,외북초등학교,교육부 경기도교육청 경기도포천교육지원청 외북초등학교,11,11,0,11,4,7,0,0
교육기관,교육부,운담초등학교,교육부 경기도교육청 경기도포천교육지원청 운담초등학교,8,8,0,8,6,2,0,0
교육기관,교육부,유암초등학교,교육부 경기도교육청 경기도포천교육지원청 유암초등학교,9,9,0,9,5,2,1,1
교육기관,교육부,이곡초등학교,교육부 경기도교육청 경기도포천교육지원청 이곡초등학교,16,16,0,16,0,16,0,0
교육기관,교육부,이동중학교,교육부 경기도교육청 경기도포천교육지원청 이동중학교,11,11,0,11,0,11,0,0
교육기관,교육부,이동초등학교,교육부 경기도교육청 경기도포천교육지원청 이동초등학교,10,10,0,10,5,5,0,0
교육기관,교육부,일동고등학교,교육부 경기도교육청 경기도포천교육지원청 일동고등학교,22,21,1,21,17,4,0,0
교육기관,교육부,일동유치원,교육부 경기도교육청 경기도포천교육지원청 일동유치원,21,7,14,7,3,4,0,0
교육기관,교육부,일동중학교,교육부 경기도교육청 경기도포천교육지원청 일동중학교,27,27,0,27,27,0,0,0
교육기관,교육부,일동초등학교,교육부 경기도교육청 경기도포천교육지원청 일동초등학교,28,28,0,28,16,12,0,0
교육기관,교육부,정교초등학교,교육부 경기도교육청 경기도포천교육지원청 정교초등학교,8,8,0,8,7,1,0,0
교육기관,교육부,중리초등학교,교육부 경기도교육청 경기도포천교육지원청 중리초등학교,15,15,0,15,13,2,0,0
교육기관,교육부,지현초등학교,교육부 경기도교육청 경기도포천교육지원청 지현초등학교,11,11,0,11,11,0,0,0
교육기관,교육부,창수초등학교,교육부 경기도교육청 경기도포천교육지원청 창수초등학교,9,9,0,9,9,0,0,0
교육기관,교육부,청성초등학교,교육부 경기도교육청 경기도포천교육지원청 청성초등학교,12,12,0,12,0,12,0,0
교육기관,교육부,추산유치원,교육부 경기도교육청 경기도포천교육지원청 추산유치원,9,9,0,9,6,3,0,0
교육기관,교육부,추산초등학교,교육부 경기도교육청 경기도포천교육지원청 추산초등학교,19,19,0,19,10,4,5,0
교육기관,교육부,축석초등학교,교육부 경기도교육청 경기도포천교육지원청 축석초등학교,14,14,0,14,14,0,0,0
교육기관,교육부,태봉초등학교,교육부 경기도교육청 경기도포천교육지원청 태봉초등학교,26,26,0,26,26,0,0,0
교육기관,교육부,포담초등학교,교육부 경기도교육청 경기도포천교육지원청 포담초등학교,16,16,0,16,16,0,0,0
교육기관,교육부,포천고등학교,교육부 경기도교육청 경기도포천교육지원청 포천고등학교,44,44,0,44,44,0,0,0
교육기관,교육부,포천노곡초등학교,교육부 경기도교육청 경기도포천교육지원청 포천노곡초등학교,10,10,0,10,8,2,0,0
교육기관,교육부,포천삼정초등학교,교육부 경기도교육청 경기도포천교육지원청 포천삼정초등학교,13,13,0,13,11,2,0,0
교육기관,교육부,포천여자중학교,교육부 경기도교육청 경기도포천교육지원청 포천여자중학교,16,16,0,16,0,16,0,0
교육기관,교육부,포천일고등학교,교육부 경기도교육청 경기도포천교육지원청 포천일고등학교,30,30,0,30,25,5,0,0
교육기관,교육부,포천중학교,교육부 경기도교육청 경기도포천교육지원청 포천중학교,22,22,0,22,11,11,0,0
교육기관,교육부,포천초등학교,교육부 경기도교육청 경기도포천교육지원청 포천초등학교,17,17,0,17,17,0,0,0
교육기관,교육부,화현초등학교,교육부 경기도교육청 경기도포천교육지원청 화현초등학교,12,12,0,12,6,6,0,0
교육기관,교육부,경기도학생교육원,교육부 경기도교육청 경기도학생교육원,13,13,0,13,0,13,0,0
교육기관,교육부,김포학생야영장,교육부 경기도교육청 경기도학생교육원 김포학생야영장,5,5,0,5,0,5,0,0
교육기관,교육부,양평학생야영장,교육부 경기도교육청 경기도학생교육원 양평학생야영장,4,4,0,4,0,4,0,0
교육기관,교육부,여주학생야영장,교육부 경기도교육청 경기도학생교육원 여주학생야영장,4,4,0,4,0,4,0,0
교육기관,교육부,연천학생야영장,교육부 경기도교육청 경기도학생교육원 연천학생야영장,7,7,0,7,0,7,0,0
교육기관,교육부,용인학생야영장,교육부 경기도교육청 경기도학생교육원 용인학생야영장,4,4,0,4,0,4,0,0
교육기관,교육부,포천학생야영장,교육부 경기도교육청 경기도학생교육원 포천학생야영장,9,9,0,9,9,0,0,0
교육기관,교육부,경기도혁신교육연수원,교육부 경기도교육청 경기도혁신교육연수원,56,56,0,56,38,18,0,0
교육기관,교육부,경기도화성오산교육지원청,교육부 경기도교육청 경기도화성오산교육지원청,64,64,0,64,0,64,0,0
교육기관,교육부,가수초등학교,교육부 경기도교육청 경기도화성오산교육지원청 가수초등학교,12,12,0,12,12,0,0,0
교육기관,교육부,갈담초등학교,교육부 경기도교육청 경기도화성오산교육지원청 갈담초등학교,10,10,0,10,4,6,0,0
교육기관,교육부,갈천초등학교,교육부 경기도교육청 경기도화성오산교육지원청 갈천초등학교,6,6,0,6,0,6,0,0
교육기관,교육부,고정초등학교,교육부 경기도교육청 경기도화성오산교육지원청 고정초등학교,17,17,0,17,17,0,0,0
교육기관,교육부,광성초등학교,교육부 경기도교육청 경기도화성오산교육지원청 광성초등학교,17,6,11,6,5,1,0,0
교육기관,교육부,구봉초등학교,교육부 경기도교육청 경기도화성오산교육지원청 구봉초등학교,16,16,0,16,8,8,0,0
교육기관,교육부,금암초등학교,교육부 경기도교육청 경기도화성오산교육지원청 금암초등학교,21,21,0,21,11,10,0,0
교육기관,교육부,기산중학교,교육부 경기도교육청 경기도화성오산교육지원청 기산중학교,22,22,0,22,0,22,0,0
교육기관,교육부,기산초등학교,교육부 경기도교육청 경기도화성오산교육지원청 기산초등학교,16,16,0,16,8,8,0,0
교육기관,교육부,기안중학교,교육부 경기도교육청 경기도화성오산교육지원청 기안중학교,28,28,0,28,0,28,0,0
교육기관,교육부,기안초등학교,교육부 경기도교육청 경기도화성오산교육지원청 기안초등학교,24,24,0,24,0,24,0,0
교육기관,교육부,깊은샘유치원,교육부 경기도교육청 경기도화성오산교육지원청 깊은샘유치원,13,13,0,13,0,13,0,0
교육기관,교육부,나루고등학교,교육부 경기도교육청 경기도화성오산교육지원청 나루고등학교,50,48,2,48,25,23,0,0
교육기관,교육부,남양고등학교,교육부 경기도교육청 경기도화성오산교육지원청 남양고등학교,17,11,6,11,11,0,0,0
교육기관,교육부,남양중학교,교육부 경기도교육청 경기도화성오산교육지원청 남양중학교,18,18,0,18,9,9,0,0
교육기관,교육부,남양초등학교,교육부 경기도교육청 경기도화성오산교육지원청 남양초등학교,27,27,0,27,11,16,0,0
교육기관,교육부,노진초등학교,교육부 경기도교육청 경기도화성오산교육지원청 노진초등학교,19,19,0,19,14,5,0,0
교육기관,교육부,노틀담유치원,교육부 경기도교육청 경기도화성오산교육지원청 노틀담유치원,16,16,0,16,0,16,0,0
교육기관,교육부,늘봄초등학교,교육부 경기도교육청 경기도화성오산교육지원청 늘봄초등학교,18,18,0,18,18,0,0,0
교육기관,교육부,능동고등학교,교육부 경기도교육청 경기도화성오산교육지원청 능동고등학교,31,31,0,31,9,22,0,0
교육기관,교육부,능동중학교,교육부 경기도교육청 경기도화성오산교육지원청 능동중학교,32,32,0,32,16,16,0,0
교육기관,교육부,능동초등학교,교육부 경기도교육청 경기도화성오산교육지원청 능동초등학교,33,33,0,33,33,0,0,0
교육기관,교육부,다온초등학교,교육부 경기도교육청 경기도화성오산교육지원청 다온초등학교,20,20,0,20,15,5,0,0
교육기관,교육부,다원유치원,교육부 경기도교육청 경기도화성오산교육지원청 다원유치원,16,16,0,16,12,4,0,0
교육기관,교육부,다원중학교,교육부 경기도교육청 경기도화성오산교육지원청 다원중학교,53,53,0,53,0,53,0,0
교육기관,교육부,다원초등학교,교육부 경기도교육청 경기도화성오산교육지원청 다원초등학교,25,25,0,25,25,0,0,0
교육기관,교육부,다일유치원,교육부 경기도교육청 경기도화성오산교육지원청 다일유치원,9,0,9,0,0,0,0,0
교육기관,교육부,대양초등학교,교육부 경기도교육청 경기도화성오산교육지원청 대양초등학교,27,27,0,27,27,0,0,0
교육기관,교육부,대호중학교,교육부 경기도교육청 경기도화성오산교육지원청 대호중학교,12,12,0,12,12,0,0,0
교육기관,교육부,대호초등학교,교육부 경기도교육청 경기도화성오산교육지원청 대호초등학교,16,16,0,16,0,16,0,0
교육기관,교육부,도이초등학교,교육부 경기도교육청 경기도화성오산교육지원청 도이초등학교,20,20,0,20,2,18,0,0
교육기관,교육부,동산숲유치원,교육부 경기도교육청 경기도화성오산교육지원청 동산숲유치원,16,16,0,16,2,12,1,1
교육기관,교육부,동양초등학교,교육부 경기도교육청 경기도화성오산교육지원청 동양초등학교,64,64,0,64,63,1,0,0
교육기관,교육부,동탄고등학교,교육부 경기도교육청 경기도화성오산교육지원청 동탄고등학교,30,30,0,30,10,20,0,0
교육기관,교육부,동탄국제고등학교,교육부 경기도교육청 경기도화성오산교육지원청 동탄국제고등학교,91,91,0,91,87,4,0,0
교육기관,교육부,동탄국제유치원,교육부 경기도교육청 경기도화성오산교육지원청 동탄국제유치원,56,56,0,56,56,0,0,0
교육기관,교육부,동탄꿈의유치원,교육부 경기도교육청 경기도화성오산교육지원청 동탄꿈의유치원,39,39,0,39,5,34,0,0
교육기관,교육부,동탄목동중학교,교육부 경기도교육청 경기도화성오산교육지원청 동탄목동중학교,34,34,0,34,4,30,0,0
교육기관,교육부,동탄목동초등학교,교육부 경기도교육청 경기도화성오산교육지원청 동탄목동초등학교,23,23,0,23,0,23,0,0
교육기관,교육부,동탄중앙초등학교,교육부 경기도교육청 경기도화성오산교육지원청 동탄중앙초등학교,32,32,0,32,32,0,0,0
교육기관,교육부,동탄중학교,교육부 경기도교육청 경기도화성오산교육지원청 동탄중학교,44,44,0,44,44,0,0,0
교육기관,교육부,동탄창의나라유치원,교육부 경기도교육청 경기도화성오산교육지원청 동탄창의나라유치원,32,32,0,32,1,31,0,0
교육기관,교육부,동탄초등학교,교육부 경기도교육청 경기도화성오산교육지원청 동탄초등학교,25,25,0,25,14,11,0,0
교육기관,교육부,동탄호수유치원,교육부 경기도교육청 경기도화성오산교육지원청 동탄호수유치원,8,8,0,8,0,8,0,0
교육기관,교육부,동학중학교,교육부 경기도교육청 경기도화성오산교육지원청 동학중학교,28,28,0,28,6,22,0,0
교육기관,교육부,동학초등학교,교육부 경기도교육청 경기도화성오산교육지원청 동학초등학교,11,11,0,11,8,3,0,0
교육기관,교육부,동화초등학교,교육부 경기도교육청 경기도화성오산교육지원청 동화초등학교,21,21,0,21,21,0,0,0
교육기관,교육부,두레자연중학교,교육부 경기도교육청 경기도화성오산교육지원청 두레자연중학교,15,15,0,15,15,0,0,0
교육기관,교육부,라온유치원,교육부 경기도교육청 경기도화성오산교육지원청 라온유치원,35,35,0,35,0,35,0,0
교육기관,교육부,마산초등학교,교육부 경기도교육청 경기도화성오산교육지원청 마산초등학교,8,8,0,8,4,4,0,0
교육기관,교육부,매홀중학교,교육부 경기도교육청 경기도화성오산교육지원청 매홀중학교,43,43,0,43,10,33,0,0
교육기관,교육부,무봉유치원,교육부 경기도교육청 경기도화성오산교육지원청 무봉유치원,12,12,0,12,8,4,0,0
교육기관,교육부,문시중학교,교육부 경기도교육청 경기도화성오산교육지원청 문시중학교,45,45,0,45,45,0,0,0
교육기관,교육부,문시초등학교,교육부 경기도교육청 경기도화성오산교육지원청 문시초등학교,19,19,0,19,14,5,0,0
교육기관,교육부,민들레유치원,교육부 경기도교육청 경기도화성오산교육지원청 민들레유치원,18,3,15,3,0,3,0,0
교육기관,교육부,바다유치원,교육부 경기도교육청 경기도화성오산교육지원청 바다유치원,38,38,0,38,30,6,1,1
교육기관,교육부,반디유치원,교육부 경기도교육청 경기도화성오산교육지원청 반디유치원,29,29,0,29,0,29,0,0
교육기관,교육부,반석초등학교,교육부 경기도교육청 경기도화성오산교육지원청 반석초등학교,25,25,0,25,22,2,1,0
교육기관,교육부,반송고등학교,교육부 경기도교육청 경기도화성오산교육지원청 반송고등학교,32,30,2,30,2,26,1,1
교육기관,교육부,반송중학교,교육부 경기도교육청 경기도화성오산교육지원청 반송중학교,52,52,0,52,52,0,0,0
교육기관,교육부,반송초등학교,교육부 경기도교육청 경기도화성오산교육지원청 반송초등학교,18,18,0,18,18,0,0,0
교육기관,교육부,발안바이오과학고등학교,교육부 경기도교육청 경기도화성오산교육지원청 발안바이오과학고등학교,37,15,22,15,0,15,0,0
교육기관,교육부,발안중학교,교육부 경기도교육청 경기도화성오산교육지원청 발안중학교,16,16,0,16,8,8,0,0
교육기관,교육부,발안초등학교,교육부 경기도교육청 경기도화성오산교육지원청 발안초등학교,16,16,0,16,8,8,0,0
교육기관,교육부,방교중학교,교육부 경기도교육청 경기도화성오산교육지원청 방교중학교,53,53,0,53,1,50,1,1
교육기관,교육부,방교초등학교,교육부 경기도교육청 경기도화성오산교육지원청 방교초등학교,40,40,0,40,0,40,0,0
교육기관,교육부,배양초등학교,교육부 경기도교육청 경기도화성오산교육지원청 배양초등학교,26,26,0,26,26,0,0,0
교육기관,교육부,병점고등학교,교육부 경기도교육청 경기도화성오산교육지원청 병점고등학교,58,58,0,58,15,43,0,0
교육기관,교육부,병점중학교,교육부 경기도교육청 경기도화성오산교육지원청 병점중학교,45,45,0,45,25,15,2,3
교육기관,교육부,병점초등학교,교육부 경기도교육청 경기도화성오산교육지원청 병점초등학교,16,5,11,5,5,0,0,0
교육기관,교육부,봉담고등학교,교육부 경기도교육청 경기도화성오산교육지원청 봉담고등학교,24,24,0,24,18,6,0,0
교육기관,교육부,봉담중학교,교육부 경기도교육청 경기도화성오산교육지원청 봉담중학교,31,29,2,29,7,22,0,0
교육기관,교육부,봉담초등학교,교육부 경기도교육청 경기도화성오산교육지원청 봉담초등학교,28,28,0,28,8,20,0,0
교육기관,교육부,비봉고등학교,교육부 경기도교육청 경기도화성오산교육지원청 비봉고등학교,71,71,0,71,23,48,0,0
교육기관,교육부,비봉중학교,교육부 경기도교육청 경기도화성오산교육지원청 비봉중학교,13,13,0,13,13,0,0,0
교육기관,교육부,비봉초등학교,교육부 경기도교육청 경기도화성오산교육지원청 비봉초등학교,13,13,0,13,0,13,0,0
교육기관,교육부,빛여울유치원,교육부 경기도교육청 경기도화성오산교육지원청 빛여울유치원,20,20,0,20,0,20,0,0
교육기관,교육부,뿌리유치원,교육부 경기도교육청 경기도화성오산교육지원청 뿌리유치원,16,4,12,4,1,1,1,1
교육기관,교육부,사창초등학교,교육부 경기도교육청 경기도화성오산교육지원청 사창초등학교,9,9,0,9,9,0,0,0
교육기관,교육부,삼괴고등학교,교육부 경기도교육청 경기도화성오산교육지원청 삼괴고등학교,60,19,41,19,8,11,0,0
교육기관,교육부,삼괴중학교,교육부 경기도교육청 경기도화성오산교육지원청 삼괴중학교,26,24,2,24,2,22,0,0
교육기관,교육부,삼미초등학교,교육부 경기도교육청 경기도화성오산교육지원청 삼미초등학교,16,16,0,16,8,8,0,0
교육기관,교육부,상봉초등학교,교육부 경기도교육청 경기도화성오산교육지원청 상봉초등학교,16,4,12,4,4,0,0,0
교육기관,교육부,상신초등학교,교육부 경기도교육청 경기도화성오산교육지원청 상신초등학교,35,35,0,35,35,0,0,0
교육기관,교육부,새봄유치원,교육부 경기도교육청 경기도화성오산교육지원청 새봄유치원,16,15,1,15,14,1,0,0
교육기관,교육부,새솔고등학교,교육부 경기도교육청 경기도화성오산교육지원청 새솔고등학교,59,56,3,56,0,56,0,0
교육기관,교육부,새솔유치원,교육부 경기도교육청 경기도화성오산교육지원청 새솔유치원,16,8,8,8,2,6,0,0
교육기관,교육부,새솔초등학교,교육부 경기도교육청 경기도화성오산교육지원청 새솔초등학교,16,16,0,16,15,1,0,0
교육기관,교육부,서경초등학교,교육부 경기도교육청 경기도화성오산교육지원청 서경초등학교,25,25,0,25,25,0,0,0
교육기관,교육부,서신중학교,교육부 경기도교육청 경기도화성오산교육지원청 서신중학교,13,13,0,13,0,13,0,0
교육기관,교육부,서연고등학교,교육부 경기도교육청 경기도화성오산교육지원청 서연고등학교,64,64,0,64,61,3,0,0
교육기관,교육부,서연유치원,교육부 경기도교육청 경기도화성오산교육지원청 서연유치원,26,9,17,9,9,0,0,0
교육기관,교육부,서연중학교,교육부 경기도교육청 경기도화성오산교육지원청 서연중학교,58,58,0,58,58,0,0,0
교육기관,교육부,서연초등학교,교육부 경기도교육청 경기도화성오산교육지원청 서연초등학교,26,26,0,26,2,19,3,2
교육기관,교육부,석우중학교,교육부 경기도교육청 경기도화성오산교육지원청 석우중학교,38,38,0,38,26,12,0,0
교육기관,교육부,석우초등학교,교육부 경기도교육청 경기도화성오산교육지원청 석우초등학교,10,10,0,10,6,4,0,0
교육기관,교육부,석천초등학교,교육부 경기도교육청 경기도화성오산교육지원청 석천초등학교,9,9,0,9,9,0,0,0
교육기관,교육부,성산초등학교,교육부 경기도교육청 경기도화성오산교육지원청 성산초등학교,20,20,0,20,20,0,0,0
교육기관,교육부,성심학교,교육부 경기도교육청 경기도화성오산교육지원청 성심학교,29,28,1,28,0,28,0,0
교육기관,교육부,성호고등학교,교육부 경기도교육청 경기도화성오산교육지원청 성호고등학교,41,41,0,41,36,5,0,0
교육기관,교육부,성호중학교,교육부 경기도교육청 경기도화성오산교육지원청 성호중학교,34,34,0,34,24,10,0,0
교육기관,교육부,세교고등학교,교육부 경기도교육청 경기도화성오산교육지원청 세교고등학교,58,58,0,58,57,1,0,0
교육기관,교육부,세교유치원,교육부 경기도교육청 경기도화성오산교육지원청 세교유치원,11,11,0,11,0,11,0,0
교육기관,교육부,세마고등학교,교육부 경기도교육청 경기도화성오산교육지원청 세마고등학교,48,48,0,48,0,48,0,0
교육기관,교육부,세마중학교,교육부 경기도교육청 경기도화성오산교육지원청 세마중학교,54,54,0,54,27,27,0,0
교육기관,교육부,세마초등학교,교육부 경기도교육청 경기도화성오산교육지원청 세마초등학교,16,6,10,6,1,4,1,0
교육기관,교육부,세미초등학교,교육부 경기도교육청 경기도화성오산교육지원청 세미초등학교,20,20,0,20,0,20,0,0
교육기관,교육부,세정초등학교,교육부 경기도교육청 경기도화성오산교육지원청 세정초등학교,18,18,0,18,11,7,0,0
교육기관,교육부,솔빛유치원,교육부 경기도교육청 경기도화성오산교육지원청 솔빛유치원,32,32,0,32,16,16,0,0
교육기관,교육부,솔빛중학교,교육부 경기도교육청 경기도화성오산교육지원청 솔빛중학교,31,31,0,31,22,9,0,0
교육기관,교육부,송라초등학교,교육부 경기도교육청 경기도화성오산교육지원청 송라초등학교,16,16,0,16,16,0,0,0
교육기관,교육부,송린초등학교,교육부 경기도교육청 경기도화성오산교육지원청 송린초등학교,28,28,0,28,16,10,2,0
교육기관,교육부,송산고등학교,교육부 경기도교육청 경기도화성오산교육지원청 송산고등학교,46,46,0,46,0,46,0,0
교육기관,교육부,송산중학교,교육부 경기도교육청 경기도화성오산교육지원청 송산중학교,30,30,0,30,15,15,0,0
교육기관,교육부,송산초등학교,교육부 경기도교육청 경기도화성오산교육지원청 송산초등학교,15,15,0,15,0,15,0,0
교육기관,교육부,송화초등학교,교육부 경기도교육청 경기도화성오산교육지원청 송화초등학교,25,25,0,25,0,25,0,0
교육기관,교육부,수기초등학교,교육부 경기도교육청 경기도화성오산교육지원청 수기초등학교,24,24,0,24,14,10,0,0
교육기관,교육부,수노을유치원,교육부 경기도교육청 경기도화성오산교육지원청 수노을유치원,21,21,0,21,21,0,0,0
교육기관,교육부,수영초등학교,교육부 경기도교육청 경기도화성오산교육지원청 수영초등학교,9,9,0,9,9,0,0,0
교육기관,교육부,수청초등학교,교육부 경기도교육청 경기도화성오산교육지원청 수청초등학교,22,22,0,22,12,10,0,0
교육기관,교육부,수현유치원,교육부 경기도교육청 경기도화성오산교육지원청 수현유치원,26,26,0,26,16,10,0,0
교육기관,교육부,수현중학교,교육부 경기도교육청 경기도화성오산교육지원청 수현중학교,62,62,0,62,1,60,1,0
교육기관,교육부,수현초등학교,교육부 경기도교육청 경기도화성오산교육지원청 수현초등학교,23,23,0,23,17,6,0,0
교육기관,교육부,숲속다원유치원,교육부 경기도교육청 경기도화성오산교육지원청 숲속다원유치원,39,37,2,37,29,2,3,3
교육기관,교육부,숲속초등학교,교육부 경기도교육청 경기도화성오산교육지원청 숲속초등학교,16,16,0,16,16,0,0,0
교육기관,교육부,신남초등학교,교육부 경기도교육청 경기도화성오산교육지원청 신남초등학교,26,26,0,26,0,26,0,0
교육기관,교육부,신동탄재크와콩나무유치원,교육부 경기도교육청 경기도화성오산교육지원청 신동탄재크와콩나무유치원,32,32,0,32,32,0,0,0
교육기관,교육부,신백중학교,교육부 경기도교육청 경기도화성오산교육지원청 신백중학교,31,31,0,31,11,20,0,0
교육기관,교육부,아이가행복한유치원,교육부 경기도교육청 경기도화성오산교육지원청 아이가행복한유치원,24,0,24,0,0,0,0,0
교육기관,교육부,아이들세상유치원,교육부 경기도교육청 경기도화성오산교육지원청 아이들세상유치원,21,21,0,21,0,21,0,0
교육기관,교육부,아이숲유치원,교육부 경기도교육청 경기도화성오산교육지원청 아이숲유치원,16,16,0,16,13,1,2,0
교육기관,교육부,아인초등학교,교육부 경기도교육청 경기도화성오산교육지원청 아인초등학교,32,14,18,14,14,0,0,0
교육기관,교육부,안녕초등학교,교육부 경기도교육청 경기도화성오산교육지원청 안녕초등학교,18,18,0,18,18,0,0,0
교육기관,교육부,안화고등학교,교육부 경기도교육청 경기도화성오산교육지원청 안화고등학교,12,12,0,12,0,12,0,0
교육기관,교육부,안화중학교,교육부 경기도교육청 경기도화성오산교육지원청 안화중학교,48,48,0,48,32,16,0,0
교육기관,교육부,안화초등학교,교육부 경기도교육청 경기도화성오산교육지원청 안화초등학교,24,24,0,24,0,24,0,0
교육기관,교육부,양감중학교,교육부 경기도교육청 경기도화성오산교육지원청 양감중학교,8,8,0,8,7,1,0,0
교육기관,교육부,양감초등학교,교육부 경기도교육청 경기도화성오산교육지원청 양감초등학교,12,12,0,12,12,0,0,0
교육기관,교육부,양산초등학교,교육부 경기도교육청 경기도화성오산교육지원청 양산초등학교,14,14,0,14,12,2,0,0
교육기관,교육부,여울초등학교,교육부 경기도교육청 경기도화성오산교육지원청 여울초등학교,20,16,4,16,6,10,0,0
교육기관,교육부,영천유치원,교육부 경기도교육청 경기도화성오산교육지원청 영천유치원,16,16,0,16,4,12,0,0
교육기관,교육부,영천초등학교,교육부 경기도교육청 경기도화성오산교육지원청 영천초등학교,27,27,0,27,20,4,3,0
교육기관,교육부,예당고등학교,교육부 경기도교육청 경기도화성오산교육지원청 예당고등학교,32,32,0,32,9,23,0,0
교육기관,교육부,예당중학교,교육부 경기도교육청 경기도화성오산교육지원청 예당중학교,20,20,0,20,0,20,0,0
교육기관,교육부,예당초등학교,교육부 경기도교육청 경기도화성오산교육지원청 예당초등학교,12,12,0,12,0,12,0,0
교육기관,교육부,예솔초등학교,교육부 경기도교육청 경기도화성오산교육지원청 예솔초등학교,29,29,0,29,17,12,0,0
교육기관,교육부,예원유치원,교육부 경기도교육청 경기도화성오산교육지원청 예원유치원,13,13,0,13,0,13,0,0
교육기관,교육부,예원초등학교,교육부 경기도교육청 경기도화성오산교육지원청 예원초등학교,14,14,0,14,13,1,0,0
교육기관,교육부,오산고현초등학교,교육부 경기도교육청 경기도화성오산교육지원청 오산고현초등학교,22,22,0,22,22,0,0,0
교육기관,교육부,오산다온유치원,교육부 경기도교육청 경기도화성오산교육지원청 오산다온유치원,17,16,1,16,1,15,0,0
교육기관,교육부,오산대원초등학교,교육부 경기도교육청 경기도화성오산교육지원청 오산대원초등학교,14,14,0,14,14,0,0,0
교육기관,교육부,오산숲유치원,교육부 경기도교육청 경기도화성오산교육지원청 오산숲유치원,16,16,0,16,0,16,0,0
교육기관,교육부,오산원당초등학교,교육부 경기도교육청 경기도화성오산교육지원청 오산원당초등학교,22,22,0,22,0,22,0,0
교육기관,교육부,오산원일중학교,교육부 경기도교육청 경기도화성오산교육지원청 오산원일중학교,21,21,0,21,8,13,0,0
교육기관,교육부,오산원일초등학교,교육부 경기도교육청 경기도화성오산교육지원청 오산원일초등학교,17,17,0,17,17,0,0,0
교육기관,교육부,오산정보고등학교,교육부 경기도교육청 경기도화성오산교육지원청 오산정보고등학교,27,27,0,27,17,8,2,0
교육기관,교육부,오산초등학교,교육부 경기도교육청 경기도화성오산교육지원청 오산초등학교,16,16,0,16,16,0,0,0
교육기관,교육부,와우중학교,교육부 경기도교육청 경기도화성오산교육지원청 와우중학교,41,41,0,41,0,41,0,0
교육기관,교육부,와우초등학교,교육부 경기도교육청 경기도화성오산교육지원청 와우초등학교,9,9,0,9,3,4,1,1
교육기관,교육부,왕배초등학교,교육부 경기도교육청 경기도화성오산교육지원청 왕배초등학교,27,10,17,10,5,5,0,0
교육기관,교육부,우정초등학교,교육부 경기도교육청 경기도화성오산교육지원청 우정초등학교,14,14,0,14,0,14,0,0
교육기관,교육부,운산초등학교,교육부 경기도교육청 경기도화성오산교육지원청 운산초등학교,9,9,0,9,4,3,1,1
교육기관,교육부,운암고등학교,교육부 경기도교육청 경기도화성오산교육지원청 운암고등학교,35,35,0,35,0,35,0,0
교육기관,교육부,운암중학교,교육부 경기도교육청 경기도화성오산교육지원청 운암중학교,12,12,0,12,11,1,0,0
교육기관,교육부,운암초등학교,교육부 경기도교육청 경기도화성오산교육지원청 운암초등학교,8,8,0,8,8,0,0,0
교육기관,교육부,운천고등학교,교육부 경기도교육청 경기도화성오산교육지원청 운천고등학교,35,35,0,35,0,35,0,0
교육기관,교육부,운천초등학교,교육부 경기도교육청 경기도화성오산교육지원청 운천초등학교,14,13,1,13,7,6,0,0
교육기관,교육부,원동초등학교,교육부 경기도교육청 경기도화성오산교육지원청 원동초등학교,8,8,0,8,3,5,0,0
교육기관,교육부,윤정유치원,교육부 경기도교육청 경기도화성오산교육지원청 윤정유치원,16,5,11,5,2,3,0,0
교육기관,교육부,율목초등학교,교육부 경기도교육청 경기도화성오산교육지원청 율목초등학교,25,25,0,25,0,25,0,0
교육기관,교육부,이림유치원,교육부 경기도교육청 경기도화성오산교육지원청 이림유치원,6,6,0,6,3,2,1,0
교육기관,교육부,이산고등학교,교육부 경기도교육청 경기도화성오산교육지원청 이산고등학교,58,58,0,58,0,58,0,0
교육기관,교육부,이산중학교,교육부 경기도교육청 경기도화성오산교육지원청 이산중학교,21,21,0,21,0,21,0,0
교육기관,교육부,이솔초등학교,교육부 경기도교육청 경기도화성오산교육지원청 이솔초등학교,36,36,0,36,20,16,0,0
교육기관,교육부,이지유치원,교육부 경기도교육청 경기도화성오산교육지원청 이지유치원,56,56,0,56,0,56,0,0
교육기관,교육부,장안여자중학교,교육부 경기도교육청 경기도화성오산교육지원청 장안여자중학교,19,19,0,19,6,13,0,0
교육기관,교육부,정남중학교,교육부 경기도교육청 경기도화성오산교육지원청 정남중학교,17,17,0,17,17,0,0,0
교육기관,교육부,정남초등학교,교육부 경기도교육청 경기도화성오산교육지원청 정남초등학교,19,19,0,19,9,10,0,0
교육기관,교육부,정림초등학교,교육부 경기도교육청 경기도화성오산교육지원청 정림초등학교,20,20,0,20,10,10,0,0
교육기관,교육부,정현고등학교,교육부 경기도교육청 경기도화성오산교육지원청 정현고등학교,42,41,1,41,16,25,0,0
교육기관,교육부,정현초등학교,교육부 경기도교육청 경기도화성오산교육지원청 정현초등학교,27,27,0,27,27,0,0,0
교육기관,교육부,제암초등학교,교육부 경기도교육청 경기도화성오산교육지원청 제암초등학교,13,13,0,13,4,9,0,0
교육기관,교육부,제이라온유치원,교육부 경기도교육청 경기도화성오산교육지원청 제이라온유치원,32,25,7,25,14,11,0,0
교육기관,교육부,진안중학교,교육부 경기도교육청 경기도화성오산교육지원청 진안중학교,64,64,0,64,40,12,7,5
교육기관,교육부,진안초등학교,교육부 경기도교육청 경기도화성오산교육지원청 진안초등학교,18,18,0,18,13,5,0,0
교육기관,교육부,창의고등학교,교육부 경기도교육청 경기도화성오산교육지원청 창의고등학교,43,43,0,43,0,43,0,0
교육기관,교육부,창의나라유치원,교육부 경기도교육청 경기도화성오산교육지원청 창의나라유치원,22,22,0,22,22,0,0,0
교육기관,교육부,청계중학교,교육부 경기도교육청 경기도화성오산교육지원청 청계중학교,21,21,0,21,2,19,0,0
교육기관,교육부,청룡초등학교,교육부 경기도교육청 경기도화성오산교육지원청 청룡초등학교,20,20,0,20,0,20,0,0
교육기관,교육부,청림중학교,교육부 경기도교육청 경기도화성오산교육지원청 청림중학교,47,47,0,47,47,0,0,0
교육기관,교육부,청림초등학교,교육부 경기도교육청 경기도화성오산교육지원청 청림초등학교,25,25,0,25,14,11,0,0
교육기관,교육부,청목초등학교,교육부 경기도교육청 경기도화성오산교육지원청 청목초등학교,18,18,0,18,0,18,0,0
교육기관,교육부,청원초등학교,교육부 경기도교육청 경기도화성오산교육지원청 청원초등학교,8,8,0,8,0,8,0,0
교육기관,교육부,치동중학교,교육부 경기도교육청 경기도화성오산교육지원청 치동중학교,53,53,0,53,48,5,0,0
교육기관,교육부,치동초등학교,교육부 경기도교육청 경기도화성오산교육지원청 치동초등학교,27,27,0,27,27,0,0,0
교육기관,교육부,태안초등학교,교육부 경기도교육청 경기도화성오산교육지원청 태안초등학교,15,15,0,15,0,15,0,0
교육기관,교육부,팔탄초등학교,교육부 경기도교육청 경기도화성오산교육지원청 팔탄초등학교,8,8,0,8,0,8,0,0
교육기관,교육부,푸른중학교,교육부 경기도교육청 경기도화성오산교육지원청 푸른중학교,35,35,0,35,9,26,0,0
교육기관,교육부,푸른초등학교,교육부 경기도교육청 경기도화성오산교육지원청 푸른초등학교,28,28,0,28,0,28,0,0
교육기관,교육부,필봉초등학교,교육부 경기도교육청 경기도화성오산교육지원청 필봉초등학교,39,39,0,39,0,39,0,0
교육기관,교육부,하길고등학교,교육부 경기도교육청 경기도화성오산교육지원청 하길고등학교,55,55,0,55,0,55,0,0
교육기관,교육부,하길중학교,교육부 경기도교육청 경기도화성오산교육지원청 하길중학교,24,24,0,24,0,24,0,0
교육기관,교육부,하길초등학교,교육부 경기도교육청 경기도화성오산교육지원청 하길초등학교,14,14,0,14,7,7,0,0
교육기관,교육부,하늘꿈의유치원,교육부 경기도교육청 경기도화성오산교육지원청 하늘꿈의유치원,64,4,60,4,1,1,1,1
교육기관,교육부,하늘빛유치원,교육부 경기도교육청 경기도화성오산교육지원청 하늘빛유치원,5,5,0,5,5,0,0,0
교육기관,교육부,학동초등학교,교육부 경기도교육청 경기도화성오산교육지원청 학동초등학교,10,10,0,10,5,5,0,0
교육기관,교육부,한마음초등학교,교육부 경기도교육청 경기도화성오산교육지원청 한마음초등학교,16,16,0,16,16,0,0,0
교육기관,교육부,한백중학교,교육부 경기도교육청 경기도화성오산교육지원청 한백중학교,47,47,0,47,16,31,0,0
교육기관,교육부,한빛유치원,교육부 경기도교육청 경기도화성오산교육지원청 한빛유치원,32,32,0,32,0,32,0,0
교육기관,교육부,한울초등학교,교육부 경기도교육청 경기도화성오산교육지원청 한울초등학교,23,23,0,23,23,0,0,0
교육기관,교육부,한율초등학교,교육부 경기도교육청 경기도화성오산교육지원청 한율초등학교,31,31,0,31,16,15,0,0
교육기관,교육부,해운초등학교,교육부 경기도교육청 경기도화성오산교육지원청 해운초등학교,17,13,4,13,13,0,0,0
교육기관,교육부,해원학교,교육부 경기도교육청 경기도화성오산교육지원청 해원학교,32,32,0,32,18,14,0,0
교육기관,교육부,행정초등학교,교육부 경기도교육청 경기도화성오산교육지원청 행정초등학교,22,22,0,22,22,0,0,0
교육기관,교육부,향남고등학교,교육부 경기도교육청 경기도화성오산교육지원청 향남고등학교,32,32,0,32,16,14,0,2
교육기관,교육부,향남유치원,교육부 경기도교육청 경기도화성오산교육지원청 향남유치원,16,16,0,16,15,1,0,0
교육기관,교육부,향남중학교,교육부 경기도교육청 경기도화성오산교육지원청 향남중학교,31,30,1,30,30,0,0,0
교육기관,교육부,향남초등학교,교육부 경기도교육청 경기도화성오산교육지원청 향남초등학교,20,20,0,20,0,20,0,0
교육기관,교육부,향일고등학교,교육부 경기도교육청 경기도화성오산교육지원청 향일고등학교,28,26,2,26,19,7,0,0
교육기관,교육부,호연초등학교,교육부 경기도교육청 경기도화성오산교육지원청 호연초등학교,26,23,3,23,0,23,0,0
교육기관,교육부,홍익디자인고등학교,교육부 경기도교육청 경기도화성오산교육지원청 홍익디자인고등학교,19,19,0,19,1,18,0,0
교육기관,교육부,화남초등학교,교육부 경기도교육청 경기도화성오산교육지원청 화남초등학교,25,25,0,25,13,12,0,0
교육기관,교육부,화도중학교,교육부 경기도교육청 경기도화성오산교육지원청 화도중학교,20,20,0,20,10,10,0,0
교육기관,교육부,화성고등학교,교육부 경기도교육청 경기도화성오산교육지원청 화성고등학교,157,157,0,157,0,157,0,0
교육기관,교육부,화성금곡초등학교,교육부 경기도교육청 경기도화성오산교육지원청 화성금곡초등학교,13,13,0,13,13,0,0,0
교육기관,교육부,화성나래학교,교육부 경기도교육청 경기도화성오산교육지원청 화성나래학교,41,41,0,41,0,41,0,0
교육기관,교육부,화성동화중학교,교육부 경기도교육청 경기도화성오산교육지원청 화성동화중학교,40,40,0,40,0,40,0,0
교육기관,교육부,화성매송초등학교,교육부 경기도교육청 경기도화성오산교육지원청 화성매송초등학교,14,14,0,14,14,0,0,0
교육기관,교육부,화성반월고등학교,교육부 경기도교육청 경기도화성오산교육지원청 화성반월고등학교,14,14,0,14,14,0,0,0
교육기관,교육부,화성반월중학교,교육부 경기도교육청 경기도화성오산교육지원청 화성반월중학교,16,15,1,15,0,15,0,0
교육기관,교육부,화성반월초등학교,교육부 경기도교육청 경기도화성오산교육지원청 화성반월초등학교,16,16,0,16,16,0,0,0
교육기관,교육부,화성벌말초등학교,교육부 경기도교육청 경기도화성오산교육지원청 화성벌말초등학교,10,10,0,10,10,0,0,0
교육기관,교육부,화성세정중학교,교육부 경기도교육청 경기도화성오산교육지원청 화성세정중학교,60,60,0,60,0,60,0,0
교육기관,교육부,화성신동초등학교,교육부 경기도교육청 경기도화성오산교육지원청 화성신동초등학교,48,48,0,48,0,48,0,0
교육기관,교육부,화성장안초등학교,교육부 경기도교육청 경기도화성오산교육지원청 화성장안초등학교,16,16,0,16,0,16,0,0
교육기관,교육부,화성장안초등학교석포분교장,교육부 경기도교육청 경기도화성오산교육지원청 화성장안초등학교석포분교장,6,6,0,6,6,0,0,0
교육기관,교육부,화성청계초등학교,교육부 경기도교육청 경기도화성오산교육지원청 화성청계초등학교,23,23,0,23,20,3,0,0
교육기관,교육부,화성초등학교,교육부 경기도교육청 경기도화성오산교육지원청 화성초등학교,24,24,0,24,0,24,0,0
교육기관,교육부,화성화수초등학교,교육부 경기도교육청 경기도화성오산교육지원청 화성화수초등학교,9,9,0,9,5,4,0,0
교육기관,교육부,화원초등학교,교육부 경기도교육청 경기도화성오산교육지원청 화원초등학교,12,12,0,12,10,2,0,0
교육기관,교육부,활초초등학교,교육부 경기도교육청 경기도화성오산교육지원청 활초초등학교,12,12,0,12,4,8,0,0
교육기관,교육부,효행초등학교,교육부 경기도교육청 경기도화성오산교육지원청 효행초등학교,36,36,0,36,0,36,0,0
교육기관,교육부,경기성남교육도서관,교육부 경기도교육청 경기성남교육도서관,24,24,0,24,6,18,0,0
교육기관,교육부,경기여주가남교육도서관,교육부 경기도교육청 경기여주가남교육도서관,17,17,0,17,4,13,0,0
교육기관,교육부,경기의정부교육도서관,교육부 경기도교육청 경기의정부교육도서관,8,8,0,8,0,8,0,0
교육기관,교육부,경기중앙교육도서관,교육부 경기도교육청 경기중앙교육도서관,8,8,0,8,0,8,0,0
교육기관,교육부,경기평생교육학습관,교육부 경기도교육청 경기평생교육학습관,59,58,1,58,2,56,0,0
교육기관,교육부,경기평택교육도서관,교육부 경기도교육청 경기평택교육도서관,4,4,0,4,0,4,0,0
교육기관,교육부,경기포천교육도서관,교육부 경기도교육청 경기포천교육도서관,5,5,0,5,2,1,1,1
교육기관,교육부,경기화성교육도서관,교육부 경기도교육청 경기화성교육도서관,7,7,0,7,3,4,0,0
교육기관,교육부,분당아람고등학교,교육부 경기도교육청 분당아람고등학교,22,22,0,22,0,22,0,0
교육기관,교육부,소래고등학교,교육부 경기도교육청 소래고등학교,49,49,0,49,20,29,0,0
교육기관,교육부,강원도교육청,교육부 강원도교육청,35,28,7,28,0,28,0,0
교육기관,교육부,강릉교육문화관,교육부 강원도교육청 강릉교육문화관,22,22,0,22,22,0,0,0
교육기관,교육부,강원교육과학정보원,교육부 강원도교육청 강원교육과학정보원,66,42,24,42,0,42,0,0
교육기관,교육부,동해분원,교육부 강원도교육청 강원교육과학정보원 동해분원,28,28,0,28,0,28,0,0
교육기관,교육부,춘천분원,교육부 강원도교육청 강원교육과학정보원 춘천분원,20,20,0,20,5,15,0,0
교육기관,교육부,강원국제교육원,교육부 강원도교육청 강원국제교육원,40,40,0,40,0,40,0,0
교육기관,교육부,강원도강릉교육지원청,교육부 강원도교육청 강원도강릉교육지원청,11,9,2,9,0,9,0,0
교육기관,교육부,강동초등학교,교육부 강원도교육청 강원도강릉교육지원청 강동초등학교,10,10,0,10,10,0,0,0
교육기관,교육부,강릉명륜고등학교,교육부 강원도교육청 강원도강릉교육지원청 강릉명륜고등학교,34,34,0,34,25,9,0,0
교육기관,교육부,강릉문성고등학교,교육부 강원도교육청 강원도강릉교육지원청 강릉문성고등학교,32,32,0,32,10,22,0,0
교육기관,교육부,강릉여자고등학교,교육부 강원도교육청 강원도강릉교육지원청 강릉여자고등학교,33,33,0,33,14,19,0,0
교육기관,교육부,강릉오성학교,교육부 강원도교육청 강원도강릉교육지원청 강릉오성학교,20,20,0,20,7,13,0,0
교육기관,교육부,강릉유치원,교육부 강원도교육청 강원도강릉교육지원청 강릉유치원,8,8,0,8,0,8,0,0
교육기관,교육부,강릉정보공업고등학교,교육부 강원도교육청 강원도강릉교육지원청 강릉정보공업고등학교,52,50,2,50,0,50,0,0
교육기관,교육부,강릉제일고등학교,교육부 강원도교육청 강원도강릉교육지원청 강릉제일고등학교,71,71,0,71,71,0,0,0
교육기관,교육부,강릉중앙고등학교,교육부 강원도교육청 강원도강릉교육지원청 강릉중앙고등학교,69,69,0,69,0,69,0,0
교육기관,교육부,강릉중학교,교육부 강원도교육청 강원도강릉교육지원청 강릉중학교,45,45,0,45,0,45,0,0
교육기관,교육부,강릉초등학교,교육부 강원도교육청 강원도강릉교육지원청 강릉초등학교,23,23,0,23,23,0,0,0
교육기관,교육부,강릉해람중학교,교육부 강원도교육청 강원도강릉교육지원청 강릉해람중학교,38,38,0,38,2,36,0,0
교육기관,교육부,강원예술고등학교,교육부 강원도교육청 강원도강릉교육지원청 강원예술고등학교,34,34,0,34,0,34,0,0
교육기관,교육부,경포고등학교,교육부 강원도교육청 강원도강릉교육지원청 경포고등학교,50,50,0,50,0,50,0,0
교육기관,교육부,경포중학교,교육부 강원도교육청 강원도강릉교육지원청 경포중학교,52,50,2,50,50,0,0,0
교육기관,교육부,경포초등학교,교육부 강원도교육청 강원도강릉교육지원청 경포초등학교,18,18,0,18,18,0,0,0
교육기관,교육부,구정초등학교,교육부 강원도교육청 강원도강릉교육지원청 구정초등학교,11,11,0,11,11,0,0,0
교육기관,교육부,남강초등학교,교육부 강원도교육청 강원도강릉교육지원청 남강초등학교,20,20,0,20,0,20,0,0
교육기관,교육부,남산초등학교,교육부 강원도교육청 강원도강릉교육지원청 남산초등학교,16,16,0,16,15,1,0,0
교육기관,교육부,남선초등학교,교육부 강원도교육청 강원도강릉교육지원청 남선초등학교,10,10,0,10,8,2,0,0
교육기관,교육부,남호초등학교,교육부 강원도교육청 강원도강릉교육지원청 남호초등학교,25,25,0,25,25,0,0,0
교육기관,교육부,늘해랑유치원,교육부 강원도교육청 강원도강릉교육지원청 늘해랑유치원,25,25,0,25,19,1,4,1
교육기관,교육부,동명중학교,교육부 강원도교육청 강원도강릉교육지원청 동명중학교,25,25,0,25,24,1,0,0
교육기관,교육부,동명초등학교,교육부 강원도교육청 강원도강릉교육지원청 동명초등학교,16,16,0,16,16,0,0,0
교육기관,교육부,동해광희고등학교,교육부 강원도교육청 강원도강릉교육지원청 동해광희고등학교,43,41,2,41,0,41,0,0
교육기관,교육부,동해광희중학교,교육부 강원도교육청 강원도강릉교육지원청 동해광희중학교,16,16,0,16,8,5,2,1
교육기관,교육부,동해랑유치원,교육부 강원도교육청 강원도강릉교육지원청 동해랑유치원,17,17,0,17,10,7,0,0
교육기관,교육부,동해삼육고등학교,교육부 강원도교육청 강원도강릉교육지원청 동해삼육고등학교,54,54,0,54,0,54,0,0
교육기관,교육부,동해삼육중학교,교육부 강원도교육청 강원도강릉교육지원청 동해삼육중학교,17,17,0,17,17,0,0,0
교육기관,교육부,동해삼육초등학교,교육부 강원도교육청 강원도강릉교육지원청 동해삼육초등학교,30,30,0,30,0,30,0,0
교육기관,교육부,동해상업고등학교,교육부 강원도교육청 강원도강릉교육지원청 동해상업고등학교,52,33,19,33,33,0,0,0
교육기관,교육부,동해중앙초등학교,교육부 강원도교육청 강원도강릉교육지원청 동해중앙초등학교,20,20,0,20,19,1,0,0
교육기관,교육부,동해중학교,교육부 강원도교육청 강원도강릉교육지원청 동해중학교,29,29,0,29,20,9,0,0
교육기관,교육부,동해초등학교,교육부 강원도교육청 강원도강릉교육지원청 동해초등학교,18,18,0,18,0,18,0,0
교육기관,교육부,동해해솔학교,교육부 강원도교육청 강원도강릉교육지원청 동해해솔학교,43,43,0,43,0,43,0,0
교육기관,교육부,동호초등학교,교육부 강원도교육청 강원도강릉교육지원청 동호초등학교,15,15,0,15,0,15,0,0
교육기관,교육부,명주초등학교,교육부 강원도교육청 강원도강릉교육지원청 명주초등학교,15,15,0,15,15,0,0,0
교육기관,교육부,모산초등학교,교육부 강원도교육청 강원도강릉교육지원청 모산초등학교,14,14,0,14,7,7,0,0
교육기관,교육부,묵호고등학교,교육부 강원도교육청 강원도강릉교육지원청 묵호고등학교,51,51,0,51,24,27,0,0
교육기관,교육부,묵호초등학교,교육부 강원도교육청 강원도강릉교육지원청 묵호초등학교,20,20,0,20,10,10,0,0
교육기관,교육부,북삼초등학교,교육부 강원도교육청 강원도강릉교육지원청 북삼초등학교,19,19,0,19,19,0,0,0
교육기관,교육부,북평고등학교,교육부 강원도교육청 강원도강릉교육지원청 북평고등학교,78,66,12,66,66,0,0,0
교육기관,교육부,북평여자고등학교,교육부 강원도교육청 강원도강릉교육지원청 북평여자고등학교,32,32,0,32,32,0,0,0
교육기관,교육부,북평중학교,교육부 강원도교육청 강원도강릉교육지원청 북평중학교,53,53,0,53,40,13,0,0
교육기관,교육부,북평초등학교,교육부 강원도교육청 강원도강릉교육지원청 북평초등학교,16,16,0,16,0,16,0,0
교육기관,교육부,사천중학교,교육부 강원도교육청 강원도강릉교육지원청 사천중학교,20,20,0,20,16,4,0,0
교육기관,교육부,사천초등학교,교육부 강원도교육청 강원도강릉교육지원청 사천초등학교,13,13,0,13,7,6,0,0
교육기관,교육부,삼화초등학교,교육부 강원도교육청 강원도강릉교육지원청 삼화초등학교,9,9,0,9,0,9,0,0
교육기관,교육부,성덕초등학교,교육부 강원도교육청 강원도강릉교육지원청 성덕초등학교,16,16,0,16,2,12,1,1
교육기관,교육부,성산초등학교,교육부 강원도교육청 강원도강릉교육지원청 성산초등학교,14,14,0,14,7,7,0,0
교육기관,교육부,솔올중학교,교육부 강원도교육청 강원도강릉교육지원청 솔올중학교,36,36,0,36,0,36,0,0
교육기관,교육부,솔향유치원,교육부 강원도교육청 강원도강릉교육지원청 솔향유치원,16,16,0,16,5,11,0,0
교육기관,교육부,송양초등학교,교육부 강원도교육청 강원도강릉교육지원청 송양초등학교,20,20,0,20,20,0,0,0
교육기관,교육부,송정초등학교,교육부 강원도교육청 강원도강릉교육지원청 송정초등학교,12,12,0,12,12,0,0,0
교육기관,교육부,신영초등학교,교육부 강원도교육청 강원도강릉교육지원청 신영초등학교,16,16,0,16,9,7,0,0
교육기관,교육부,신왕초등학교,교육부 강원도교육청 강원도강릉교육지원청 신왕초등학교,8,8,0,8,2,2,2,2
교육기관,교육부,연곡초등학교,교육부 강원도교육청 강원도강릉교육지원청 연곡초등학교,22,22,0,22,13,9,0,0
교육기관,교육부,영동초등학교,교육부 강원도교육청 강원도강릉교육지원청 영동초등학교,15,15,0,15,15,0,0,0
교육기관,교육부,예람중학교,교육부 강원도교육청 강원도강릉교육지원청 예람중학교,47,47,0,47,29,14,0,4
교육기관,교육부,옥계중학교,교육부 강원도교육청 강원도강릉교육지원청 옥계중학교,9,9,0,9,6,1,1,1
교육기관,교육부,옥계초등학교,교육부 강원도교육청 강원도강릉교육지원청 옥계초등학교,15,15,0,15,15,0,0,0
교육기관,교육부,옥천초등학교,교육부 강원도교육청 강원도강릉교육지원청 옥천초등학교,17,17,0,17,17,0,0,0
교육기관,교육부,왕산중학교,교육부 강원도교육청 강원도강릉교육지원청 왕산중학교,10,10,0,10,9,1,0,0
교육기관,교육부,왕산초등학교,교육부 강원도교육청 강원도강릉교육지원청 왕산초등학교,18,18,0,18,0,18,0,0
교육기관,교육부,운산초등학교,교육부 강원도교육청 강원도강릉교육지원청 운산초등학교,13,13,0,13,13,0,0,0
교육기관,교육부,운양초등학교,교육부 강원도교육청 강원도강릉교육지원청 운양초등학교,11,11,0,11,11,0,0,0
교육기관,교육부,유천초등학교,교육부 강원도교육청 강원도강릉교육지원청 유천초등학교,24,24,0,24,24,0,0,0
교육기관,교육부,율곡중학교,교육부 강원도교육청 강원도강릉교육지원청 율곡중학교,39,0,39,0,0,0,0,0
교육기관,교육부,율곡초등학교,교육부 강원도교육청 강원도강릉교육지원청 율곡초등학교,20,20,0,20,20,0,0,0
교육기관,교육부,임곡초등학교,교육부 강원도교육청 강원도강릉교육지원청 임곡초등학교,13,13,0,13,0,13,0,0
교육기관,교육부,정동초등학교,교육부 강원도교육청 강원도강릉교육지원청 정동초등학교,16,16,0,16,16,0,0,0
교육기관,교육부,주문진고등학교,교육부 강원도교육청 강원도강릉교육지원청 주문진고등학교,18,18,0,18,8,8,0,2
교육기관,교육부,주문진초등학교,교육부 강원도교육청 강원도강릉교육지원청 주문진초등학교,26,26,0,26,22,4,0,0
교육기관,교육부,중앙초등학교,교육부 강원도교육청 강원도강릉교육지원청 중앙초등학교,26,26,0,26,14,12,0,0
교육기관,교육부,창호초등학교,교육부 강원도교육청 강원도강릉교육지원청 창호초등학교,9,9,0,9,9,0,0,0
교육기관,교육부,천곡초등학교,교육부 강원도교육청 강원도강릉교육지원청 천곡초등학교,11,11,0,11,9,2,0,0
교육기관,교육부,청운초등학교,교육부 강원도교육청 강원도강릉교육지원청 청운초등학교,37,37,0,37,37,0,0,0
교육기관,교육부,초당초등학교,교육부 강원도교육청 강원도강릉교육지원청 초당초등학교,22,22,0,22,22,0,0,0
교육기관,교육부,포남초등학교,교육부 강원도교육청 강원도강릉교육지원청 포남초등학교,20,20,0,20,18,2,0,0
교육기관,교육부,하랑중학교,교육부 강원도교육청 강원도강릉교육지원청 하랑중학교,38,38,0,38,38,0,0,0
교육기관,교육부,하슬라유치원,교육부 강원도교육청 강원도강릉교육지원청 하슬라유치원,16,16,0,16,16,0,0,0
교육기관,교육부,하슬라중학교,교육부 강원도교육청 강원도강릉교육지원청 하슬라중학교,42,40,2,40,18,20,1,1
교육기관,교육부,한솔초등학교,교육부 강원도교육청 강원도강릉교육지원청 한솔초등학교,21,21,0,21,11,7,2,1
교육기관,교육부,해오름유치원,교육부 강원도교육청 강원도강릉교육지원청 해오름유치원,12,12,0,12,0,12,0,0
교육기관,교육부,강원도고성교육지원청,교육부 강원도교육청 강원도고성교육지원청,0,0,0,0,0,0,0,0
교육기관,교육부,강원도교육연구원,교육부 강원도교육청 강원도교육연구원,6,6,0,6,0,6,0,0
교육기관,교육부,강원도교육연수원,교육부 강원도교육청 강원도교육연수원,17,17,0,17,13,4,0,0
교육기관,교육부,횡성분원,교육부 강원도교육청 강원도교육연수원 횡성분원,40,40,0,40,19,21,0,0
교육기관,교육부,강원도교직원수련원,교육부 강원도교육청 강원도교직원수련원,42,41,1,41,2,39,0,0
교육기관,교육부,강원도동해교육지원청,교육부 강원도교육청 강원도동해교육지원청,7,5,2,5,5,0,0,0
교육기관,교육부,강원도삼척교육지원청,교육부 강원도교육청 강원도삼척교육지원청,4,4,0,4,0,4,0,0
교육기관,교육부,가곡고등학교,교육부 강원도교육청 강원도삼척교육지원청 가곡고등학교,16,14,2,14,8,4,1,1
교육기관,교육부,가곡중학교,교육부 강원도교육청 강원도삼척교육지원청 가곡중학교,2,2,0,2,1,1,0,0
교육기관,교육부,도계고등학교,교육부 강원도교육청 강원도삼척교육지원청 도계고등학교,44,44,0,44,13,29,1,1
교육기관,교육부,도계전산정보고등학교,교육부 강원도교육청 강원도삼척교육지원청 도계전산정보고등학교,14,14,0,14,11,1,1,1
교육기관,교육부,도계중학교,교육부 강원도교육청 강원도삼척교육지원청 도계중학교,17,17,0,17,16,1,0,0
교육기관,교육부,도계초등학교,교육부 강원도교육청 강원도삼척교육지원청 도계초등학교,14,14,0,14,14,0,0,0
교육기관,교육부,도계한빛유치원,교육부 강원도교육청 강원도삼척교육지원청 도계한빛유치원,6,6,0,6,6,0,0,0
교육기관,교육부,맹방초등학교,교육부 강원도교육청 강원도삼척교육지원청 맹방초등학교,7,7,0,7,7,0,0,0
교육기관,교육부,미동초등학교,교육부 강원도교육청 강원도삼척교육지원청 미동초등학교,12,12,0,12,6,6,0,0
교육기관,교육부,미로중학교,교육부 강원도교육청 강원도삼척교육지원청 미로중학교,12,12,0,12,5,7,0,0
교육기관,교육부,미로초등학교,교육부 강원도교육청 강원도삼척교육지원청 미로초등학교,9,9,0,9,9,0,0,0
교육기관,교육부,삼성초등학교,교육부 강원도교육청 강원도삼척교육지원청 삼성초등학교,10,10,0,10,10,0,0,0
교육기관,교육부,삼일고등학교,교육부 강원도교육청 강원도삼척교육지원청 삼일고등학교,28,28,0,28,14,14,0,0
교육기관,교육부,삼척고등학교,교육부 강원도교육청 강원도삼척교육지원청 삼척고등학교,25,25,0,25,5,20,0,0
교육기관,교육부,삼척남초등학교,교육부 강원도교육청 강원도삼척교육지원청 삼척남초등학교,16,16,0,16,6,10,0,0
교육기관,교육부,삼척누리유치원,교육부 강원도교육청 강원도삼척교육지원청 삼척누리유치원,7,6,1,6,3,3,0,0
교육기관,교육부,삼척마이스터고등학교,교육부 강원도교육청 강원도삼척교육지원청 삼척마이스터고등학교,61,61,0,61,61,0,0,0
교육기관,교육부,삼척여자고등학교,교육부 강원도교육청 강원도삼척교육지원청 삼척여자고등학교,33,33,0,33,20,13,0,0
교육기관,교육부,삼척중앙초등학교,교육부 강원도교육청 강원도삼척교육지원청 삼척중앙초등학교,8,8,0,8,8,0,0,0
교육기관,교육부,삼척중학교,교육부 강원도교육청 강원도삼척교육지원청 삼척중학교,22,22,0,22,11,11,0,0
교육기관,교육부,삼척초등학교,교육부 강원도교육청 강원도삼척교육지원청 삼척초등학교,19,19,0,19,19,0,0,0
교육기관,교육부,상장중학교,교육부 강원도교육청 강원도삼척교육지원청 상장중학교,29,29,0,29,0,29,0,0
교육기관,교육부,상장초등학교,교육부 강원도교육청 강원도삼척교육지원청 상장초등학교,19,19,0,19,15,4,0,0
교육기관,교육부,서부초등학교,교육부 강원도교육청 강원도삼척교육지원청 서부초등학교,10,10,0,10,8,2,0,0
교육기관,교육부,세연중학교,교육부 강원도교육청 강원도삼척교육지원청 세연중학교,33,31,2,31,28,1,1,1
교육기관,교육부,신동초등학교,교육부 강원도교육청 강원도삼척교육지원청 신동초등학교,10,10,0,10,0,10,0,0
교육기관,교육부,오저초등학교,교육부 강원도교육청 강원도삼척교육지원청 오저초등학교,11,11,0,11,11,0,0,0
교육기관,교육부,원덕고등학교,교육부 강원도교육청 강원도삼척교육지원청 원덕고등학교,7,7,0,7,3,4,0,0
교육기관,교육부,원덕중학교,교육부 강원도교육청 강원도삼척교육지원청 원덕중학교,11,11,0,11,4,3,2,2
교육기관,교육부,임원중학교,교육부 강원도교육청 강원도삼척교육지원청 임원중학교,7,7,0,7,2,3,1,1
교육기관,교육부,임원초등학교,교육부 강원도교육청 강원도삼척교육지원청 임원초등학교,27,27,0,27,27,0,0,0
교육기관,교육부,장성여자고등학교,교육부 강원도교육청 강원도삼척교육지원청 장성여자고등학교,48,48,0,48,14,32,1,1
교육기관,교육부,장성초등학교,교육부 강원도교육청 강원도삼척교육지원청 장성초등학교,17,17,0,17,17,0,0,0
교육기관,교육부,장원초등학교,교육부 강원도교육청 강원도삼척교육지원청 장원초등학교,13,13,0,13,0,13,0,0
교육기관,교육부,정라초등학교,교육부 강원도교육청 강원도삼척교육지원청 정라초등학교,23,23,0,23,22,1,0,0
교육기관,교육부,진주초등학교,교육부 강원도교육청 강원도삼척교육지원청 진주초등학교,18,11,7,11,6,5,0,0
교육기관,교육부,철암고등학교,교육부 강원도교육청 강원도삼척교육지원청 철암고등학교,17,16,1,16,4,12,0,0
교육기관,교육부,철암중학교,교육부 강원도교육청 강원도삼척교육지원청 철암중학교,16,16,0,16,8,8,0,0
교육기관,교육부,철암초등학교,교육부 강원도교육청 강원도삼척교육지원청 철암초등학교,9,9,0,9,9,0,0,0
교육기관,교육부,청아중학교,교육부 강원도교육청 강원도삼척교육지원청 청아중학교,32,32,0,32,16,16,0,0
교육기관,교육부,태백기계공업고등학교,교육부 강원도교육청 강원도삼척교육지원청 태백기계공업고등학교,165,165,0,165,110,55,0,0
교육기관,교육부,태백라온학교,교육부 강원도교육청 강원도삼척교육지원청 태백라온학교,52,52,0,52,52,0,0,0
교육기관,교육부,태백중학교,교육부 강원도교육청 강원도삼척교육지원청 태백중학교,26,26,0,26,0,26,0,0
교육기관,교육부,태백초등학교,교육부 강원도교육청 강원도삼척교육지원청 태백초등학교,19,19,0,19,10,9,0,0
교육기관,교육부,태사랑유치원,교육부 강원도교육청 강원도삼척교육지원청 태사랑유치원,7,7,0,7,0,7,0,0
교육기관,교육부,태서초등학교,교육부 강원도교육청 강원도삼척교육지원청 태서초등학교,14,14,0,14,0,14,0,0
교육기관,교육부,통리초등학교,교육부 강원도교육청 강원도삼척교육지원청 통리초등학교,16,16,0,16,7,9,0,0
교육기관,교육부,하늘빛유치원,교육부 강원도교육청 강원도삼척교육지원청 하늘빛유치원,12,12,0,12,5,7,0,0
교육기관,교육부,하장중학교,교육부 강원도교육청 강원도삼척교육지원청 하장중학교,19,19,0,19,19,0,0,0
교육기관,교육부,하장초등학교,교육부 강원도교육청 강원도삼척교육지원청 하장초등학교,8,8,0,8,8,0,0,0
교육기관,교육부,함태중학교,교육부 강원도교육청 강원도삼척교육지원청 함태중학교,30,30,0,30,25,5,0,0
교육기관,교육부,함태초등학교,교육부 강원도교육청 강원도삼척교육지원청 함태초등학교,15,15,0,15,13,2,0,0
교육기관,교육부,호산초등학교,교육부 강원도교육청 강원도삼척교육지원청 호산초등학교,13,13,0,13,13,0,0,0
교육기관,교육부,황지고등학교,교육부 강원도교육청 강원도삼척교육지원청 황지고등학교,68,45,23,45,15,30,0,0
교육기관,교육부,황지정보산업고등학교,교육부 강원도교육청 강원도삼척교육지원청 황지정보산업고등학교,23,21,2,21,9,12,0,0
교육기관,교육부,황지중학교,교육부 강원도교육청 강원도삼척교육지원청 황지중학교,25,25,0,25,15,10,0,0
교육기관,교육부,황지초등학교,교육부 강원도교육청 강원도삼척교육지원청 황지초등학교,23,23,0,23,23,0,0,0
교육기관,교육부,흥전초등학교,교육부 강원도교육청 강원도삼척교육지원청 흥전초등학교,8,8,0,8,8,0,0,0
교육기관,교육부,강원도속초양양교육지원청,교육부 강원도교육청 강원도속초양양교육지원청,17,17,0,17,0,17,0,0
교육기관,교육부,간성초등학교,교육부 강원도교육청 강원도속초양양교육지원청 간성초등학교,29,29,0,29,15,14,0,0
교육기관,교육부,강현중학교,교육부 강원도교육청 강원도속초양양교육지원청 강현중학교,10,10,0,10,10,0,0,0
교육기관,교육부,거성초등학교,교육부 강원도교육청 강원도속초양양교육지원청 거성초등학교,10,10,0,10,7,3,0,0
교육기관,교육부,거진정보공업고등학교,교육부 강원도교육청 강원도속초양양교육지원청 거진정보공업고등학교,9,9,0,9,3,6,0,0
교육기관,교육부,거진중학교,교육부 강원도교육청 강원도속초양양교육지원청 거진중학교,17,17,0,17,15,2,0,0
교육기관,교육부,거진초등학교,교육부 강원도교육청 강원도속초양양교육지원청 거진초등학교,14,14,0,14,9,0,5,0
교육기관,교육부,고성고등학교,교육부 강원도교육청 강원도속초양양교육지원청 고성고등학교,21,16,5,16,16,0,0,0
교육기관,교육부,고성중학교,교육부 강원도교육청 강원도속초양양교육지원청 고성중학교,19,19,0,19,10,9,0,0
교육기관,교육부,공현진초등학교,교육부 강원도교육청 강원도속초양양교육지원청 공현진초등학교,9,9,0,9,9,0,0,0
교육기관,교육부,광산초등학교,교육부 강원도교육청 강원도속초양양교육지원청 광산초등학교,8,8,0,8,0,8,0,0
교육기관,교육부,광정초등학교,교육부 강원도교육청 강원도속초양양교육지원청 광정초등학교,22,22,0,22,0,22,0,0
교육기관,교육부,교동초등학교,교육부 강원도교육청 강원도속초양양교육지원청 교동초등학교,63,63,0,63,56,7,0,0
교육기관,교육부,대진고등학교,교육부 강원도교육청 강원도속초양양교육지원청 대진고등학교,23,23,0,23,23,0,0,0
교육기관,교육부,대진초등학교,교육부 강원도교육청 강원도속초양양교육지원청 대진초등학교,16,16,0,16,12,4,0,0
교육기관,교육부,대포초등학교,교육부 강원도교육청 강원도속초양양교육지원청 대포초등학교,24,24,0,24,14,10,0,0
교육기관,교육부,도학초등학교,교육부 강원도교육청 강원도속초양양교육지원청 도학초등학교,10,10,0,10,5,5,0,0
교육기관,교육부,동광산업과학고등학교,교육부 강원도교육청 강원도속초양양교육지원청 동광산업과학고등학교,16,16,0,16,13,3,0,0
교육기관,교육부,동광중학교,교육부 강원도교육청 강원도속초양양교육지원청 동광중학교,10,10,0,10,5,5,0,0
교육기관,교육부,산호유치원,교육부 강원도교육청 강원도속초양양교육지원청 산호유치원,8,8,0,8,8,0,0,0
교육기관,교육부,상평초등학교,교육부 강원도교육청 강원도속초양양교육지원청 상평초등학교,12,12,0,12,1,11,0,0
교육기관,교육부,상평초등학교공수전분교장,교육부 강원도교육청 강원도속초양양교육지원청 상평초등학교공수전분교장,5,5,0,5,1,4,0,0
교육기관,교육부,상평초등학교오색분교장,교육부 강원도교육청 강원도속초양양교육지원청 상평초등학교오색분교장,12,12,0,12,9,3,0,0
교육기관,교육부,상평초등학교현서분교장,교육부 강원도교육청 강원도속초양양교육지원청 상평초등학교현서분교장,4,4,0,4,0,4,0,0
교육기관,교육부,설악중학교,교육부 강원도교육청 강원도속초양양교육지원청 설악중학교,35,35,0,35,35,0,0,0
교육기관,교육부,설악초등학교,교육부 강원도교육청 강원도속초양양교육지원청 설악초등학교,9,9,0,9,6,3,0,0
교육기관,교육부,설온중학교,교육부 강원도교육청 강원도속초양양교육지원청 설온중학교,27,27,0,27,27,0,0,0
교육기관,교육부,소야초등학교,교육부 강원도교육청 강원도속초양양교육지원청 소야초등학교,15,15,0,15,15,0,0,0
교육기관,교육부,속초고등학교,교육부 강원도교육청 강원도속초양양교육지원청 속초고등학교,53,53,0,53,53,0,0,0
교육기관,교육부,속초여자고등학교,교육부 강원도교육청 강원도속초양양교육지원청 속초여자고등학교,47,47,0,47,37,10,0,0
교육기관,교육부,속초유치원,교육부 강원도교육청 강원도속초양양교육지원청 속초유치원,17,17,0,17,12,5,0,0
교육기관,교육부,속초중학교,교육부 강원도교육청 강원도속초양양교육지원청 속초중학교,31,31,0,31,31,0,0,0
교육기관,교육부,속초청해학교,교육부 강원도교육청 강원도속초양양교육지원청 속초청해학교,13,13,0,13,10,3,0,0
교육기관,교육부,속초초등학교,교육부 강원도교육청 강원도속초양양교육지원청 속초초등학교,29,29,0,29,0,29,0,0
교육기관,교육부,속초해랑중학교,교육부 강원도교육청 강원도속초양양교육지원청 속초해랑중학교,28,28,0,28,16,12,0,0
교육기관,교육부,손양초등학교,교육부 강원도교육청 강원도속초양양교육지원청 손양초등학교,14,14,0,14,14,0,0,0
교육기관,교육부,송포초등학교,교육부 강원도교육청 강원도속초양양교육지원청 송포초등학교,13,13,0,13,13,0,0,0
교육기관,교육부,아야진초등학교,교육부 강원도교육청 강원도속초양양교육지원청 아야진초등학교,13,13,0,13,0,9,2,2
교육기관,교육부,양양고등학교,교육부 강원도교육청 강원도속초양양교육지원청 양양고등학교,77,77,0,77,75,2,0,0
교육기관,교육부,양양중학교,교육부 강원도교육청 강원도속초양양교육지원청 양양중학교,40,38,2,38,20,16,1,1
교육기관,교육부,양양초등학교,교육부 강원도교육청 강원도속초양양교육지원청 양양초등학교,32,32,0,32,32,0,0,0
교육기관,교육부,영랑초등학교,교육부 강원도교육청 강원도속초양양교육지원청 영랑초등학교,16,16,0,16,8,8,0,0
교육기관,교육부,오호초등학교,교육부 강원도교육청 강원도속초양양교육지원청 오호초등학교,12,12,0,12,12,0,0,0
교육기관,교육부,온정초등학교,교육부 강원도교육청 강원도속초양양교육지원청 온정초등학교,13,13,0,13,7,6,0,0
교육기관,교육부,인구초등학교,교육부 강원도교육청 강원도속초양양교육지원청 인구초등학교,11,11,0,11,8,3,0,0
교육기관,교육부,인흥초등학교,교육부 강원도교육청 강원도속초양양교육지원청 인흥초등학교,14,14,0,14,8,6,0,0
교육기관,교육부,조산초등학교,교육부 강원도교육청 강원도속초양양교육지원청 조산초등학교,12,12,0,12,12,0,0,0
교육기관,교육부,조양초등학교,교육부 강원도교육청 강원도속초양양교육지원청 조양초등학교,14,14,0,14,6,4,2,2
교육기관,교육부,죽왕초등학교,교육부 강원도교육청 강원도속초양양교육지원청 죽왕초등학교,13,13,0,13,13,0,0,0
교육기관,교육부,중앙초등학교,교육부 강원도교육청 강원도속초양양교육지원청 중앙초등학교,27,26,1,26,14,12,0,0
교육기관,교육부,천진초등학교,교육부 강원도교육청 강원도속초양양교육지원청 천진초등학교,10,10,0,10,10,0,0,0
교육기관,교육부,청대초등학교,교육부 강원도교육청 강원도속초양양교육지원청 청대초등학교,18,18,0,18,18,0,0,0
교육기관,교육부,청봉초등학교,교육부 강원도교육청 강원도속초양양교육지원청 청봉초등학교,14,14,0,14,14,0,0,0
교육기관,교육부,청호초등학교,교육부 강원도교육청 강원도속초양양교육지원청 청호초등학교,9,9,0,9,5,4,0,0
교육기관,교육부,한남초등학교,교육부 강원도교육청 강원도속초양양교육지원청 한남초등학교,18,18,0,18,18,0,0,0
교육기관,교육부,현남중학교,교육부 강원도교육청 강원도속초양양교육지원청 현남중학교,13,11,2,11,11,0,0,0
교육기관,교육부,현북중학교,교육부 강원도교육청 강원도속초양양교육지원청 현북중학교,11,11,0,11,7,4,0,0
교육기관,교육부,현북초등학교,교육부 강원도교육청 강원도속초양양교육지원청 현북초등학교,12,12,0,12,0,12,0,0
교육기관,교육부,현성초등학교,교육부 강원도교육청 강원도속초양양교육지원청 현성초등학교,13,13,0,13,6,7,0,0
교육기관,교육부,회룡초등학교,교육부 강원도교육청 강원도속초양양교육지원청 회룡초등학교,15,15,0,15,15,0,0,0
교육기관,교육부,강원도양구교육지원청,교육부 강원도교육청 강원도양구교육지원청,4,4,0,4,2,2,0,0
교육기관,교육부,원당초등학교,교육부 강원도교육청 강원도양구교육지원청 원당초등학교,12,12,0,12,12,0,0,0
교육기관,교육부,강원도영월교육지원청,교육부 강원도교육청 강원도영월교육지원청,10,8,2,8,0,8,0,0
교육기관,교육부,석정여자중학교,교육부 강원도교육청 강원도영월교육지원청 석정여자중학교,37,35,2,35,12,21,0,2
교육기관,교육부,강원도원주교육지원청,교육부 강원도교육청 강원도원주교육지원청,16,16,0,16,0,16,0,0
교육기관,교육부,강원과학고등학교,교육부 강원도교육청 강원도원주교육지원청 강원과학고등학교,25,25,0,25,10,15,0,0
교육기관,교육부,고산초등학교,교육부 강원도교육청 강원도원주교육지원청 고산초등학교,8,8,0,8,8,0,0,0
교육기관,교육부,관설초등학교,교육부 강원도교육청 강원도원주교육지원청 관설초등학교,14,14,0,14,0,14,0,0
교육기관,교육부,교학초등학교,교육부 강원도교육청 강원도원주교육지원청 교학초등학교,9,9,0,9,9,0,0,0
교육기관,교육부,구곡초등학교,교육부 강원도교육청 강원도원주교육지원청 구곡초등학교,41,40,1,40,14,24,2,0
교육기관,교육부,귀래중학교,교육부 강원도교육청 강원도원주교육지원청 귀래중학교,14,14,0,14,14,0,0,0
교육기관,교육부,귀래초등학교,교육부 강원도교육청 강원도원주교육지원청 귀래초등학교,12,12,0,12,12,0,0,0
교육기관,교육부,금대초등학교,교육부 강원도교육청 강원도원주교육지원청 금대초등학교,20,20,0,20,14,6,0,0
교육기관,교육부,나영유치원,교육부 강원도교육청 강원도원주교육지원청 나영유치원,12,12,0,12,0,12,0,0
교육기관,교육부,남원주중학교,교육부 강원도교육청 강원도원주교육지원청 남원주중학교,48,48,0,48,48,0,0,0
교육기관,교육부,남원주초등학교,교육부 강원도교육청 강원도원주교육지원청 남원주초등학교,34,30,4,30,30,0,0,0
교육기관,교육부,단계초등학교,교육부 강원도교육청 강원도원주교육지원청 단계초등학교,15,15,0,15,15,0,0,0
교육기관,교육부,단관초등학교,교육부 강원도교육청 강원도원주교육지원청 단관초등학교,33,33,0,33,17,16,0,0
교육기관,교육부,대성고등학교,교육부 강원도교육청 강원도원주교육지원청 대성고등학교,49,49,0,49,49,0,0,0
교육기관,교육부,동화나라유치원,교육부 강원도교육청 강원도원주교육지원청 동화나라유치원,13,8,5,8,4,4,0,0
교육기관,교육부,동화초등학교,교육부 강원도교육청 강원도원주교육지원청 동화초등학교,26,26,0,26,0,26,0,0
교육기관,교육부,둔둔초등학교,교육부 강원도교육청 강원도원주교육지원청 둔둔초등학교,12,12,0,12,10,2,0,0
교육기관,교육부,만대초등학교,교육부 강원도교육청 강원도원주교육지원청 만대초등학교,35,35,0,35,17,18,0,0
교육기관,교육부,만종초등학교,교육부 강원도교육청 강원도원주교육지원청 만종초등학교,11,11,0,11,11,0,0,0
교육기관,교육부,매지초등학교,교육부 강원도교육청 강원도원주교육지원청 매지초등학교,16,16,0,16,16,0,0,0
교육기관,교육부,명륜초등학교,교육부 강원도교육청 강원도원주교육지원청 명륜초등학교,32,32,0,32,32,0,0,0
교육기관,교육부,무실빛유치원,교육부 강원도교육청 강원도원주교육지원청 무실빛유치원,16,16,0,16,0,16,0,0
교육기관,교육부,무실초등학교,교육부 강원도교육청 강원도원주교육지원청 무실초등학교,30,30,0,30,16,14,0,0
교육기관,교육부,문막중학교,교육부 강원도교육청 강원도원주교육지원청 문막중학교,19,19,0,19,18,1,0,0
교육기관,교육부,문막초등학교,교육부 강원도교육청 강원도원주교육지원청 문막초등학교,32,32,0,32,18,14,0,0
교육기관,교육부,미래고등학교,교육부 강원도교육청 강원도원주교육지원청 미래고등학교,56,54,2,54,0,54,0,0
교육기관,교육부,반계초등학교,교육부 강원도교육청 강원도원주교육지원청 반계초등학교,12,12,0,12,10,2,0,0
교육기관,교육부,반곡별유치원,교육부 강원도교육청 강원도원주교육지원청 반곡별유치원,18,18,0,18,11,7,0,0
교육기관,교육부,반곡중학교,교육부 강원도교육청 강원도원주교육지원청 반곡중학교,64,64,0,64,60,4,0,0
교육기관,교육부,반곡초등학교,교육부 강원도교육청 강원도원주교육지원청 반곡초등학교,35,35,0,35,20,15,0,0
교육기관,교육부,버들중학교,교육부 강원도교육청 강원도원주교육지원청 버들중학교,51,50,1,50,0,50,0,0
교육기관,교육부,버들초등학교,교육부 강원도교육청 강원도원주교육지원청 버들초등학교,74,74,0,74,0,74,0,0
교육기관,교육부,봉대가온학교,교육부 강원도교육청 강원도원주교육지원청 봉대가온학교,82,82,0,82,80,2,0,0
교육기관,교육부,봉대초등학교,교육부 강원도교육청 강원도원주교육지원청 봉대초등학교,52,52,0,52,26,26,0,0
교육기관,교육부,부론초등학교,교육부 강원도교육청 강원도원주교육지원청 부론초등학교,19,19,0,19,10,9,0,0
교육기관,교육부,북원여자고등학교,교육부 강원도교육청 강원도원주교육지원청 북원여자고등학교,14,12,2,12,0,12,0,0
교육기관,교육부,북원중학교,교육부 강원도교육청 강원도원주교육지원청 북원중학교,36,36,0,36,20,10,3,3
교육기관,교육부,북원초등학교,교육부 강원도교육청 강원도원주교육지원청 북원초등학교,18,18,0,18,10,8,0,0
교육기관,교육부,비두초등학교,교육부 강원도교육청 강원도원주교육지원청 비두초등학교,10,10,0,10,0,10,0,0
교육기관,교육부,산내들유치원,교육부 강원도교육청 강원도원주교육지원청 산내들유치원,14,0,14,0,0,0,0,0
교육기관,교육부,상지여자고등학교,교육부 강원도교육청 강원도원주교육지원청 상지여자고등학교,25,25,0,25,2,23,0,0
교육기관,교육부,상지여자중학교,교육부 강원도교육청 강원도원주교육지원청 상지여자중학교,16,16,0,16,10,6,0,0
교육기관,교육부,샘마루초등학교,교육부 강원도교육청 강원도원주교육지원청 샘마루초등학교,60,60,0,60,7,53,0,0
교육기관,교육부,서곡초등학교,교육부 강원도교육청 강원도원주교육지원청 서곡초등학교,20,20,0,20,20,0,0,0
교육기관,교육부,섬강중학교,교육부 강원도교육청 강원도원주교육지원청 섬강중학교,70,70,0,70,49,13,8,0
교육기관,교육부,섬강초등학교,교육부 강원도교육청 강원도원주교육지원청 섬강초등학교,80,80,0,80,62,18,0,0
교육기관,교육부,성균관유치원,교육부 강원도교육청 강원도원주교육지원청 성균관유치원,22,22,0,22,8,14,0,0
교육기관,교육부,성불유치원,교육부 강원도교육청 강원도원주교육지원청 성불유치원,15,15,0,15,8,7,0,0
교육기관,교육부,소초초등학교,교육부 강원도교육청 강원도원주교육지원청 소초초등학교,12,12,0,12,12,0,0,0
교육기관,교육부,솔샘초등학교,교육부 강원도교육청 강원도원주교육지원청 솔샘초등학교,45,45,0,45,45,0,0,0
교육기관,교육부,신림중학교,교육부 강원도교육청 강원도원주교육지원청 신림중학교,11,11,0,11,3,6,0,2
교육기관,교육부,신림초등학교,교육부 강원도교육청 강원도원주교육지원청 신림초등학교,19,19,0,19,19,0,0,0
교육기관,교육부,신평초등학교,교육부 강원도교육청 강원도원주교육지원청 신평초등학교,16,16,0,16,5,10,1,0
교육기관,교육부,영서고등학교,교육부 강원도교육청 강원도원주교육지원청 영서고등학교,90,90,0,90,82,8,0,0
교육기관,교육부,예지유치원,교육부 강원도교육청 강원도원주교육지원청 예지유치원,31,31,0,31,0,31,0,0
교육기관,교육부,우산초등학교,교육부 강원도교육청 강원도원주교육지원청 우산초등학교,20,20,0,20,8,12,0,0
교육기관,교육부,원주고등학교,교육부 강원도교육청 강원도원주교육지원청 원주고등학교,54,54,0,54,54,0,0,0
교육기관,교육부,원주금융회계고등학교,교육부 강원도교육청 강원도원주교육지원청 원주금융회계고등학교,40,40,0,40,30,10,0,0
교육기관,교육부,원주대성중학교,교육부 강원도교육청 강원도원주교육지원청 원주대성중학교,9,9,0,9,9,0,0,0
교육기관,교육부,원주삼육고등학교,교육부 강원도교육청 강원도원주교육지원청 원주삼육고등학교,77,77,0,77,2,75,0,0
교육기관,교육부,원주삼육중학교,교육부 강원도교육청 강원도원주교육지원청 원주삼육중학교,19,19,0,19,4,15,0,0
교육기관,교육부,원주삼육초등학교,교육부 강원도교육청 강원도원주교육지원청 원주삼육초등학교,62,62,0,62,62,0,0,0
교육기관,교육부,원주여자고등학교,교육부 강원도교육청 강원도원주교육지원청 원주여자고등학교,70,70,0,70,70,0,0,0
교육기관,교육부,원주여자중학교,교육부 강원도교육청 강원도원주교육지원청 원주여자중학교,34,34,0,34,34,0,0,0
교육기관,교육부,원주의료고등학교,교육부 강원도교육청 강원도원주교육지원청 원주의료고등학교,106,21,85,21,21,0,0,0
교육기관,교육부,원주중학교,교육부 강원도교육청 강원도원주교육지원청 원주중학교,31,31,0,31,31,0,0,0
교육기관,교육부,원주청원학교,교육부 강원도교육청 강원도원주교육지원청 원주청원학교,16,16,0,16,7,9,0,0
교육기관,교육부,원주초등학교,교육부 강원도교육청 강원도원주교육지원청 원주초등학교,55,55,0,55,0,55,0,0
교육기관,교육부,육민관고등학교,교육부 강원도교육청 강원도원주교육지원청 육민관고등학교,65,65,0,65,0,65,0,0
교육기관,교육부,육민관중학교,교육부 강원도교육청 강원도원주교육지원청 육민관중학교,35,35,0,35,0,35,0,0
교육기관,교육부,이화유치원,교육부 강원도교육청 강원도원주교육지원청 이화유치원,20,5,15,5,2,1,1,1
교육기관,교육부,일산초등학교,교육부 강원도교육청 강원도원주교육지원청 일산초등학교,25,25,0,25,25,0,0,0
교육기관,교육부,장양초등학교,교육부 강원도교육청 강원도원주교육지원청 장양초등학교,26,26,0,26,20,6,0,0
교육기관,교육부,제일유치원,교육부 강원도교육청 강원도원주교육지원청 제일유치원,16,3,13,3,1,1,1,0
교육기관,교육부,지정샘유치원,교육부 강원도교육청 강원도원주교육지원청 지정샘유치원,27,12,15,12,3,3,6,0
교육기관,교육부,지정중학교,교육부 강원도교육청 강원도원주교육지원청 지정중학교,7,7,0,7,7,0,0,0
교육기관,교육부,지정초등학교,교육부 강원도교육청 강원도원주교육지원청 지정초등학교,20,20,0,20,17,3,0,0
교육기관,교육부,진광고등학교,교육부 강원도교육청 강원도원주교육지원청 진광고등학교,91,91,0,91,91,0,0,0
교육기관,교육부,진광중학교,교육부 강원도교육청 강원도원주교육지원청 진광중학교,55,55,0,55,30,25,0,0
교육기관,교육부,치악고등학교,교육부 강원도교육청 강원도원주교육지원청 치악고등학교,40,40,0,40,40,0,0,0
교육기관,교육부,태봉초등학교,교육부 강원도교육청 강원도원주교육지원청 태봉초등학교,19,19,0,19,6,13,0,0
교육기관,교육부,태장초등학교,교육부 강원도교육청 강원도원주교육지원청 태장초등학교,28,28,0,28,28,0,0,0
교육기관,교육부,평원초등학교,교육부 강원도교육청 강원도원주교육지원청 평원초등학교,29,29,0,29,29,0,0,0
교육기관,교육부,학성유치원,교육부 강원도교육청 강원도원주교육지원청 학성유치원,10,10,0,10,0,10,0,0
교육기관,교육부,학성중학교,교육부 강원도교육청 강원도원주교육지원청 학성중학교,84,84,0,84,18,66,0,0
교육기관,교육부,학성초등학교,교육부 강원도교육청 강원도원주교육지원청 학성초등학교,63,63,0,63,56,7,0,0
교육기관,교육부,호저중학교,교육부 강원도교육청 강원도원주교육지원청 호저중학교,9,9,0,9,0,9,0,0
교육기관,교육부,호저초등학교,교육부 강원도교육청 강원도원주교육지원청 호저초등학교,22,22,0,22,8,11,0,3
교육기관,교육부,황둔중학교,교육부 강원도교육청 강원도원주교육지원청 황둔중학교,10,10,0,10,4,4,0,2
교육기관,교육부,황둔초등학교,교육부 강원도교육청 강원도원주교육지원청 황둔초등학교,8,8,0,8,0,8,0,0
교육기관,교육부,흥양초등학교,교육부 강원도교육청 강원도원주교육지원청 흥양초등학교,16,16,0,16,16,0,0,0
교육기관,교육부,흥업초등학교,교육부 강원도교육청 강원도원주교육지원청 흥업초등학교,13,13,0,13,8,5,0,0
교육기관,교육부,강원도인제교육지원청,교육부 강원도교육청 강원도인제교육지원청,1,1,0,1,1,0,0,0
교육기관,교육부,강원도정선교육지원청,교육부 강원도교육청 강원도정선교육지원청,5,5,0,5,0,5,0,0
교육기관,교육부,갈래초등학교,교육부 강원도교육청 강원도정선교육지원청 갈래초등학교,14,14,0,14,7,7,0,0
교육기관,교육부,고한고등학교,교육부 강원도교육청 강원도정선교육지원청 고한고등학교,37,37,0,37,19,16,2,0
교육기관,교육부,고한중학교,교육부 강원도교육청 강원도정선교육지원청 고한중학교,21,21,0,21,21,0,0,0
교육기관,교육부,고한초등학교,교육부 강원도교육청 강원도정선교육지원청 고한초등학교,11,11,0,11,0,11,0,0
교육기관,교육부,구래초등학교,교육부 강원도교육청 강원도정선교육지원청 구래초등학교,8,8,0,8,8,0,0,0
교육기관,교육부,남선초등학교남창분교장,교육부 강원도교육청 강원도정선교육지원청 남선초등학교남창분교장,7,7,0,7,3,4,0,0
교육기관,교육부,남평초등학교,교육부 강원도교육청 강원도정선교육지원청 남평초등학교,10,10,0,10,10,0,0,0
교육기관,교육부,내성초등학교,교육부 강원도교육청 강원도정선교육지원청 내성초등학교,20,20,0,20,14,6,0,0
교육기관,교육부,녹전중학교,교육부 강원도교육청 강원도정선교육지원청 녹전중학교,11,11,0,11,8,3,0,0
교육기관,교육부,녹전초등학교,교육부 강원도교육청 강원도정선교육지원청 녹전초등학교,10,10,0,10,4,6,0,0
교육기관,교육부,마차고등학교,교육부 강원도교육청 강원도정선교육지원청 마차고등학교,23,23,0,23,23,0,0,0
교육기관,교육부,마차중학교,교육부 강원도교육청 강원도정선교육지원청 마차중학교,5,5,0,5,3,2,0,0
교육기관,교육부,마차초등학교,교육부 강원도교육청 강원도정선교육지원청 마차초등학교,14,14,0,14,4,10,0,0
교육기관,교육부,무릉초등학교,교육부 강원도교육청 강원도정선교육지원청 무릉초등학교,16,16,0,16,0,16,0,0
교육기관,교육부,문곡중학교,교육부 강원도교육청 강원도정선교육지원청 문곡중학교,21,21,0,21,11,8,1,1
교육기관,교육부,백전초등학교,교육부 강원도교육청 강원도정선교육지원청 백전초등학교,8,8,0,8,8,0,0,0
교육기관,교육부,벽탄초등학교,교육부 강원도교육청 강원도정선교육지원청 벽탄초등학교,15,15,0,15,8,7,0,0
교육기관,교육부,봉래중학교,교육부 강원도교육청 강원도정선교육지원청 봉래중학교,20,20,0,20,7,13,0,0
교육기관,교육부,봉래초등학교,교육부 강원도교육청 강원도정선교육지원청 봉래초등학교,22,22,0,22,17,5,0,0
교육기관,교육부,봉양초등학교,교육부 강원도교육청 강원도정선교육지원청 봉양초등학교,23,23,0,23,23,0,0,0
교육기관,교육부,북평초등학교,교육부 강원도교육청 강원도정선교육지원청 북평초등학교,14,14,0,14,14,0,0,0
교육기관,교육부,사북고등학교,교육부 강원도교육청 강원도정선교육지원청 사북고등학교,35,33,2,33,23,10,0,0
교육기관,교육부,사북중학교,교육부 강원도교육청 강원도정선교육지원청 사북중학교,18,18,0,18,18,0,0,0
교육기관,교육부,사북초등학교,교육부 강원도교육청 강원도정선교육지원청 사북초등학교,16,16,0,16,16,0,0,0
교육기관,교육부,상동고등학교,교육부 강원도교육청 강원도정선교육지원청 상동고등학교,8,8,0,8,8,0,0,0
교육기관,교육부,상동중학교,교육부 강원도교육청 강원도정선교육지원청 상동중학교,9,9,0,9,2,5,1,1
교육기관,교육부,신천초등학교,교육부 강원도교육청 강원도정선교육지원청 신천초등학교,13,13,0,13,6,7,0,0
교육기관,교육부,쌍룡중학교,교육부 강원도교육청 강원도정선교육지원청 쌍룡중학교,12,0,12,0,0,0,0,0
교육기관,교육부,쌍룡초등학교,교육부 강원도교육청 강원도정선교육지원청 쌍룡초등학교,14,14,0,14,8,6,0,0
교육기관,교육부,여량고등학교,교육부 강원도교육청 강원도정선교육지원청 여량고등학교,18,18,0,18,18,0,0,0
교육기관,교육부,여량중학교,교육부 강원도교육청 강원도정선교육지원청 여량중학교,18,18,0,18,13,5,0,0
교육기관,교육부,여량초등학교,교육부 강원도교육청 강원도정선교육지원청 여량초등학교,11,11,0,11,11,0,0,0
교육기관,교육부,연당중학교,교육부 강원도교육청 강원도정선교육지원청 연당중학교,11,11,0,11,5,6,0,0
교육기관,교육부,연당초등학교,교육부 강원도교육청 강원도정선교육지원청 연당초등학교,13,13,0,13,6,7,0,0
교육기관,교육부,영월고등학교,교육부 강원도교육청 강원도정선교육지원청 영월고등학교,46,46,0,46,0,46,0,0
교육기관,교육부,영월중학교,교육부 강원도교육청 강원도정선교육지원청 영월중학교,11,11,0,11,6,5,0,0
교육기관,교육부,영월초등학교,교육부 강원도교육청 강원도정선교육지원청 영월초등학교,54,23,31,23,3,5,0,15
교육기관,교육부,예미초등학교,교육부 강원도교육청 강원도정선교육지원청 예미초등학교,11,11,0,11,8,3,0,0
교육기관,교육부,옥동중학교,교육부 강원도교육청 강원도정선교육지원청 옥동중학교,19,19,0,19,16,3,0,0
교육기관,교육부,옥동초등학교,교육부 강원도교육청 강원도정선교육지원청 옥동초등학교,13,13,0,13,10,3,0,0
교육기관,교육부,임계고등학교,교육부 강원도교육청 강원도정선교육지원청 임계고등학교,9,9,0,9,9,0,0,0
교육기관,교육부,임계중학교,교육부 강원도교육청 강원도정선교육지원청 임계중학교,16,16,0,16,16,0,0,0
교육기관,교육부,정선고등학교,교육부 강원도교육청 강원도정선교육지원청 정선고등학교,9,9,0,9,6,1,1,1
교육기관,교육부,정선정보공업고등학교,교육부 강원도교육청 강원도정선교육지원청 정선정보공업고등학교,58,58,0,58,40,18,0,0
교육기관,교육부,정선중학교,교육부 강원도교육청 강원도정선교육지원청 정선중학교,31,31,0,31,14,17,0,0
교육기관,교육부,정선초등학교,교육부 강원도교육청 강원도정선교육지원청 정선초등학교,19,19,0,19,0,19,0,0
교육기관,교육부,정선초등학교가수분교장,교육부 강원도교육청 강원도정선교육지원청 정선초등학교가수분교장,4,4,0,4,2,2,0,0
교육기관,교육부,주천중학교,교육부 강원도교육청 강원도정선교육지원청 주천중학교,10,10,0,10,3,7,0,0
교육기관,교육부,주천초등학교,교육부 강원도교육청 강원도정선교육지원청 주천초등학교,16,16,0,16,0,16,0,0
교육기관,교육부,증산초등학교,교육부 강원도교육청 강원도정선교육지원청 증산초등학교,10,10,0,10,10,0,0,0
교육기관,교육부,한국소방마이스터고등학교,교육부 강원도교육청 강원도정선교육지원청 한국소방마이스터고등학교,150,150,0,150,0,150,0,0
교육기관,교육부,함백고등학교,교육부 강원도교육청 강원도정선교육지원청 함백고등학교,53,53,0,53,53,0,0,0
교육기관,교육부,함백중학교,교육부 강원도교육청 강원도정선교육지원청 함백중학교,23,23,0,23,10,13,0,0
교육기관,교육부,함백초등학교,교육부 강원도교육청 강원도정선교육지원청 함백초등학교,12,12,0,12,12,0,0,0
교육기관,교육부,화동초등학교,교육부 강원도교육청 강원도정선교육지원청 화동초등학교,11,11,0,11,11,0,0,0
교육기관,교육부,강원도철원교육지원청,교육부 강원도교육청 강원도철원교육지원청,9,8,1,8,0,8,0,0
교육기관,교육부,신철원초등학교,교육부 강원도교육청 강원도철원교육지원청 신철원초등학교,15,15,0,15,0,15,0,0
교육기관,교육부,가산초등학교,교육부 강원도교육청 강원도춘천교육지원청 가산초등학교,16,16,0,16,16,0,0,0
교육기관,교육부,가정중학교,교육부 강원도교육청 강원도춘천교육지원청 가정중학교,104,104,0,104,0,104,0,0
교육기관,교육부,강서중학교,교육부 강원도교육청 강원도춘천교육지원청 강서중학교,16,16,0,16,8,8,0,0
교육기관,교육부,강원고등학교,교육부 강원도교육청 강원도춘천교육지원청 강원고등학교,49,49,0,49,0,49,0,0
교육기관,교육부,강원명진학교,교육부 강원도교육청 강원도춘천교육지원청 강원명진학교,39,38,1,38,0,38,0,0
교육기관,교육부,강원생명과학고등학교,교육부 강원도교육청 강원도춘천교육지원청 강원생명과학고등학교,38,0,38,0,0,0,0,0
교육기관,교육부,강원외국어고등학교,교육부 강원도교육청 강원도춘천교육지원청 강원외국어고등학교,146,146,0,146,5,141,0,0
교육기관,교육부,강원중학교,교육부 강원도교육청 강원도춘천교육지원청 강원중학교,29,29,0,29,0,29,0,0
교육기관,교육부,강원체육고등학교,교육부 강원도교육청 강원도춘천교육지원청 강원체육고등학교,53,53,0,53,42,11,0,0
교육기관,교육부,강원체육중학교,교육부 강원도교육청 강원도춘천교육지원청 강원체육중학교,30,15,15,15,6,9,0,0
교육기관,교육부,광판초등학교,교육부 강원도교육청 강원도춘천교육지원청 광판초등학교,16,16,0,16,6,10,0,0
교육기관,교육부,교동초등학교,교육부 강원도교육청 강원도춘천교육지원청 교동초등학교,12,12,0,12,12,0,0,0
교육기관,교육부,근화초등학교,교육부 강원도교육청 강원도춘천교육지원청 근화초등학교,8,8,0,8,2,6,0,0
교육기관,교육부,금병초등학교,교육부 강원도교육청 강원도춘천교육지원청 금병초등학교,15,15,0,15,0,15,0,0
교육기관,교육부,금산초등학교,교육부 강원도교육청 강원도춘천교육지원청 금산초등학교,15,15,0,15,15,0,0,0
교육기관,교육부,남부초등학교,교육부 강원도교육청 강원도춘천교육지원청 남부초등학교,25,25,0,25,14,11,0,0
교육기관,교육부,남산초등학교,교육부 강원도교육청 강원도춘천교육지원청 남산초등학교,16,16,0,16,10,6,0,0
교육기관,교육부,남춘천중학교,교육부 강원도교육청 강원도춘천교육지원청 남춘천중학교,52,0,52,0,0,0,0,0
교육기관,교육부,남춘천초등학교,교육부 강원도교육청 강원도춘천교육지원청 남춘천초등학교,21,21,0,21,14,7,0,0
교육기관,교육부,당림초등학교,교육부 강원도교육청 강원도춘천교육지원청 당림초등학교,10,10,0,10,10,0,0,0
교육기관,교육부,대룡중학교,교육부 강원도교육청 강원도춘천교육지원청 대룡중학교,30,30,0,30,15,15,0,0
교육기관,교육부,대암중학교,교육부 강원도교육청 강원도춘천교육지원청 대암중학교,16,16,0,16,0,16,0,0
교육기관,교육부,도촌초등학교,교육부 강원도교육청 강원도춘천교육지원청 도촌초등학교,11,11,0,11,0,11,0,0
교육기관,교육부,동내초등학교,교육부 강원도교육청 강원도춘천교육지원청 동내초등학교,16,16,0,16,16,0,0,0
교육기관,교육부,동부초등학교,교육부 강원도교육청 강원도춘천교육지원청 동부초등학교,20,20,0,20,14,6,0,0
교육기관,교육부,동산중학교,교육부 강원도교육청 강원도춘천교육지원청 동산중학교,14,14,0,14,14,0,0,0
교육기관,교육부,두란노유치원,교육부 강원도교육청 강원도춘천교육지원청 두란노유치원,32,2,30,2,1,1,0,0
교육기관,교육부,만천유치원,교육부 강원도교육청 강원도춘천교육지원청 만천유치원,18,18,0,18,0,18,0,0
교육기관,교육부,만천초등학교,교육부 강원도교육청 강원도춘천교육지원청 만천초등학교,31,31,0,31,31,0,0,0
교육기관,교육부,미래숲유치원,교육부 강원도교육청 강원도춘천교육지원청 미래숲유치원,9,9,0,9,0,9,0,0
교육기관,교육부,방산중학교,교육부 강원도교육청 강원도춘천교육지원청 방산중학교,12,12,0,12,8,4,0,0
교육기관,교육부,방산초등학교,교육부 강원도교육청 강원도춘천교육지원청 방산초등학교,9,9,0,9,4,5,0,0
교육기관,교육부,봄내중학교,교육부 강원도교육청 강원도춘천교육지원청 봄내중학교,27,27,0,27,15,12,0,0
교육기관,교육부,봄내초등학교,교육부 강원도교육청 강원도춘천교육지원청 봄내초등학교,33,33,0,33,15,18,0,0
교육기관,교육부,봄봄유치원,교육부 강원도교육청 강원도춘천교육지원청 봄봄유치원,17,17,0,17,0,17,0,0
교육기관,교육부,봉의중학교,교육부 강원도교육청 강원도춘천교육지원청 봉의중학교,37,19,18,19,19,0,0,0
교육기관,교육부,봉의초등학교,교육부 강원도교육청 강원도춘천교육지원청 봉의초등학교,52,52,0,52,44,5,3,0
교육기관,교육부,부안초등학교,교육부 강원도교육청 강원도춘천교육지원청 부안초등학교,26,26,0,26,26,0,0,0
교육기관,교육부,비봉초등학교,교육부 강원도교육청 강원도춘천교육지원청 비봉초등학교,10,10,0,10,10,0,0,0
교육기관,교육부,상천초등학교,교육부 강원도교육청 강원도춘천교육지원청 상천초등학교,14,14,0,14,14,0,0,0
교육기관,교육부,새봄유치원,교육부 강원도교육청 강원도춘천교육지원청 새봄유치원,10,10,0,10,0,10,0,0
교육기관,교육부,서상초등학교,교육부 강원도교육청 강원도춘천교육지원청 서상초등학교,10,10,0,10,10,0,0,0
교육기관,교육부,석사초등학교,교육부 강원도교육청 강원도춘천교육지원청 석사초등학교,18,18,0,18,13,2,3,0
교육기관,교육부,석천중학교,교육부 강원도교육청 강원도춘천교육지원청 석천중학교,16,16,0,16,0,16,0,0
교육기관,교육부,성수고등학교,교육부 강원도교육청 강원도춘천교육지원청 성수고등학교,26,26,0,26,17,9,0,0
교육기관,교육부,성수여자고등학교,교육부 강원도교육청 강원도춘천교육지원청 성수여자고등학교,31,31,0,31,1,30,0,0
교육기관,교육부,성심유치원,교육부 강원도교육청 강원도춘천교육지원청 성심유치원,4,4,0,4,3,1,0,0
교육기관,교육부,성원초등학교,교육부 강원도교육청 강원도춘천교육지원청 성원초등학교,20,20,0,20,18,2,0,0
교육기관,교육부,소양중학교,교육부 강원도교육청 강원도춘천교육지원청 소양중학교,48,48,0,48,28,20,0,0
교육기관,교육부,소양초등학교,교육부 강원도교육청 강원도춘천교육지원청 소양초등학교,30,30,0,30,30,0,0,0
교육기관,교육부,송화초등학교,교육부 강원도교육청 강원도춘천교육지원청 송화초등학교,30,30,0,30,28,2,0,0
교육기관,교육부,신남초등학교,교육부 강원도교육청 강원도춘천교육지원청 신남초등학교,23,23,0,23,23,0,0,0
교육기관,교육부,신동초등학교,교육부 강원도교육청 강원도춘천교육지원청 신동초등학교,27,27,0,27,11,16,0,0
교육기관,교육부,신포중학교,교육부 강원도교육청 강원도춘천교육지원청 신포중학교,16,16,0,16,8,8,0,0
교육기관,교육부,양구고등학교,교육부 강원도교육청 강원도춘천교육지원청 양구고등학교,33,33,0,33,4,29,0,0
교육기관,교육부,양구여자고등학교,교육부 강원도교육청 강원도춘천교육지원청 양구여자고등학교,39,39,0,39,7,32,0,0
교육기관,교육부,양구중학교,교육부 강원도교육청 강원도춘천교육지원청 양구중학교,17,16,1,16,8,8,0,0
교육기관,교육부,양구초등학교,교육부 강원도교육청 강원도춘천교육지원청 양구초등학교,20,20,0,20,5,15,0,0
교육기관,교육부,오동초등학교,교육부 강원도교육청 강원도춘천교육지원청 오동초등학교,13,13,0,13,13,0,0,0
교육기관,교육부,용하중학교,교육부 강원도교육청 강원도춘천교육지원청 용하중학교,13,13,0,13,13,0,0,0
교육기관,교육부,용하초등학교,교육부 강원도교육청 강원도춘천교육지원청 용하초등학교,15,15,0,15,6,9,0,0
교육기관,교육부,우석중학교,교육부 강원도교육청 강원도춘천교육지원청 우석중학교,31,31,0,31,31,0,0,0
교육기관,교육부,우석초등학교,교육부 강원도교육청 강원도춘천교육지원청 우석초등학교,24,24,0,24,20,4,0,0
교육기관,교육부,은빛유치원,교육부 강원도교육청 강원도춘천교육지원청 은빛유치원,16,16,0,16,5,11,0,0
교육기관,교육부,임당초등학교,교육부 강원도교육청 강원도춘천교육지원청 임당초등학교,13,13,0,13,7,6,0,0
교육기관,교육부,장학초등학교,교육부 강원도교육청 강원도춘천교육지원청 장학초등학교,59,59,0,59,59,0,0,0
교육기관,교육부,전인고등학교,교육부 강원도교육청 강원도춘천교육지원청 전인고등학교,49,47,2,47,2,45,0,0
교육기관,교육부,조양초등학교,교육부 강원도교육청 강원도춘천교육지원청 조양초등학교,9,9,0,9,9,0,0,0
교육기관,교육부,중앙초등학교,교육부 강원도교육청 강원도춘천교육지원청 중앙초등학교,27,27,0,27,0,27,0,0
교육기관,교육부,지촌초등학교지암분교장,교육부 강원도교육청 강원도춘천교육지원청 지촌초등학교지암분교장,8,8,0,8,3,3,1,1
교육기관,교육부,창촌중학교,교육부 강원도교육청 강원도춘천교육지원청 창촌중학교,18,18,0,18,7,11,0,0
교육기관,교육부,천전초등학교,교육부 강원도교육청 강원도춘천교육지원청 천전초등학교,18,18,0,18,15,3,0,0
교육기관,교육부,추곡초등학교,교육부 강원도교육청 강원도춘천교육지원청 추곡초등학교,12,12,0,12,12,0,0,0
교육기관,교육부,춘성중학교,교육부 강원도교육청 강원도춘천교육지원청 춘성중학교,7,7,0,7,7,0,0,0
교육기관,교육부,춘천계성학교,교육부 강원도교육청 강원도춘천교육지원청 춘천계성학교,23,23,0,23,12,11,0,0
교육기관,교육부,춘천고등학교,교육부 강원도교육청 강원도춘천교육지원청 춘천고등학교,62,62,0,62,17,45,0,0
교육기관,교육부,춘천기계공업고등학교,교육부 강원도교육청 강원도춘천교육지원청 춘천기계공업고등학교,94,94,0,94,70,24,0,0
교육기관,교육부,춘천동원학교,교육부 강원도교육청 강원도춘천교육지원청 춘천동원학교,32,32,0,32,32,0,0,0
교육기관,교육부,춘천삼육초등학교,교육부 강원도교육청 강원도춘천교육지원청 춘천삼육초등학교,74,74,0,74,74,0,0,0
교육기관,교육부,춘천여자고등학교,교육부 강원도교육청 강원도춘천교육지원청 춘천여자고등학교,36,34,2,34,25,5,2,2
교육기관,교육부,춘천초등학교,교육부 강원도교육청 강원도춘천교육지원청 춘천초등학교,9,9,0,9,9,0,0,0
교육기관,교육부,춘천한샘고등학교,교육부 강원도교육청 강원도춘천교육지원청 춘천한샘고등학교,67,67,0,67,0,67,0,0
교육기관,교육부,퇴계중학교,교육부 강원도교육청 강원도춘천교육지원청 퇴계중학교,64,64,0,64,24,40,0,0
교육기관,교육부,한전초등학교,교육부 강원도교육청 강원도춘천교육지원청 한전초등학교,28,28,0,28,22,6,0,0
교육기관,교육부,해안중학교,교육부 강원도교육청 강원도춘천교육지원청 해안중학교,14,14,0,14,0,14,0,0
교육기관,교육부,해안초등학교,교육부 강원도교육청 강원도춘천교육지원청 해안초등학교,10,10,0,10,10,0,0,0
교육기관,교육부,호반초등학교,교육부 강원도교육청 강원도춘천교육지원청 호반초등학교,12,12,0,12,8,4,0,0
교육기관,교육부,효제초등학교,교육부 강원도교육청 강원도춘천교육지원청 효제초등학교,12,12,0,12,4,6,2,0
교육기관,교육부,후평중학교,교육부 강원도교육청 강원도춘천교육지원청 후평중학교,48,48,0,48,47,1,0,0
교육기관,교육부,후평초등학교,교육부 강원도교육청 강원도춘천교육지원청 후평초등학교,47,47,0,47,47,0,0,0
교육기관,교육부,강원도태백교육지원청,교육부 강원도교육청 강원도태백교육지원청,8,8,0,8,0,8,0,0
교육기관,교육부,강원도평창교육지원청,교육부 강원도교육청 강원도평창교육지원청,13,12,1,12,6,6,0,0
교육기관,교육부,대화초등학교,교육부 강원도교육청 강원도평창교육지원청 대화초등학교,10,10,0,10,5,5,0,0
교육기관,교육부,횡계초등학교,교육부 강원도교육청 강원도평창교육지원청 횡계초등학교,17,17,0,17,7,9,0,1
교육기관,교육부,강원도홍천교육지원청,교육부 강원도교육청 강원도홍천교육지원청,12,12,0,12,3,6,3,0
교육기관,교육부,강원생활과학고등학교,교육부 강원도교육청 강원도홍천교육지원청 강원생활과학고등학교,60,24,36,24,20,2,1,1
교육기관,교육부,구송초등학교,교육부 강원도교육청 강원도홍천교육지원청 구송초등학교,8,8,0,8,5,2,1,0
교육기관,교육부,귀둔초등학교,교육부 강원도교육청 강원도홍천교육지원청 귀둔초등학교,9,9,0,9,6,3,0,0
교육기관,교육부,기린고등학교,교육부 강원도교육청 강원도홍천교육지원청 기린고등학교,11,11,0,11,11,0,0,0
교육기관,교육부,기린중학교,교육부 강원도교육청 강원도홍천교육지원청 기린중학교,26,26,0,26,16,10,0,0
교육기관,교육부,기린초등학교,교육부 강원도교육청 강원도홍천교육지원청 기린초등학교,19,19,0,19,19,0,0,0
교육기관,교육부,남산초등학교,교육부 강원도교육청 강원도홍천교육지원청 남산초등학교,16,16,0,16,0,16,0,0
교육기관,교육부,내면중학교,교육부 강원도교육청 강원도홍천교육지원청 내면중학교,5,5,0,5,5,0,0,0
교육기관,교육부,내촌중학교,교육부 강원도교육청 강원도홍천교육지원청 내촌중학교,11,9,2,9,9,0,0,0
교육기관,교육부,내촌초등학교,교육부 강원도교육청 강원도홍천교육지원청 내촌초등학교,12,12,0,12,6,6,0,0
교육기관,교육부,너브내유치원,교육부 강원도교육청 강원도홍천교육지원청 너브내유치원,8,8,0,8,6,2,0,0
교육기관,교육부,대곡초등학교,교육부 강원도교육청 강원도홍천교육지원청 대곡초등학교,14,14,0,14,12,2,0,0
교육기관,교육부,동화중학교,교육부 강원도교육청 강원도홍천교육지원청 동화중학교,4,4,0,4,0,4,0,0
교육기관,교육부,두촌중학교,교육부 강원도교육청 강원도홍천교육지원청 두촌중학교,19,19,0,19,13,6,0,0
교육기관,교육부,두촌초등학교,교육부 강원도교육청 강원도홍천교육지원청 두촌초등학교,15,15,0,15,15,0,0,0
교육기관,교육부,매산초등학교,교육부 강원도교육청 강원도홍천교육지원청 매산초등학교,7,7,0,7,7,0,0,0
교육기관,교육부,명덕초등학교,교육부 강원도교육청 강원도홍천교육지원청 명덕초등학교,17,17,0,17,13,4,0,0
교육기관,교육부,모곡초등학교,교육부 강원도교육청 강원도홍천교육지원청 모곡초등학교,12,12,0,12,4,8,0,0
교육기관,교육부,반곡초등학교,교육부 강원도교육청 강원도홍천교육지원청 반곡초등학교,12,12,0,12,12,0,0,0
교육기관,교육부,부평초등학교,교육부 강원도교육청 강원도홍천교육지원청 부평초등학교,15,15,0,15,11,4,0,0
교육기관,교육부,삼생초등학교,교육부 강원도교육청 강원도홍천교육지원청 삼생초등학교,10,10,0,10,1,9,0,0
교육기관,교육부,삼포초등학교,교육부 강원도교육청 강원도홍천교육지원청 삼포초등학교,8,8,0,8,8,0,0,0
교육기관,교육부,상남중학교,교육부 강원도교육청 강원도홍천교육지원청 상남중학교,13,13,0,13,10,3,0,0
교육기관,교육부,상남초등학교,교육부 강원도교육청 강원도홍천교육지원청 상남초등학교,15,15,0,15,13,2,0,0
교육기관,교육부,서석고등학교,교육부 강원도교육청 강원도홍천교육지원청 서석고등학교,28,28,0,28,0,28,0,0
교육기관,교육부,서석중학교,교육부 강원도교육청 강원도홍천교육지원청 서석중학교,12,0,12,0,0,0,0,0
교육기관,교육부,서석초등학교청량분교장,교육부 강원도교육청 강원도홍천교육지원청 서석초등학교청량분교장,10,10,0,10,4,6,0,0
교육기관,교육부,서화중학교,교육부 강원도교육청 강원도홍천교육지원청 서화중학교,15,15,0,15,15,0,0,0
교육기관,교육부,서화초등학교,교육부 강원도교육청 강원도홍천교육지원청 서화초등학교,19,19,0,19,19,0,0,0
교육기관,교육부,석화초등학교,교육부 강원도교육청 강원도홍천교육지원청 석화초등학교,22,22,0,22,22,0,0,0
교육기관,교육부,속초초등학교,교육부 강원도교육청 강원도홍천교육지원청 속초초등학교,16,16,0,16,16,0,0,0
교육기관,교육부,신남고등학교,교육부 강원도교육청 강원도홍천교육지원청 신남고등학교,18,18,0,18,12,6,0,0
교육기관,교육부,신남중학교,교육부 강원도교육청 강원도홍천교육지원청 신남중학교,15,15,0,15,8,5,1,1
교육기관,교육부,양덕중학교,교육부 강원도교육청 강원도홍천교육지원청 양덕중학교,9,9,0,9,5,4,0,0
교육기관,교육부,어론초등학교,교육부 강원도교육청 강원도홍천교육지원청 어론초등학교,12,12,0,12,10,2,0,0
교육기관,교육부,오안초등학교,교육부 강원도교육청 강원도홍천교육지원청 오안초등학교,13,13,0,13,11,2,0,0
교육기관,교육부,원당초등학교,교육부 강원도교육청 강원도홍천교육지원청 원당초등학교,9,9,0,9,3,6,0,0
교육기관,교육부,원통중학교,교육부 강원도교육청 강원도홍천교육지원청 원통중학교,23,23,0,23,10,13,0,0
교육기관,교육부,원통초등학교,교육부 강원도교육청 강원도홍천교육지원청 원통초등학교,22,22,0,22,19,3,0,0
교육기관,교육부,원통초등학교신덕분교장,교육부 강원도교육청 강원도홍천교육지원청 원통초등학교신덕분교장,1,1,0,1,1,0,0,0
교육기관,교육부,월학초등학교,교육부 강원도교육청 강원도홍천교육지원청 월학초등학교,14,14,0,14,14,0,0,0
교육기관,교육부,율전초등학교,교육부 강원도교육청 강원도홍천교육지원청 율전초등학교,7,7,0,7,7,0,0,0
교육기관,교육부,인제중학교,교육부 강원도교육청 강원도홍천교육지원청 인제중학교,24,24,0,24,24,0,0,0
교육기관,교육부,인제초등학교,교육부 강원도교육청 강원도홍천교육지원청 인제초등학교,19,19,0,19,0,19,0,0
교육기관,교육부,주봉초등학교,교육부 강원도교육청 강원도홍천교육지원청 주봉초등학교,19,19,0,19,14,5,0,0
교육기관,교육부,창촌초등학교,교육부 강원도교육청 강원도홍천교육지원청 창촌초등학교,13,13,0,13,13,0,0,0
교육기관,교육부,팔렬고등학교,교육부 강원도교육청 강원도홍천교육지원청 팔렬고등학교,32,32,0,32,32,0,0,0
교육기관,교육부,팔렬중학교,교육부 강원도교육청 강원도홍천교육지원청 팔렬중학교,20,20,0,20,4,16,0,0
교육기관,교육부,하늘내린유치원,교육부 강원도교육청 강원도홍천교육지원청 하늘내린유치원,14,14,0,14,7,7,0,0
교육기관,교육부,한계초등학교,교육부 강원도교육청 강원도홍천교육지원청 한계초등학교,8,8,0,8,8,0,0,0
교육기관,교육부,한서중학교,교육부 강원도교육청 강원도홍천교육지원청 한서중학교,13,13,0,13,6,7,0,0
교육기관,교육부,한서초등학교,교육부 강원도교육청 강원도홍천교육지원청 한서초등학교,15,15,0,15,15,0,0,0
교육기관,교육부,해밀학교,교육부 강원도교육청 강원도홍천교육지원청 해밀학교,16,16,0,16,3,13,0,0
교육기관,교육부,협신초등학교,교육부 강원도교육청 강원도홍천교육지원청 협신초등학교,14,14,0,14,3,11,0,0
교육기관,교육부,홍천고등학교,교육부 강원도교육청 강원도홍천교육지원청 홍천고등학교,69,37,32,37,0,37,0,0
교육기관,교육부,홍천남산유치원,교육부 강원도교육청 강원도홍천교육지원청 홍천남산유치원,20,20,0,20,4,16,0,0
교육기관,교육부,홍천농업고등학교,교육부 강원도교육청 강원도홍천교육지원청 홍천농업고등학교,101,101,0,101,34,67,0,0
교육기관,교육부,홍천여자고등학교,교육부 강원도교육청 강원도홍천교육지원청 홍천여자고등학교,46,46,0,46,0,46,0,0
교육기관,교육부,홍천중학교,교육부 강원도교육청 강원도홍천교육지원청 홍천중학교,32,32,0,32,0,32,0,0
교육기관,교육부,홍천초등학교,교육부 강원도교육청 강원도홍천교육지원청 홍천초등학교,36,36,0,36,19,17,0,0
교육기관,교육부,화계초등학교,교육부 강원도교육청 강원도홍천교육지원청 화계초등학교,13,13,0,13,7,6,0,0
교육기관,교육부,화촌중학교,교육부 강원도교육청 강원도홍천교육지원청 화촌중학교,13,13,0,13,9,4,0,0
교육기관,교육부,화촌초등학교,교육부 강원도교육청 강원도홍천교육지원청 화촌초등학교,6,6,0,6,6,0,0,0
교육기관,교육부,강원도화천교육지원청,교육부 강원도교육청 강원도화천교육지원청,2,2,0,2,1,1,0,0
교육기관,교육부,간동고등학교,교육부 강원도교육청 강원도화천교육지원청 간동고등학교,16,16,0,16,10,6,0,0
교육기관,교육부,간동중학교,교육부 강원도교육청 강원도화천교육지원청 간동중학교,10,10,0,10,6,4,0,0
교육기관,교육부,광덕초등학교,교육부 강원도교육청 강원도화천교육지원청 광덕초등학교,16,16,0,16,8,8,0,0
교육기관,교육부,근남초등학교,교육부 강원도교육청 강원도화천교육지원청 근남초등학교,13,13,0,13,13,0,0,0
교육기관,교육부,김화고등학교,교육부 강원도교육청 강원도화천교육지원청 김화고등학교,44,0,44,0,0,0,0,0
교육기관,교육부,김화공업고등학교,교육부 강원도교육청 강원도화천교육지원청 김화공업고등학교,32,32,0,32,32,0,0,0
교육기관,교육부,김화여자중학교,교육부 강원도교육청 강원도화천교육지원청 김화여자중학교,7,7,0,7,7,0,0,0
교육기관,교육부,김화중학교,교육부 강원도교육청 강원도화천교육지원청 김화중학교,15,15,0,15,2,13,0,0
교육기관,교육부,김화초등학교,교육부 강원도교육청 강원도화천교육지원청 김화초등학교,12,12,0,12,10,2,0,0
교육기관,교육부,내대초등학교,교육부 강원도교육청 강원도화천교육지원청 내대초등학교,12,12,0,12,6,6,0,0
교육기관,교육부,다목초등학교,교육부 강원도교육청 강원도화천교육지원청 다목초등학교,22,22,0,22,22,0,0,0
교육기관,교육부,문혜초등학교,교육부 강원도교육청 강원도화천교육지원청 문혜초등학교,14,14,0,14,13,1,0,0
교육기관,교육부,봉오초등학교,교육부 강원도교육청 강원도화천교육지원청 봉오초등학교,13,13,0,13,13,0,0,0
교육기관,교육부,사내고등학교,교육부 강원도교육청 강원도화천교육지원청 사내고등학교,31,29,2,29,28,1,0,0
교육기관,교육부,사내중학교,교육부 강원도교육청 강원도화천교육지원청 사내중학교,21,20,1,20,19,0,1,0
교육기관,교육부,사내초등학교,교육부 강원도교육청 강원도화천교육지원청 사내초등학교,13,13,0,13,4,8,1,0
교육기관,교육부,산양초등학교,교육부 강원도교육청 강원도화천교육지원청 산양초등학교,14,14,0,14,7,7,0,0
교육기관,교육부,상승초등학교,교육부 강원도교육청 강원도화천교육지원청 상승초등학교,16,16,0,16,16,0,0,0
교육기관,교육부,서면초등학교,교육부 강원도교육청 강원도화천교육지원청 서면초등학교,15,15,0,15,7,8,0,0
교육기관,교육부,신철원고등학교,교육부 강원도교육청 강원도화천교육지원청 신철원고등학교,56,55,1,55,55,0,0,0
교육기관,교육부,신철원중학교,교육부 강원도교육청 강원도화천교육지원청 신철원중학교,40,39,1,39,36,3,0,0
교육기관,교육부,실내초등학교,교육부 강원도교육청 강원도화천교육지원청 실내초등학교,10,10,0,10,10,0,0,0
교육기관,교육부,오덕초등학교,교육부 강원도교육청 강원도화천교육지원청 오덕초등학교,19,19,0,19,6,13,0,0
교육기관,교육부,오음초등학교,교육부 강원도교육청 강원도화천교육지원청 오음초등학교,7,7,0,7,2,5,0,0
교육기관,교육부,와수초등학교,교육부 강원도교육청 강원도화천교육지원청 와수초등학교,14,14,0,14,14,0,0,0
교육기관,교육부,용암초등학교,교육부 강원도교육청 강원도화천교육지원청 용암초등학교,16,16,0,16,4,12,0,0
교육기관,교육부,용정초등학교,교육부 강원도교육청 강원도화천교육지원청 용정초등학교,15,15,0,15,9,6,0,0
교육기관,교육부,유촌초등학교,교육부 강원도교육청 강원도화천교육지원청 유촌초등학교,16,16,0,16,16,0,0,0
교육기관,교육부,장흥초등학교,교육부 강원도교육청 강원도화천교육지원청 장흥초등학교,12,12,0,12,10,2,0,0
교육기관,교육부,철원고등학교,교육부 강원도교육청 강원도화천교육지원청 철원고등학교,66,66,0,66,0,66,0,0
교육기관,교육부,철원여자고등학교,교육부 강원도교육청 강원도화천교육지원청 철원여자고등학교,17,17,0,17,17,0,0,0
교육기관,교육부,청양초등학교,교육부 강원도교육청 강원도화천교육지원청 청양초등학교,20,20,0,20,0,20,0,0
교육기관,교육부,토성초등학교,교육부 강원도교육청 강원도화천교육지원청 토성초등학교,14,14,0,14,10,4,0,0
교육기관,교육부,풍산초등학교,교육부 강원도교육청 강원도화천교육지원청 풍산초등학교,15,15,0,15,14,1,0,0
교육기관,교육부,화천고등학교,교육부 강원도교육청 강원도화천교육지원청 화천고등학교,50,50,0,50,50,0,0,0
교육기관,교육부,화천유치원,교육부 강원도교육청 강원도화천교육지원청 화천유치원,8,8,0,8,8,0,0,0
교육기관,교육부,화천정보산업고등학교,교육부 강원도교육청 강원도화천교육지원청 화천정보산업고등학교,40,39,1,39,19,20,0,0
교육기관,교육부,화천중학교,교육부 강원도교육청 강원도화천교육지원청 화천중학교,12,12,0,12,5,7,0,0
교육기관,교육부,화천초등학교,교육부 강원도교육청 강원도화천교육지원청 화천초등학교,12,12,0,12,12,0,0,0
교육기관,교육부,강원도횡성교육지원청,교육부 강원도교육청 강원도횡성교육지원청,7,7,0,7,4,3,0,0
교육기관,교육부,갑천고등학교,교육부 강원도교육청 강원도횡성교육지원청 갑천고등학교,18,18,0,18,12,6,0,0
교육기관,교육부,갑천중학교,교육부 강원도교육청 강원도횡성교육지원청 갑천중학교,5,5,0,5,0,5,0,0
교육기관,교육부,갑천초등학교,교육부 강원도교육청 강원도횡성교육지원청 갑천초등학교,8,8,0,8,4,4,0,0
교육기관,교육부,강림초등학교,교육부 강원도교육청 강원도횡성교육지원청 강림초등학교,11,11,0,11,8,3,0,0
교육기관,교육부,강원학생선수촌,교육부 강원도교육청 강원도횡성교육지원청 강원학생선수촌,13,13,0,13,6,7,0,0
교육기관,교육부,거문초등학교,교육부 강원도교육청 강원도횡성교육지원청 거문초등학교,13,13,0,13,3,10,0,0
교육기관,교육부,계촌중학교,교육부 강원도교육청 강원도횡성교육지원청 계촌중학교,10,10,0,10,7,3,0,0
교육기관,교육부,계촌초등학교,교육부 강원도교육청 강원도횡성교육지원청 계촌초등학교,13,13,0,13,8,5,0,0
교육기관,교육부,공근중학교,교육부 강원도교육청 강원도횡성교육지원청 공근중학교,17,12,5,12,6,6,0,0
교육기관,교육부,공근초등학교,교육부 강원도교육청 강원도횡성교육지원청 공근초등학교,15,12,3,12,9,3,0,0
교육기관,교육부,대관령중학교,교육부 강원도교육청 강원도횡성교육지원청 대관령중학교,25,25,0,25,25,0,0,0
교육기관,교육부,대동여자중학교,교육부 강원도교육청 강원도횡성교육지원청 대동여자중학교,16,16,0,16,16,0,0,0
교육기관,교육부,대화고등학교,교육부 강원도교육청 강원도횡성교육지원청 대화고등학교,29,12,17,12,6,6,0,0
교육기관,교육부,대화중학교,교육부 강원도교육청 강원도횡성교육지원청 대화중학교,14,5,9,5,2,1,1,1
교육기관,교육부,도성초등학교,교육부 강원도교육청 강원도횡성교육지원청 도성초등학교,8,8,0,8,6,2,0,0
교육기관,교육부,둔내중학교,교육부 강원도교육청 강원도횡성교육지원청 둔내중학교,10,10,0,10,5,5,0,0
교육기관,교육부,둔내초등학교,교육부 강원도교육청 강원도횡성교육지원청 둔내초등학교,14,14,0,14,0,14,0,0
교육기관,교육부,메밀꽃유치원,교육부 강원도교육청 강원도횡성교육지원청 메밀꽃유치원,15,15,0,15,15,0,0,0
교육기관,교육부,면온초등학교,교육부 강원도교육청 강원도횡성교육지원청 면온초등학교,17,17,0,17,17,0,0,0
교육기관,교육부,미탄중학교,교육부 강원도교육청 강원도횡성교육지원청 미탄중학교,15,15,0,15,14,1,0,0
교육기관,교육부,미탄초등학교,교육부 강원도교육청 강원도횡성교육지원청 미탄초등학교,16,12,4,12,12,0,0,0
교육기관,교육부,방림초등학교,교육부 강원도교육청 강원도횡성교육지원청 방림초등학교,12,12,0,12,12,0,0,0
교육기관,교육부,봉평고등학교,교육부 강원도교육청 강원도횡성교육지원청 봉평고등학교,10,10,0,10,10,0,0,0
교육기관,교육부,봉평중학교,교육부 강원도교육청 강원도횡성교육지원청 봉평중학교,13,13,0,13,13,0,0,0
교육기관,교육부,봉평초등학교,교육부 강원도교육청 강원도횡성교육지원청 봉평초등학교,24,24,0,24,24,0,0,0
교육기관,교육부,상지대관령고등학교,교육부 강원도교육청 강원도횡성교육지원청 상지대관령고등학교,32,32,0,32,32,0,0,0
교육기관,교육부,서원중학교,교육부 강원도교육청 강원도횡성교육지원청 서원중학교,13,13,0,13,13,0,0,0
교육기관,교육부,성남초등학교,교육부 강원도교육청 강원도횡성교육지원청 성남초등학교,10,10,0,10,9,1,0,0
교육기관,교육부,성북초등학교,교육부 강원도교육청 강원도횡성교육지원청 성북초등학교,21,21,0,21,16,5,0,0
교육기관,교육부,속사초등학교,교육부 강원도교육청 강원도횡성교육지원청 속사초등학교,19,19,0,19,19,0,0,0
교육기관,교육부,수백초등학교,교육부 강원도교육청 강원도횡성교육지원청 수백초등학교,10,10,0,10,0,10,0,0
교육기관,교육부,신리초등학교,교육부 강원도교육청 강원도횡성교육지원청 신리초등학교,9,9,0,9,9,0,0,0
교육기관,교육부,안흥고등학교,교육부 강원도교육청 강원도횡성교육지원청 안흥고등학교,13,13,0,13,7,6,0,0
교육기관,교육부,안흥중학교,교육부 강원도교육청 강원도횡성교육지원청 안흥중학교,8,8,0,8,8,0,0,0
교육기관,교육부,안흥초등학교,교육부 강원도교육청 강원도횡성교육지원청 안흥초등학교,12,12,0,12,9,3,0,0
교육기관,교육부,안흥초등학교덕천분교장,교육부 강원도교육청 강원도횡성교육지원청 안흥초등학교덕천분교장,1,1,0,1,0,1,0,0
교육기관,교육부,용전중학교,교육부 강원도교육청 강원도횡성교육지원청 용전중학교,9,9,0,9,6,3,0,0
교육기관,교육부,우천중학교,교육부 강원도교육청 강원도횡성교육지원청 우천중학교,11,11,0,11,11,0,0,0
교육기관,교육부,우천초등학교,교육부 강원도교육청 강원도횡성교육지원청 우천초등학교,12,12,0,12,12,0,0,0
교육기관,교육부,유현초등학교,교육부 강원도교육청 강원도횡성교육지원청 유현초등학교,13,13,0,13,13,0,0,0
교육기관,교육부,이승복기념관,교육부 강원도교육청 강원도횡성교육지원청 이승복기념관,16,16,0,16,0,16,0,0
교육기관,교육부,정금초등학교,교육부 강원도교육청 강원도횡성교육지원청 정금초등학교,21,21,0,21,0,21,0,0
교육기관,교육부,주진초등학교,교육부 강원도교육청 강원도횡성교육지원청 주진초등학교,13,13,0,13,4,9,0,0
교육기관,교육부,진부고등학교,교육부 강원도교육청 강원도횡성교육지원청 진부고등학교,46,46,0,46,25,21,0,0
교육기관,교육부,진부중학교,교육부 강원도교육청 강원도횡성교육지원청 진부중학교,31,31,0,31,17,10,2,2
교육기관,교육부,진부초등학교,교육부 강원도교육청 강원도횡성교육지원청 진부초등학교,24,24,0,24,23,0,1,0
교육기관,교육부,창림초등학교,교육부 강원도교육청 강원도횡성교육지원청 창림초등학교,13,13,0,13,7,6,0,0
교육기관,교육부,청일중학교,교육부 강원도교육청 강원도횡성교육지원청 청일중학교,13,13,0,13,7,6,0,0
교육기관,교육부,청일초등학교,교육부 강원도교육청 강원도횡성교육지원청 청일초등학교,8,8,0,8,4,4,0,0
교육기관,교육부,춘당초등학교,교육부 강원도교육청 강원도횡성교육지원청 춘당초등학교,16,16,0,16,12,4,0,0
교육기관,교육부,평창고등학교,교육부 강원도교육청 강원도횡성교육지원청 평창고등학교,26,26,0,26,26,0,0,0
교육기관,교육부,평창중학교,교육부 강원도교육청 강원도횡성교육지원청 평창중학교,31,31,0,31,2,27,1,1
교육기관,교육부,평창초등학교,교육부 강원도교육청 강원도횡성교육지원청 평창초등학교,29,29,0,29,0,29,0,0
교육기관,교육부,현천고등학교,교육부 강원도교육청 강원도횡성교육지원청 현천고등학교,79,79,0,79,16,63,0,0
교육기관,교육부,횡성고등학교,교육부 강원도교육청 강원도횡성교육지원청 횡성고등학교,56,54,2,54,0,54,0,0
교육기관,교육부,횡성여자고등학교,교육부 강원도교육청 강원도횡성교육지원청 횡성여자고등학교,28,11,17,11,0,11,0,0
교육기관,교육부,횡성중학교,교육부 강원도교육청 강원도횡성교육지원청 횡성중학교,17,17,0,17,4,13,0,0
교육기관,교육부,횡성초등학교,교육부 강원도교육청 강원도횡성교육지원청 횡성초등학교,25,25,0,25,5,20,0,0
교육기관,교육부,강원유아교육진흥원,교육부 강원도교육청 강원유아교육진흥원,26,26,0,26,0,26,0,0
교육기관,교육부,강원진로교육원,교육부 강원도교육청 강원진로교육원,64,64,0,64,0,64,0,0
교육기관,교육부,강원평화교육원,교육부 강원도교육청 강원평화교육원,9,9,0,9,1,8,0,0
교육기관,교육부,강원학생교육원,교육부 강원도교육청 강원학생교육원,37,37,0,37,0,37,0,0
교육기관,교육부,고성교육도서관,교육부 강원도교육청 고성교육도서관,6,6,0,6,6,0,0,0
교육기관,교육부,동해교육도서관,교육부 강원도교육청 동해교육도서관,14,14,0,14,0,14,0,0
교육기관,교육부,명주교육도서관,교육부 강원도교육청 명주교육도서관,11,11,0,11,6,3,2,0
교육기관,교육부,문막교육도서관,교육부 강원도교육청 문막교육도서관,20,20,0,20,0,20,0,0
교육기관,교육부,사임당교육원,교육부 강원도교육청 사임당교육원,26,26,0,26,8,18,0,0
교육기관,교육부,삼척교육문화관,교육부 강원도교육청 삼척교육문화관,20,20,0,20,0,20,0,0
교육기관,교육부,속초교육도서관,교육부 강원도교육청 속초교육도서관,16,16,0,16,8,8,0,0
교육기관,교육부,속초교육문화관,교육부 강원도교육청 속초교육문화관,14,14,0,14,4,10,0,0
교육기관,교육부,양구교육도서관,교육부 강원도교육청 양구교육도서관,16,16,0,16,9,7,0,0
교육기관,교육부,양양교육도서관,교육부 강원도교육청 양양교육도서관,15,15,0,15,0,15,0,0
교육기관,교육부,영월교육도서관,교육부 강원도교육청 영월교육도서관,16,16,0,16,0,16,0,0
교육기관,교육부,원주교육문화관,교육부 강원도교육청 원주교육문화관,81,81,0,81,23,58,0,0
교육기관,교육부,인제교육도서관,교육부 강원도교육청 인제교육도서관,13,13,0,13,0,13,0,0
교육기관,교육부,정선교육도서관,교육부 강원도교육청 정선교육도서관,19,19,0,19,0,19,0,0
교육기관,교육부,철원교육도서관,교육부 강원도교육청 철원교육도서관,23,23,0,23,23,0,0,0
교육기관,교육부,춘성교육도서관,교육부 강원도교육청 춘성교육도서관,16,16,0,16,10,6,0,0
교육기관,교육부,춘천교육문화관,교육부 강원도교육청 춘천교육문화관,48,48,0,48,29,11,8,0
교육기관,교육부,홍천교육도서관,교육부 강원도교육청 춘천교육문화관 홍천교육도서관,23,23,0,23,17,6,0,0
교육기관,교육부,태백교육도서관,교육부 강원도교육청 태백교육도서관,16,16,0,16,0,16,0,0
교육기관,교육부,평창교육도서관,교육부 강원도교육청 평창교육도서관,8,8,0,8,0,8,0,0
교육기관,교육부,화천교육도서관,교육부 강원도교육청 화천교육도서관,21,21,0,21,2,17,2,0
교육기관,교육부,횡성교육도서관,교육부 강원도교육청 횡성교육도서관,0,0,0,0,0,0,0,0
교육기관,교육부,충청북도교육청,교육부 충청북도교육청,95,95,0,95,0,95,0,0
교육기관,교육부,광혜원고등학교,교육부 충청북도교육청 광혜원고등학교,64,64,0,64,32,32,0,0
교육기관,교육부,괴산고등학교,교육부 충청북도교육청 괴산고등학교,69,69,0,69,60,9,0,0
교육기관,교육부,국원고등학교,교육부 충청북도교육청 국원고등학교,166,166,0,166,166,0,0,0
교육기관,교육부,꽃동네학교,교육부 충청북도교육청 꽃동네학교,77,77,0,77,65,12,0,0
교육기관,교육부,단양고등학교,교육부 충청북도교육청 단양고등학교,58,58,0,58,0,58,0,0
교육기관,교육부,단재교육연수원,교육부 충청북도교육청 단재교육연수원,14,14,0,14,0,14,0,0
교육기관,교육부,대금고등학교,교육부 충청북도교육청 대금고등학교,35,35,0,35,0,35,0,0
교육기관,교육부,대성여자상업고등학교,교육부 충청북도교육청 대성여자상업고등학교,41,14,27,14,5,6,3,0
교육기관,교육부,매괴고등학교,교육부 충청북도교육청 매괴고등학교,73,73,0,73,0,73,0,0
교육기관,교육부,보은고등학교,교육부 충청북도교육청 보은고등학교,99,97,2,97,0,97,0,0
교육기관,교육부,보은여자고등학교,교육부 충청북도교육청 보은여자고등학교,29,29,0,29,24,3,1,1
교육기관,교육부,보은정보고등학교,교육부 충청북도교육청 보은정보고등학교,29,15,14,15,5,10,0,0
교육기관,교육부,봉명고등학교,교육부 충청북도교육청 봉명고등학교,67,67,0,67,33,34,0,0
교육기관,교육부,산남고등학교,교육부 충청북도교육청 산남고등학교,52,52,0,52,52,0,0,0
교육기관,교육부,상당고등학교,교육부 충청북도교육청 상당고등학교,61,0,61,0,0,0,0,0
교육기관,교육부,서원고등학교,교육부 충청북도교육청 서원고등학교,65,65,0,65,65,0,0,0
교육기관,교육부,서전고등학교,교육부 충청북도교육청 서전고등학교,75,74,1,74,24,50,0,0
교육기관,교육부,세광고등학교,교육부 충청북도교육청 세광고등학교,37,37,0,37,15,22,0,0
교육기관,교육부,세명고등학교,교육부 충청북도교육청 세명고등학교,58,58,0,58,32,26,0,0
교육기관,교육부,숭덕학교,교육부 충청북도교육청 숭덕학교,35,35,0,35,0,35,0,0
교육기관,교육부,양업고등학교,교육부 충청북도교육청 양업고등학교,34,34,0,34,17,17,0,0
교육기관,교육부,양청고등학교,교육부 충청북도교육청 양청고등학교,72,72,0,72,50,22,0,0
교육기관,교육부,영동고등학교,교육부 충청북도교육청 영동고등학교,50,50,0,50,34,16,0,0
교육기관,교육부,영동미래고등학교,교육부 충청북도교육청 영동미래고등학교,18,18,0,18,0,18,0,0
교육기관,교육부,영동산업과학고등학교,교육부 충청북도교육청 영동산업과학고등학교,64,64,0,64,0,64,0,0
교육기관,교육부,오송고등학교,교육부 충청북도교육청 오송고등학교,53,16,37,16,0,16,0,0
교육기관,교육부,오창고등학교,교육부 충청북도교육청 오창고등학교,52,51,1,51,0,51,0,0
교육기관,교육부,옥천고등학교,교육부 충청북도교육청 옥천고등학교,82,82,0,82,66,16,0,0
교육기관,교육부,운호고등학교,교육부 충청북도교육청 운호고등학교,36,36,0,36,36,0,0,0
교육기관,교육부,음성고등학교,교육부 충청북도교육청 음성고등학교,54,54,0,54,0,54,0,0
교육기관,교육부,이은학교,교육부 충청북도교육청 이은학교,0,0,0,0,0,0,0,0
교육기관,교육부,일신여자고등학교,교육부 충청북도교육청 일신여자고등학교,74,74,0,74,74,0,0,0
교육기관,교육부,제천고등학교,교육부 충청북도교육청 제천고등학교,35,35,0,35,0,35,0,0
교육기관,교육부,제천디지털전자고등학교,교육부 충청북도교육청 제천디지털전자고등학교,39,39,0,39,3,36,0,0
교육기관,교육부,제천산업고등학교,교육부 충청북도교육청 제천산업고등학교,66,66,0,66,66,0,0,0
교육기관,교육부,제천상업고등학교,교육부 충청북도교육청 제천상업고등학교,44,44,0,44,44,0,0,0
교육기관,교육부,제천여자고등학교,교육부 충청북도교육청 제천여자고등학교,63,63,0,63,0,63,0,0
교육기관,교육부,제천제일고등학교,교육부 충청북도교육청 제천제일고등학교,51,51,0,51,51,0,0,0
교육기관,교육부,주성고등학교,교육부 충청북도교육청 주성고등학교,49,49,0,49,7,42,0,0
교육기관,교육부,증평공업고등학교,교육부 충청북도교육청 증평공업고등학교,65,65,0,65,0,65,0,0
교육기관,교육부,증평정보고등학교,교육부 충청북도교육청 증평정보고등학교,49,49,0,49,49,0,0,0
교육기관,교육부,진천고등학교,교육부 충청북도교육청 진천고등학교,58,28,30,28,0,28,0,0
교육기관,교육부,진천상업고등학교,교육부 충청북도교육청 진천상업고등학교,31,31,0,31,13,16,1,1
교육기관,교육부,청산고등학교,교육부 충청북도교육청 청산고등학교,28,28,0,28,28,0,0,0
교육기관,교육부,청석고등학교,교육부 충청북도교육청 청석고등학교,55,54,1,54,33,21,0,0
교육기관,교육부,청암학교,교육부 충청북도교육청 청암학교,10,10,0,10,3,7,0,0
교육기관,교육부,청원고등학교,교육부 충청북도교육청 청원고등학교,84,79,5,79,16,58,5,0
교육기관,교육부,청주고등학교,교육부 충청북도교육청 청주고등학교,89,89,0,89,15,74,0,0
교육기관,교육부,청주농업고등학교,교육부 충청북도교육청 청주농업고등학교,151,150,1,150,94,54,2,0
교육기관,교육부,청주대성고등학교,교육부 충청북도교육청 청주대성고등학교,73,72,1,72,0,72,0,0
교육기관,교육부,청주맹학교,교육부 충청북도교육청 청주맹학교,8,8,0,8,4,4,0,0
교육기관,교육부,청주성신학교,교육부 충청북도교육청 청주성신학교,56,56,0,56,0,56,0,0
교육기관,교육부,청주신흥고등학교,교육부 충청북도교육청 청주신흥고등학교,82,82,0,82,0,82,0,0
교육기관,교육부,청주여자고등학교,교육부 충청북도교육청 청주여자고등학교,45,20,25,20,10,10,0,0
교육기관,교육부,청주여자상업고등학교,교육부 충청북도교육청 청주여자상업고등학교,32,32,0,32,16,16,0,0
교육기관,교육부,청주외국어고등학교,교육부 충청북도교육청 청주외국어고등학교,58,58,0,58,58,0,0,0
교육기관,교육부,청주중앙여자고등학교,교육부 충청북도교육청 청주중앙여자고등학교,38,38,0,38,38,0,0,0
교육기관,교육부,청주하이텍고등학교,교육부 충청북도교육청 청주하이텍고등학교,30,30,0,30,30,0,0,0
교육기관,교육부,청주혜원학교,교육부 충청북도교육청 청주혜원학교,46,46,0,46,46,0,0,0
교육기관,교육부,청주혜화학교,교육부 충청북도교육청 청주혜화학교,11,11,0,11,0,11,0,0
교육기관,교육부,충북고등학교,교육부 충청북도교육청 충북고등학교,62,62,0,62,14,48,0,0
교육기관,교육부,충북공업고등학교,교육부 충청북도교육청 충북공업고등학교,67,67,0,67,63,3,1,0
교육기관,교육부,충북과학고등학교,교육부 충청북도교육청 충북과학고등학교,55,54,1,54,0,54,0,0
교육기관,교육부,충북반도체고등학교,교육부 충청북도교육청 충북반도체고등학교,110,110,0,110,0,110,0,0
교육기관,교육부,충북산업과학고등학교,교육부 충청북도교육청 충북산업과학고등학교,72,72,0,72,0,72,0,0
교육기관,교육부,충북상업정보고등학교,교육부 충청북도교육청 충북상업정보고등학교,73,73,0,73,30,43,0,0
교육기관,교육부,충북생명산업고등학교,교육부 충청북도교육청 충북생명산업고등학교,91,91,0,91,47,44,0,0
교육기관,교육부,충북에너지고등학교,교육부 충청북도교육청 충북에너지고등학교,86,86,0,86,20,66,0,0
교육기관,교육부,충북여자고등학교,교육부 충청북도교육청 충북여자고등학교,43,6,37,6,2,2,1,1
교육기관,교육부,충북예술고등학교,교육부 충청북도교육청 충북예술고등학교,32,32,0,32,0,32,0,0
교육기관,교육부,충북체육고등학교,교육부 충청북도교육청 충북체육고등학교,78,78,0,78,0,78,0,0
교육기관,교육부,충원고등학교,교육부 충청북도교육청 충원고등학교,60,58,2,58,23,30,3,2
교육기관,교육부,충주고등학교,교육부 충청북도교육청 충주고등학교,50,50,0,50,22,28,0,0
교육기관,교육부,충주공업고등학교,교육부 충청북도교육청 충주공업고등학교,48,48,0,48,0,48,0,0
교육기관,교육부,충주대원고등학교,교육부 충청북도교육청 충주대원고등학교,42,22,20,22,6,16,0,0
교육기관,교육부,충주상업고등학교,교육부 충청북도교육청 충주상업고등학교,17,17,0,17,13,4,0,0
교육기관,교육부,충주성모학교,교육부 충청북도교육청 충주성모학교,33,33,0,33,0,33,0,0
교육기관,교육부,충주성심학교,교육부 충청북도교육청 충주성심학교,32,32,0,32,32,0,0,0
교육기관,교육부,충주여자고등학교,교육부 충청북도교육청 충주여자고등학교,39,15,24,15,15,0,0,0
교육기관,교육부,충주예성여자고등학교,교육부 충청북도교육청 충주예성여자고등학교,58,58,0,58,30,28,0,0
교육기관,교육부,충주혜성학교,교육부 충청북도교육청 충주혜성학교,29,29,0,29,0,29,0,0
교육기관,교육부,충청북도괴산증평교육지원청,교육부 충청북도교육청 충청북도괴산증평교육지원청,9,9,0,9,0,9,0,0
교육기관,교육부,감물초등학교,교육부 충청북도교육청 충청북도괴산증평교육지원청 감물초등학교,21,21,0,21,5,16,0,0
교육기관,교육부,괴산교육도서관,교육부 충청북도교육청 충청북도괴산증평교육지원청 괴산교육도서관,9,9,0,9,0,9,0,0
교육기관,교육부,괴산명덕초등학교,교육부 충청북도교육청 충청북도괴산증평교육지원청 괴산명덕초등학교,17,17,0,17,7,10,0,0
교육기관,교육부,괴산북중학교,교육부 충청북도교육청 충청북도괴산증평교육지원청 괴산북중학교,24,24,0,24,10,14,0,0
교육기관,교육부,괴산오성중학교,교육부 충청북도교육청 충청북도괴산증평교육지원청 괴산오성중학교,64,64,0,64,0,64,0,0
교육기관,교육부,괴산중학교,교육부 충청북도교육청 충청북도괴산증평교육지원청 괴산중학교,27,27,0,27,0,27,0,0
교육기관,교육부,도안초등학교,교육부 충청북도교육청 충청북도괴산증평교육지원청 도안초등학교,13,13,0,13,0,13,0,0
교육기관,교육부,동인초등학교,교육부 충청북도교육청 충청북도괴산증평교육지원청 동인초등학교,16,16,0,16,3,13,0,0
교육기관,교육부,목도초등학교,교육부 충청북도교육청 충청북도괴산증평교육지원청 목도초등학교,12,12,0,12,12,0,0,0
교육기관,교육부,문광초등학교,교육부 충청북도교육청 충청북도괴산증평교육지원청 문광초등학교,11,11,0,11,11,0,0,0
교육기관,교육부,백봉초등학교,교육부 충청북도교육청 충청북도괴산증평교육지원청 백봉초등학교,26,26,0,26,26,0,0,0
교육기관,교육부,보광초등학교,교육부 충청북도교육청 충청북도괴산증평교육지원청 보광초등학교,16,16,0,16,16,0,0,0
교육기관,교육부,삼보초등학교,교육부 충청북도교육청 충청북도괴산증평교육지원청 삼보초등학교,22,22,0,22,0,22,0,0
교육기관,교육부,소수초등학교,교육부 충청북도교육청 충청북도괴산증평교육지원청 소수초등학교,8,8,0,8,4,4,0,0
교육기관,교육부,송면중학교,교육부 충청북도교육청 충청북도괴산증평교육지원청 송면중학교,15,15,0,15,15,0,0,0
교육기관,교육부,송면초등학교,교육부 충청북도교육청 충청북도괴산증평교육지원청 송면초등학교,13,13,0,13,0,13,0,0
교육기관,교육부,연풍중학교,교육부 충청북도교육청 충청북도괴산증평교육지원청 연풍중학교,21,21,0,21,8,13,0,0
교육기관,교육부,연풍초등학교,교육부 충청북도교육청 충청북도괴산증평교육지원청 연풍초등학교,33,33,0,33,24,9,0,0
교육기관,교육부,장연초등학교,교육부 충청북도교육청 충청북도괴산증평교육지원청 장연초등학교,14,14,0,14,11,3,0,0
교육기관,교육부,죽리초등학교,교육부 충청북도교육청 충청북도괴산증평교육지원청 죽리초등학교,14,14,0,14,7,7,0,0
교육기관,교육부,증평교육도서관,교육부 충청북도교육청 충청북도괴산증평교육지원청 증평교육도서관,22,22,0,22,0,22,0,0
교육기관,교육부,증평여자중학교,교육부 충청북도교육청 충청북도괴산증평교육지원청 증평여자중학교,38,38,0,38,38,0,0,0
교육기관,교육부,증평중학교,교육부 충청북도교육청 충청북도괴산증평교육지원청 증평중학교,48,48,0,48,48,0,0,0
교육기관,교육부,증평초등학교,교육부 충청북도교육청 충청북도괴산증평교육지원청 증평초등학교,76,76,0,76,44,32,0,0
교육기관,교육부,청안중학교,교육부 충청북도교육청 충청북도괴산증평교육지원청 청안중학교,9,9,0,9,5,4,0,0
교육기관,교육부,청안초등학교,교육부 충청북도교육청 충청북도괴산증평교육지원청 청안초등학교,15,15,0,15,15,0,0,0
교육기관,교육부,청천중학교,교육부 충청북도교육청 충청북도괴산증평교육지원청 청천중학교,22,22,0,22,9,11,1,1
교육기관,교육부,청천초등학교,교육부 충청북도교육청 충청북도괴산증평교육지원청 청천초등학교,11,11,0,11,7,4,0,0
교육기관,교육부,칠성중학교,교육부 충청북도교육청 충청북도괴산증평교육지원청 칠성중학교,12,12,0,12,12,0,0,0
교육기관,교육부,칠성초등학교,교육부 충청북도교육청 충청북도괴산증평교육지원청 칠성초등학교,11,11,0,11,6,5,0,0
교육기관,교육부,형석중학교,교육부 충청북도교육청 충청북도괴산증평교육지원청 형석중학교,25,25,0,25,19,6,0,0
교육기관,교육부,충청북도교육도서관,교육부 충청북도교육청 충청북도교육도서관,34,34,0,34,0,34,0,0
교육기관,교육부,진천문학관,교육부 충청북도교육청 충청북도교육도서관 진천문학관,16,16,0,16,0,16,0,0
교육기관,교육부,충청북도교육문화원,교육부 충청북도교육청 충청북도교육문화원,107,107,0,107,107,0,0,0
교육기관,교육부,충청북도교육연구정보원,교육부 충청북도교육청 충청북도교육연구정보원,31,31,0,31,0,31,0,0
교육기관,교육부,충청북도국제교육원,교육부 충청북도교육청 충청북도국제교육원,91,91,0,91,0,91,0,0
교육기관,교육부,남부분원,교육부 충청북도교육청 충청북도국제교육원 남부분원,8,8,0,8,0,8,0,0
교육기관,교육부,충청북도단양교육지원청,교육부 충청북도교육청 충청북도단양교육지원청,8,8,0,8,0,8,0,0
교육기관,교육부,가곡초등학교,교육부 충청북도교육청 충청북도단양교육지원청 가곡초등학교,21,21,0,21,15,4,1,1
교육기관,교육부,가곡초등학교대곡분교장,교육부 충청북도교육청 충청북도단양교육지원청 가곡초등학교대곡분교장,0,0,0,0,0,0,0,0
교육기관,교육부,가곡초등학교보발분교장,교육부 충청북도교육청 충청북도단양교육지원청 가곡초등학교보발분교장,0,0,0,0,0,0,0,0
교육기관,교육부,가평초등학교,교육부 충청북도교육청 충청북도단양교육지원청 가평초등학교,9,9,0,9,0,9,0,0
교육기관,교육부,단성중학교,교육부 충청북도교육청 충청북도단양교육지원청 단성중학교,27,13,14,13,0,13,0,0
교육기관,교육부,단양교육도서관,교육부 충청북도교육청 충청북도단양교육지원청 단양교육도서관,3,3,0,3,0,3,0,0
교육기관,교육부,단양소백산중학교,교육부 충청북도교육청 충청북도단양교육지원청 단양소백산중학교,50,14,36,14,7,7,0,0
교육기관,교육부,단양유치원,교육부 충청북도교육청 충청북도단양교육지원청 단양유치원,10,10,0,10,0,10,0,0
교육기관,교육부,단양중학교,교육부 충청북도교육청 충청북도단양교육지원청 단양중학교,53,53,0,53,14,39,0,0
교육기관,교육부,단양초등학교,교육부 충청북도교육청 충청북도단양교육지원청 단양초등학교,16,16,0,16,4,12,0,0
교육기관,교육부,단천초등학교,교육부 충청북도교육청 충청북도단양교육지원청 단천초등학교,9,9,0,9,0,9,0,0
교육기관,교육부,대가초등학교,교육부 충청북도교육청 충청북도단양교육지원청 대가초등학교,10,10,0,10,8,2,0,0
교육기관,교육부,대강초등학교,교육부 충청북도교육청 충청북도단양교육지원청 대강초등학교,14,14,0,14,8,6,0,0
교육기관,교육부,매포중학교,교육부 충청북도교육청 충청북도단양교육지원청 매포중학교,20,20,0,20,10,10,0,0
교육기관,교육부,매포초등학교,교육부 충청북도교육청 충청북도단양교육지원청 매포초등학교,26,26,0,26,13,13,0,0
교육기관,교육부,상진초등학교,교육부 충청북도교육청 충청북도단양교육지원청 상진초등학교,24,24,0,24,24,0,0,0
교육기관,교육부,어상천초등학교,교육부 충청북도교육청 충청북도단양교육지원청 어상천초등학교,9,9,0,9,5,4,0,0
교육기관,교육부,영춘중학교,교육부 충청북도교육청 충청북도단양교육지원청 영춘중학교,8,8,0,8,4,4,0,0
교육기관,교육부,영춘초등학교,교육부 충청북도교육청 충청북도단양교육지원청 영춘초등학교,11,11,0,11,11,0,0,0
교육기관,교육부,영춘초등학교별방분교장,교육부 충청북도교육청 충청북도단양교육지원청 영춘초등학교별방분교장,6,6,0,6,2,4,0,0
교육기관,교육부,충청북도보은교육지원청,교육부 충청북도교육청 충청북도보은교육지원청,20,20,0,20,0,20,0,0
교육기관,교육부,관기초등학교,교육부 충청북도교육청 충청북도보은교육지원청 관기초등학교,9,9,0,9,6,3,0,0
교육기관,교육부,내북초등학교,교육부 충청북도교육청 충청북도보은교육지원청 내북초등학교,19,19,0,19,19,0,0,0
교육기관,교육부,동광초등학교,교육부 충청북도교육청 충청북도보은교육지원청 동광초등학교,36,36,0,36,36,0,0,0
교육기관,교육부,보덕중학교,교육부 충청북도교육청 충청북도보은교육지원청 보덕중학교,14,14,0,14,7,7,0,0
교육기관,교육부,보은교육도서관,교육부 충청북도교육청 충청북도보은교육지원청 보은교육도서관,13,13,0,13,13,0,0,0
교육기관,교육부,보은삼산초등학교,교육부 충청북도교육청 충청북도보은교육지원청 보은삼산초등학교,31,31,0,31,13,18,0,0
교육기관,교육부,보은여자중학교,교육부 충청북도교육청 충청북도보은교육지원청 보은여자중학교,21,21,0,21,10,11,0,0
교육기관,교육부,보은중학교,교육부 충청북도교육청 충청북도보은교육지원청 보은중학교,36,35,1,35,17,18,0,0
교육기관,교육부,산외초등학교,교육부 충청북도교육청 충청북도보은교육지원청 산외초등학교,18,18,0,18,0,18,0,0
교육기관,교육부,세중초등학교,교육부 충청북도교육청 충청북도보은교육지원청 세중초등학교,17,17,0,17,17,0,0,0
교육기관,교육부,속리산중학교,교육부 충청북도교육청 충청북도보은교육지원청 속리산중학교,75,75,0,75,0,75,0,0
교육기관,교육부,속리초등학교,교육부 충청북도교육청 충청북도보은교육지원청 속리초등학교,16,16,0,16,8,8,0,0
교육기관,교육부,수정초등학교,교육부 충청북도교육청 충청북도보은교육지원청 수정초등학교,12,12,0,12,6,6,0,0
교육기관,교육부,수한초등학교,교육부 충청북도교육청 충청북도보은교육지원청 수한초등학교,8,8,0,8,8,0,0,0
교육기관,교육부,종곡초등학교,교육부 충청북도교육청 충청북도보은교육지원청 종곡초등학교,12,12,0,12,4,8,0,0
교육기관,교육부,탄부초등학교,교육부 충청북도교육청 충청북도보은교육지원청 탄부초등학교,7,7,0,7,3,4,0,0
교육기관,교육부,판동초등학교,교육부 충청북도교육청 충청북도보은교육지원청 판동초등학교,17,17,0,17,0,17,0,0
교육기관,교육부,회남초등학교,교육부 충청북도교육청 충청북도보은교육지원청 회남초등학교,16,16,0,16,13,3,0,0
교육기관,교육부,회인중학교,교육부 충청북도교육청 충청북도보은교육지원청 회인중학교,16,15,1,15,7,8,0,0
교육기관,교육부,회인초등학교,교육부 충청북도교육청 충청북도보은교육지원청 회인초등학교,4,4,0,4,2,2,0,0
교육기관,교육부,충청북도영동교육지원청,교육부 충청북도교육청 충청북도영동교육지원청,18,18,0,18,0,18,0,0
교육기관,교육부,구룡초등학교,교육부 충청북도교육청 충청북도영동교육지원청 구룡초등학교,20,20,0,20,10,10,0,0
교육기관,교육부,매곡초등학교,교육부 충청북도교육청 충청북도영동교육지원청 매곡초등학교,8,8,0,8,4,4,0,0
교육기관,교육부,부용초등학교,교육부 충청북도교육청 충청북도영동교육지원청 부용초등학교,14,14,0,14,14,0,0,0
교육기관,교육부,상촌초등학교,교육부 충청북도교육청 충청북도영동교육지원청 상촌초등학교,20,20,0,20,0,20,0,0
교육기관,교육부,새너울중학교,교육부 충청북도교육청 충청북도영동교육지원청 새너울중학교,79,79,0,79,30,49,0,0
교육기관,교육부,심천중학교,교육부 충청북도교육청 충청북도영동교육지원청 심천중학교,8,8,0,8,8,0,0,0
교육기관,교육부,심천초등학교,교육부 충청북도교육청 충청북도영동교육지원청 심천초등학교,12,12,0,12,12,0,0,0
교육기관,교육부,양강초등학교,교육부 충청북도교육청 충청북도영동교육지원청 양강초등학교,15,15,0,15,15,0,0,0
교육기관,교육부,양산초등학교,교육부 충청북도교육청 충청북도영동교육지원청 양산초등학교,8,8,0,8,3,5,0,0
교육기관,교육부,영동교육도서관,교육부 충청북도교육청 충청북도영동교육지원청 영동교육도서관,24,24,0,24,0,24,0,0
교육기관,교육부,영동유치원,교육부 충청북도교육청 충청북도영동교육지원청 영동유치원,28,28,0,28,17,11,0,0
교육기관,교육부,영동중학교,교육부 충청북도교육청 충청북도영동교육지원청 영동중학교,47,47,0,47,25,22,0,0
교육기관,교육부,영동초등학교,교육부 충청북도교육청 충청북도영동교육지원청 영동초등학교,23,23,0,23,10,13,0,0
교육기관,교육부,영신중학교,교육부 충청북도교육청 충청북도영동교육지원청 영신중학교,25,25,0,25,25,0,0,0
교육기관,교육부,용화초등학교,교육부 충청북도교육청 충청북도영동교육지원청 용화초등학교,20,20,0,20,12,8,0,0
교육기관,교육부,이수초등학교,교육부 충청북도교육청 충청북도영동교육지원청 이수초등학교,31,31,0,31,29,2,0,0
교육기관,교육부,정수중학교,교육부 충청북도교육청 충청북도영동교육지원청 정수중학교,6,6,0,6,3,3,0,0
교육기관,교육부,초강초등학교,교육부 충청북도교육청 충청북도영동교육지원청 초강초등학교,12,12,0,12,12,0,0,0
교육기관,교육부,추풍령중학교,교육부 충청북도교육청 충청북도영동교육지원청 추풍령중학교,11,11,0,11,8,3,0,0
교육기관,교육부,추풍령초등학교,교육부 충청북도교육청 충청북도영동교육지원청 추풍령초등학교,25,25,0,25,16,9,0,0
교육기관,교육부,학산초등학교,교육부 충청북도교육청 충청북도영동교육지원청 학산초등학교,13,12,1,12,12,0,0,0
교육기관,교육부,황간초등학교,교육부 충청북도교육청 충청북도영동교육지원청 황간초등학교,16,16,0,16,11,5,0,0
교육기관,교육부,충청북도옥천교육지원청,교육부 충청북도교육청 충청북도옥천교육지원청,15,15,0,15,0,15,0,0
교육기관,교육부,군남초등학교,교육부 충청북도교육청 충청북도옥천교육지원청 군남초등학교,16,16,0,16,12,4,0,0
교육기관,교육부,군서초등학교,교육부 충청북도교육청 충청북도옥천교육지원청 군서초등학교,22,22,0,22,2,18,2,0
교육기관,교육부,동이초등학교,교육부 충청북도교육청 충청북도옥천교육지원청 동이초등학교,22,22,0,22,6,16,0,0
교육기관,교육부,삼양유치원,교육부 충청북도교육청 충청북도옥천교육지원청 삼양유치원,16,16,0,16,0,16,0,0
교육기관,교육부,삼양초등학교,교육부 충청북도교육청 충청북도옥천교육지원청 삼양초등학교,35,34,1,34,24,10,0,0
교육기관,교육부,안남초등학교,교육부 충청북도교육청 충청북도옥천교육지원청 안남초등학교,9,9,0,9,9,0,0,0
교육기관,교육부,안내중학교,교육부 충청북도교육청 충청북도옥천교육지원청 안내중학교,20,18,2,18,9,9,0,0
교육기관,교육부,안내초등학교,교육부 충청북도교육청 충청북도옥천교육지원청 안내초등학교,21,21,0,21,21,0,0,0
교육기관,교육부,옥천교육도서관,교육부 충청북도교육청 충청북도옥천교육지원청 옥천교육도서관,23,23,0,23,18,5,0,0
교육기관,교육부,옥천여자중학교,교육부 충청북도교육청 충청북도옥천교육지원청 옥천여자중학교,48,48,0,48,48,0,0,0
교육기관,교육부,옥천중학교,교육부 충청북도교육청 충청북도옥천교육지원청 옥천중학교,56,56,0,56,0,56,0,0
교육기관,교육부,이원중학교,교육부 충청북도교육청 충청북도옥천교육지원청 이원중학교,24,24,0,24,0,24,0,0
교육기관,교육부,이원초등학교,교육부 충청북도교육청 충청북도옥천교육지원청 이원초등학교,29,29,0,29,29,0,0,0
교육기관,교육부,장야초등학교,교육부 충청북도교육청 충청북도옥천교육지원청 장야초등학교,29,29,0,29,16,13,0,0
교육기관,교육부,죽향초등학교,교육부 충청북도교육청 충청북도옥천교육지원청 죽향초등학교,30,30,0,30,15,15,0,0
교육기관,교육부,증약초등학교,교육부 충청북도교육청 충청북도옥천교육지원청 증약초등학교,16,16,0,16,4,12,0,0
교육기관,교육부,청산중학교,교육부 충청북도교육청 충청북도옥천교육지원청 청산중학교,11,11,0,11,5,6,0,0
교육기관,교육부,청산초등학교,교육부 충청북도교육청 충청북도옥천교육지원청 청산초등학교,10,10,0,10,4,6,0,0
교육기관,교육부,청성초등학교,교육부 충청북도교육청 충청북도옥천교육지원청 청성초등학교,10,10,0,10,10,0,0,0
교육기관,교육부,충청북도유아교육진흥원,교육부 충청북도교육청 충청북도유아교육진흥원,35,35,0,35,0,35,0,0
교육기관,교육부,충청북도음성교육지원청,교육부 충청북도교육청 충청북도음성교육지원청,8,8,0,8,5,3,0,0
교육기관,교육부,감곡중학교,교육부 충청북도교육청 충청북도음성교육지원청 감곡중학교,16,16,0,16,6,10,0,0
교육기관,교육부,감곡초등학교,교육부 충청북도교육청 충청북도음성교육지원청 감곡초등학교,17,17,0,17,8,9,0,0
교육기관,교육부,금왕교육도서관,교육부 충청북도교육청 충청북도음성교육지원청 금왕교육도서관,23,23,0,23,0,23,0,0
교육기관,교육부,금왕유치원,교육부 충청북도교육청 충청북도음성교육지원청 금왕유치원,20,20,0,20,12,8,0,0
교육기관,교육부,남신초등학교,교육부 충청북도교육청 충청북도음성교육지원청 남신초등학교,8,8,0,8,0,8,0,0
교육기관,교육부,대소유치원,교육부 충청북도교육청 충청북도음성교육지원청 대소유치원,11,11,0,11,0,11,0,0
교육기관,교육부,대소중학교,교육부 충청북도교육청 충청북도음성교육지원청 대소중학교,40,40,0,40,10,30,0,0
교육기관,교육부,대소초등학교,교육부 충청북도교육청 충청북도음성교육지원청 대소초등학교,27,27,0,27,10,17,0,0
교육기관,교육부,동성유치원,교육부 충청북도교육청 충청북도음성교육지원청 동성유치원,14,14,0,14,10,4,0,0
교육기관,교육부,동성중학교,교육부 충청북도교육청 충청북도음성교육지원청 동성중학교,34,21,13,21,5,16,0,0
교육기관,교육부,동성초등학교,교육부 충청북도교육청 충청북도음성교육지원청 동성초등학교,47,47,0,47,37,10,0,0
교육기관,교육부,매괴여자중학교,교육부 충청북도교육청 충청북도음성교육지원청 매괴여자중학교,73,73,0,73,0,73,0,0
교육기관,교육부,맹동초등학교,교육부 충청북도교육청 충청북도음성교육지원청 맹동초등학교,28,28,0,28,28,0,0,0
교육기관,교육부,무극중학교,교육부 충청북도교육청 충청북도음성교육지원청 무극중학교,48,48,0,48,24,24,0,0
교육기관,교육부,무극초등학교,교육부 충청북도교육청 충청북도음성교육지원청 무극초등학교,20,20,0,20,20,0,0,0
교육기관,교육부,부윤초등학교,교육부 충청북도교육청 충청북도음성교육지원청 부윤초등학교,19,19,0,19,3,15,1,0
교육기관,교육부,삼성중학교,교육부 충청북도교육청 충청북도음성교육지원청 삼성중학교,30,30,0,30,10,20,0,0
교육기관,교육부,삼성초등학교,교육부 충청북도교육청 충청북도음성교육지원청 삼성초등학교,25,25,0,25,25,0,0,0
교육기관,교육부,생극중학교,교육부 충청북도교육청 충청북도음성교육지원청 생극중학교,17,14,3,14,0,14,0,0
교육기관,교육부,생극초등학교,교육부 충청북도교육청 충청북도음성교육지원청 생극초등학교,24,24,0,24,0,24,0,0
교육기관,교육부,소이초등학교,교육부 충청북도교육청 충청북도음성교육지원청 소이초등학교,26,26,0,26,26,0,0,0
교육기관,교육부,수봉초등학교,교육부 충청북도교육청 충청북도음성교육지원청 수봉초등학교,36,36,0,36,36,0,0,0
교육기관,교육부,쌍봉초등학교,교육부 충청북도교육청 충청북도음성교육지원청 쌍봉초등학교,22,22,0,22,22,0,0,0
교육기관,교육부,오갑초등학교,교육부 충청북도교육청 충청북도음성교육지원청 오갑초등학교,17,17,0,17,4,13,0,0
교육기관,교육부,오선초등학교,교육부 충청북도교육청 충청북도음성교육지원청 오선초등학교,13,13,0,13,10,3,0,0
교육기관,교육부,용천초등학교,교육부 충청북도교육청 충청북도음성교육지원청 용천초등학교,32,28,4,28,24,4,0,0
교육기관,교육부,원남초등학교,교육부 충청북도교육청 충청북도음성교육지원청 원남초등학교,20,20,0,20,20,0,0,0
교육기관,교육부,원당초등학교,교육부 충청북도교육청 충청북도음성교육지원청 원당초등학교,27,16,11,16,16,0,0,0
교육기관,교육부,음성교육도서관,교육부 충청북도교육청 충청북도음성교육지원청 음성교육도서관,20,20,0,20,3,17,0,0
교육기관,교육부,음성여자중학교,교육부 충청북도교육청 충청북도음성교육지원청 음성여자중학교,22,22,0,22,0,22,0,0
교육기관,교육부,음성중학교,교육부 충청북도교육청 충청북도음성교육지원청 음성중학교,34,16,18,16,8,8,0,0
교육기관,교육부,청룡초등학교,교육부 충청북도교육청 충청북도음성교육지원청 청룡초등학교,21,21,0,21,0,21,0,0
교육기관,교육부,평곡초등학교,교육부 충청북도교육청 충청북도음성교육지원청 평곡초등학교,18,18,0,18,18,0,0,0
교육기관,교육부,하당초등학교,교육부 충청북도교육청 충청북도음성교육지원청 하당초등학교,14,14,0,14,14,0,0,0
교육기관,교육부,한일중학교,교육부 충청북도교육청 충청북도음성교육지원청 한일중학교,8,8,0,8,8,0,0,0
교육기관,교육부,충청북도자연과학교육원,교육부 충청북도교육청 충청북도자연과학교육원,146,141,5,141,0,141,0,0
교육기관,교육부,충청북도제천교육지원청,교육부 충청북도교육청 충청북도제천교육지원청,27,27,0,27,0,27,0,0
교육기관,교육부,금성초등학교,교육부 충청북도교육청 충청북도제천교육지원청 금성초등학교,13,13,0,13,0,13,0,0
교육기관,교육부,남당초등학교,교육부 충청북도교육청 충청북도제천교육지원청 남당초등학교,18,18,0,18,12,6,0,0
교육기관,교육부,남천초등학교,교육부 충청북도교육청 충청북도제천교육지원청 남천초등학교,18,14,4,14,10,4,0,0
교육기관,교육부,내토중학교,교육부 충청북도교육청 충청북도제천교육지원청 내토중학교,28,28,0,28,28,0,0,0
교육기관,교육부,내토초등학교,교육부 충청북도교육청 충청북도제천교육지원청 내토초등학교,20,20,0,20,12,8,0,0
교육기관,교육부,대제중학교,교육부 충청북도교육청 충청북도제천교육지원청 대제중학교,34,34,0,34,0,34,0,0
교육기관,교육부,동명초등학교,교육부 충청북도교육청 충청북도제천교육지원청 동명초등학교,20,20,0,20,0,20,0,0
교육기관,교육부,두학초등학교,교육부 충청북도교육청 충청북도제천교육지원청 두학초등학교,12,12,0,12,10,2,0,0
교육기관,교육부,명지초등학교,교육부 충청북도교육청 충청북도제천교육지원청 명지초등학교,27,27,0,27,27,0,0,0
교육기관,교육부,백운중학교,교육부 충청북도교육청 충청북도제천교육지원청 백운중학교,10,10,0,10,10,0,0,0
교육기관,교육부,백운초등학교,교육부 충청북도교육청 충청북도제천교육지원청 백운초등학교,13,13,0,13,13,0,0,0
교육기관,교육부,봉양중학교,교육부 충청북도교육청 충청북도제천교육지원청 봉양중학교,9,9,0,9,4,5,0,0
교육기관,교육부,봉양초등학교,교육부 충청북도교육청 충청북도제천교육지원청 봉양초등학교,10,10,0,10,10,0,0,0
교육기관,교육부,송학중학교,교육부 충청북도교육청 충청북도제천교육지원청 송학중학교,22,22,0,22,15,3,2,2
교육기관,교육부,송학초등학교,교육부 충청북도교육청 충청북도제천교육지원청 송학초등학교,16,16,0,16,16,0,0,0
교육기관,교육부,수산초등학교,교육부 충청북도교육청 충청북도제천교육지원청 수산초등학교,16,16,0,16,0,16,0,0
교육기관,교육부,신백초등학교,교육부 충청북도교육청 충청북도제천교육지원청 신백초등학교,38,38,0,38,8,30,0,0
교육기관,교육부,왕미초등학교,교육부 충청북도교육청 충청북도제천교육지원청 왕미초등학교,9,9,0,9,5,4,0,0
교육기관,교육부,용두초등학교,교육부 충청북도교육청 충청북도제천교육지원청 용두초등학교,26,26,0,26,0,26,0,0
교육기관,교육부,의림여자중학교,교육부 충청북도교육청 충청북도제천교육지원청 의림여자중학교,32,32,0,32,16,16,0,0
교육기관,교육부,의림유치원,교육부 충청북도교육청 충청북도제천교육지원청 의림유치원,11,11,0,11,4,7,0,0
교육기관,교육부,의림초등학교,교육부 충청북도교육청 충청북도제천교육지원청 의림초등학교,23,23,0,23,3,20,0,0
교육기관,교육부,장락초등학교,교육부 충청북도교육청 충청북도제천교육지원청 장락초등학교,24,24,0,24,0,24,0,0
교육기관,교육부,제천덕산초등학교,교육부 충청북도교육청 충청북도제천교육지원청 제천덕산초등학교,13,12,1,12,12,0,0,0
교육기관,교육부,제천동중학교,교육부 충청북도교육청 충청북도제천교육지원청 제천동중학교,33,33,0,33,13,20,0,0
교육기관,교육부,제천여자중학교,교육부 충청북도교육청 충청북도제천교육지원청 제천여자중학교,32,12,20,12,8,4,0,0
교육기관,교육부,제천중앙초등학교,교육부 충청북도교육청 충청북도제천교육지원청 제천중앙초등학교,26,26,0,26,22,4,0,0
교육기관,교육부,제천중학교,교육부 충청북도교육청 충청북도제천교육지원청 제천중학교,51,51,0,51,37,14,0,0
교육기관,교육부,제천학생회관,교육부 충청북도교육청 충청북도제천교육지원청 제천학생회관,19,19,0,19,10,9,0,0
교육기관,교육부,청풍초등학교,교육부 충청북도교육청 충청북도제천교육지원청 청풍초등학교,10,10,0,10,0,10,0,0
교육기관,교육부,한송초등학교,교육부 충청북도교육청 충청북도제천교육지원청 한송초등학교,18,18,0,18,0,18,0,0
교육기관,교육부,홍광유치원,교육부 충청북도교육청 충청북도제천교육지원청 홍광유치원,9,7,2,7,2,5,0,0
교육기관,교육부,홍광초등학교,교육부 충청북도교육청 충청북도제천교육지원청 홍광초등학교,16,16,0,16,11,5,0,0
교육기관,교육부,화당초등학교,교육부 충청북도교육청 충청북도제천교육지원청 화당초등학교,19,19,0,19,12,7,0,0
교육기관,교육부,화산초등학교,교육부 충청북도교육청 충청북도제천교육지원청 화산초등학교,16,16,0,16,12,4,0,0
교육기관,교육부,충청북도중원교육문화원,교육부 충청북도교육청 충청북도중원교육문화원,59,59,0,59,0,59,0,0
교육기관,교육부,충청북도진로교육원,교육부 충청북도교육청 충청북도진로교육원,34,34,0,34,0,34,0,0
교육기관,교육부,충청북도진천교육지원청,교육부 충청북도교육청 충청북도진천교육지원청,18,18,0,18,11,7,0,0
교육기관,교육부,광혜원중학교,교육부 충청북도교육청 충청북도진천교육지원청 광혜원중학교,44,44,0,44,26,18,0,0
교육기관,교육부,구정초등학교,교육부 충청북도교육청 충청북도진천교육지원청 구정초등학교,21,21,0,21,0,21,0,0
교육기관,교육부,금구초등학교,교육부 충청북도교육청 충청북도진천교육지원청 금구초등학교,15,13,2,13,4,9,0,0
교육기관,교육부,덕산중학교,교육부 충청북도교육청 충청북도진천교육지원청 덕산중학교,32,32,0,32,0,32,0,0
교육기관,교육부,만승초등학교,교육부 충청북도교육청 충청북도진천교육지원청 만승초등학교,47,47,0,47,20,27,0,0
교육기관,교육부,문백초등학교,교육부 충청북도교육청 충청북도진천교육지원청 문백초등학교,24,24,0,24,8,16,0,0
교육기관,교육부,문상초등학교,교육부 충청북도교육청 충청북도진천교육지원청 문상초등학교,12,12,0,12,8,4,0,0
교육기관,교육부,백곡초등학교,교육부 충청북도교육청 충청북도진천교육지원청 백곡초등학교,16,16,0,16,0,16,0,0
교육기관,교육부,서전유치원,교육부 충청북도교육청 충청북도진천교육지원청 서전유치원,24,24,0,24,0,24,0,0
교육기관,교육부,서전중학교,교육부 충청북도교육청 충청북도진천교육지원청 서전중학교,42,42,0,42,30,12,0,0
교육기관,교육부,성암초등학교,교육부 충청북도교육청 충청북도진천교육지원청 성암초등학교,16,16,0,16,0,16,0,0
교육기관,교육부,옥동유치원,교육부 충청북도교육청 충청북도진천교육지원청 옥동유치원,15,15,0,15,0,15,0,0
교육기관,교육부,옥동초등학교,교육부 충청북도교육청 충청북도진천교육지원청 옥동초등학교,8,8,0,8,0,8,0,0
교육기관,교육부,은여울중학교,교육부 충청북도교육청 충청북도진천교육지원청 은여울중학교,64,24,40,24,12,12,0,0
교육기관,교육부,이월중학교,교육부 충청북도교육청 충청북도진천교육지원청 이월중학교,23,23,0,23,9,14,0,0
교육기관,교육부,이월초등학교,교육부 충청북도교육청 충청북도진천교육지원청 이월초등학교,16,16,0,16,16,0,0,0
교육기관,교육부,진천교육도서관,교육부 충청북도교육청 충청북도진천교육지원청 진천교육도서관,16,16,0,16,0,16,0,0
교육기관,교육부,진천삼수초등학교,교육부 충청북도교육청 충청북도진천교육지원청 진천삼수초등학교,30,30,0,30,13,17,0,0
교육기관,교육부,진천상산초등학교,교육부 충청북도교육청 충청북도진천교육지원청 진천상산초등학교,24,24,0,24,12,12,0,0
교육기관,교육부,진천상신초등학교,교육부 충청북도교육청 충청북도진천교육지원청 진천상신초등학교,25,25,0,25,0,25,0,0
교육기관,교육부,진천여자중학교,교육부 충청북도교육청 충청북도진천교육지원청 진천여자중학교,45,45,0,45,36,9,0,0
교육기관,교육부,진천유치원,교육부 충청북도교육청 충청북도진천교육지원청 진천유치원,23,23,0,23,0,23,0,0
교육기관,교육부,진천중학교,교육부 충청북도교육청 충청북도진천교육지원청 진천중학교,64,64,0,64,0,64,0,0
교육기관,교육부,초평초등학교,교육부 충청북도교육청 충청북도진천교육지원청 초평초등학교,21,21,0,21,3,18,0,0
교육기관,교육부,학성초등학교,교육부 충청북도교육청 충청북도진천교육지원청 학성초등학교,15,15,0,15,15,0,0,0
교육기관,교육부,한천초등학교,교육부 충청북도교육청 충청북도진천교육지원청 한천초등학교,27,27,0,27,27,0,0,0
교육기관,교육부,충청북도청주교육지원청,교육부 충청북도교육청 충청북도청주교육지원청,37,36,1,36,0,36,0,0
교육기관,교육부,가경중학교,교육부 충청북도교육청 충청북도청주교육지원청 가경중학교,36,36,0,36,20,15,0,1
교육기관,교육부,가경초등학교,교육부 충청북도교육청 충청북도청주교육지원청 가경초등학교,37,37,0,37,21,16,0,0
교육기관,교육부,가덕중학교,교육부 충청북도교육청 충청북도청주교육지원청 가덕중학교,10,10,0,10,8,2,0,0
교육기관,교육부,가덕초등학교,교육부 충청북도교육청 충청북도청주교육지원청 가덕초등학교,26,26,0,26,3,21,1,1
교육기관,교육부,각리중학교,교육부 충청북도교육청 충청북도청주교육지원청 각리중학교,50,17,33,17,14,1,1,1
교육기관,교육부,각리초등학교,교육부 충청북도교육청 충청북도청주교육지원청 각리초등학교,44,44,0,44,20,24,0,0
교육기관,교육부,강내초등학교,교육부 충청북도교육청 충청북도청주교육지원청 강내초등학교,16,16,0,16,7,9,0,0
교육기관,교육부,강서초등학교,교육부 충청북도교육청 충청북도청주교육지원청 강서초등학교,41,41,0,41,0,41,0,0
교육기관,교육부,개신초등학교,교육부 충청북도교육청 충청북도청주교육지원청 개신초등학교,41,41,0,41,8,33,0,0
교육기관,교육부,경덕중학교,교육부 충청북도교육청 충청북도청주교육지원청 경덕중학교,48,48,0,48,39,9,0,0
교육기관,교육부,경덕초등학교,교육부 충청북도교육청 충청북도청주교육지원청 경덕초등학교,43,43,0,43,43,0,0,0
교육기관,교육부,경산초등학교,교육부 충청북도교육청 충청북도청주교육지원청 경산초등학교,26,26,0,26,26,0,0,0
교육기관,교육부,교동초등학교,교육부 충청북도교육청 충청북도청주교육지원청 교동초등학교,40,40,0,40,40,0,0,0
교육기관,교육부,금천중학교,교육부 충청북도교육청 충청북도청주교육지원청 금천중학교,64,64,0,64,64,0,0,0
교육기관,교육부,금천초등학교,교육부 충청북도교육청 충청북도청주교육지원청 금천초등학교,34,34,0,34,34,0,0,0
교육기관,교육부,남성유치원,교육부 충청북도교육청 충청북도청주교육지원청 남성유치원,14,14,0,14,2,12,0,0
교육기관,교육부,남성중학교,교육부 충청북도교육청 충청북도청주교육지원청 남성중학교,42,12,30,12,12,0,0,0
교육기관,교육부,남이초등학교,교육부 충청북도교육청 충청북도청주교육지원청 남이초등학교,19,19,0,19,0,19,0,0
교육기관,교육부,남일초등학교,교육부 충청북도교육청 충청북도청주교육지원청 남일초등학교,27,27,0,27,27,0,0,0
교육기관,교육부,남평초등학교,교육부 충청북도교육청 충청북도청주교육지원청 남평초등학교,38,38,0,38,38,0,0,0
교육기관,교육부,낭성초등학교,교육부 충청북도교육청 충청북도청주교육지원청 낭성초등학교,14,14,0,14,12,2,0,0
교육기관,교육부,내수중학교,교육부 충청북도교육청 충청북도청주교육지원청 내수중학교,66,66,0,66,34,32,0,0
교육기관,교육부,내수초등학교,교육부 충청북도교육청 충청북도청주교육지원청 내수초등학교,23,23,0,23,0,23,0,0
교육기관,교육부,단재초등학교,교육부 충청북도교육청 충청북도청주교육지원청 단재초등학교,27,27,0,27,0,27,0,0
교육기관,교육부,대길초등학교,교육부 충청북도교육청 충청북도청주교육지원청 대길초등학교,15,15,0,15,15,0,0,0
교육기관,교육부,대성여자중학교,교육부 충청북도교육청 충청북도청주교육지원청 대성여자중학교,40,40,0,40,40,0,0,0
교육기관,교육부,대성중학교,교육부 충청북도교육청 충청북도청주교육지원청 대성중학교,41,12,29,12,4,8,0,0
교육기관,교육부,대성초등학교,교육부 충청북도교육청 충청북도청주교육지원청 대성초등학교,26,26,0,26,0,26,0,0
교육기관,교육부,덕벌초등학교,교육부 충청북도교육청 충청북도청주교육지원청 덕벌초등학교,15,15,0,15,11,4,0,0
교육기관,교육부,덕성유치원,교육부 충청북도교육청 충청북도청주교육지원청 덕성유치원,16,16,0,16,3,11,1,1
교육기관,교육부,덕성초등학교,교육부 충청북도교육청 충청북도청주교육지원청 덕성초등학교,20,20,0,20,0,20,0,0
교육기관,교육부,동남유치원,교육부 충청북도교육청 충청북도청주교육지원청 동남유치원,25,25,0,25,19,6,0,0
교육기관,교육부,동주초등학교,교육부 충청북도교육청 충청북도청주교육지원청 동주초등학교,23,23,0,23,16,7,0,0
교육기관,교육부,동화초등학교,교육부 충청북도교육청 충청북도청주교육지원청 동화초등학교,13,13,0,13,7,6,0,0
교육기관,교육부,만수초등학교,교육부 충청북도교육청 충청북도청주교육지원청 만수초등학교,24,24,0,24,18,6,0,0
교육기관,교육부,모충초등학교,교육부 충청북도교육청 충청북도청주교육지원청 모충초등학교,31,29,2,29,0,29,0,0
교육기관,교육부,문의중학교,교육부 충청북도교육청 충청북도청주교육지원청 문의중학교,15,14,1,14,4,9,0,1
교육기관,교육부,문의초등학교,교육부 충청북도교육청 충청북도청주교육지원청 문의초등학교,23,23,0,23,5,18,0,0
교육기관,교육부,문의초등학교도원분교장,교육부 충청북도교육청 충청북도청주교육지원청 문의초등학교도원분교장,21,21,0,21,5,16,0,0
교육기관,교육부,미원중학교,교육부 충청북도교육청 충청북도청주교육지원청 미원중학교,22,22,0,22,9,13,0,0
교육기관,교육부,복대중학교,교육부 충청북도교육청 충청북도청주교육지원청 복대중학교,50,50,0,50,50,0,0,0
교육기관,교육부,복대초등학교,교육부 충청북도교육청 충청북도청주교육지원청 복대초등학교,64,64,0,64,32,32,0,0
교육기관,교육부,봉덕초등학교,교육부 충청북도교육청 충청북도청주교육지원청 봉덕초등학교,36,36,0,36,0,36,0,0
교육기관,교육부,봉명중학교,교육부 충청북도교육청 충청북도청주교육지원청 봉명중학교,62,62,0,62,62,0,0,0
교육기관,교육부,봉명초등학교,교육부 충청북도교육청 충청북도청주교육지원청 봉명초등학교,21,21,0,21,21,0,0,0
교육기관,교육부,봉정초등학교,교육부 충청북도교육청 충청북도청주교육지원청 봉정초등학교,24,24,0,24,0,24,0,0
교육기관,교육부,북이초등학교,교육부 충청북도교육청 충청북도청주교육지원청 북이초등학교,14,14,0,14,11,3,0,0
교육기관,교육부,북일초등학교,교육부 충청북도교육청 충청북도청주교육지원청 북일초등학교,27,27,0,27,2,25,0,0
교육기관,교육부,분평초등학교,교육부 충청북도교육청 충청북도청주교육지원청 분평초등학교,27,27,0,27,27,0,0,0
교육기관,교육부,비봉유치원,교육부 충청북도교육청 충청북도청주교육지원청 비봉유치원,14,14,0,14,6,8,0,0
교육기관,교육부,비봉초등학교,교육부 충청북도교육청 충청북도청주교육지원청 비봉초등학교,29,29,0,29,0,29,0,0
교육기관,교육부,비상초등학교,교육부 충청북도교육청 충청북도청주교육지원청 비상초등학교,16,16,0,16,8,8,0,0
교육기관,교육부,사직초등학교,교육부 충청북도교육청 충청북도청주교육지원청 사직초등학교,19,19,0,19,9,10,0,0
교육기관,교육부,사천초등학교,교육부 충청북도교육청 충청북도청주교육지원청 사천초등학교,32,32,0,32,32,0,0,0
교육기관,교육부,산남유치원,교육부 충청북도교육청 충청북도청주교육지원청 산남유치원,11,11,0,11,0,11,0,0
교육기관,교육부,산남중학교,교육부 충청북도교육청 충청북도청주교육지원청 산남중학교,68,68,0,68,68,0,0,0
교육기관,교육부,산남초등학교,교육부 충청북도교육청 충청북도청주교육지원청 산남초등학교,37,37,0,37,24,13,0,0
교육기관,교육부,산성유치원,교육부 충청북도교육청 충청북도청주교육지원청 산성유치원,9,9,0,9,0,9,0,0
교육기관,교육부,산성초등학교,교육부 충청북도교육청 충청북도청주교육지원청 산성초등학교,30,30,0,30,15,15,0,0
교육기관,교육부,상당초등학교,교육부 충청북도교육청 충청북도청주교육지원청 상당초등학교,24,24,0,24,24,0,0,0
교육기관,교육부,상봉초등학교,교육부 충청북도교육청 충청북도청주교육지원청 상봉초등학교,8,8,0,8,8,0,0,0
교육기관,교육부,새터초등학교,교육부 충청북도교육청 충청북도청주교육지원청 새터초등학교,19,19,0,19,19,0,0,0
교육기관,교육부,샛별초등학교,교육부 충청북도교육청 충청북도청주교육지원청 샛별초등학교,34,34,0,34,0,34,0,0
교육기관,교육부,생명초등학교,교육부 충청북도교육청 충청북도청주교육지원청 생명초등학교,59,59,0,59,0,59,0,0
교육기관,교육부,서경중학교,교육부 충청북도교육청 충청북도청주교육지원청 서경중학교,44,44,0,44,30,14,0,0
교육기관,교육부,서경초등학교,교육부 충청북도교육청 충청북도청주교육지원청 서경초등학교,32,32,0,32,17,15,0,0
교육기관,교육부,서원유치원,교육부 충청북도교육청 충청북도청주교육지원청 서원유치원,4,4,0,4,1,3,0,0
교육기관,교육부,서원중학교,교육부 충청북도교육청 충청북도청주교육지원청 서원중학교,48,48,0,48,48,0,0,0
교육기관,교육부,서원초등학교,교육부 충청북도교육청 충청북도청주교육지원청 서원초등학교,26,26,0,26,26,0,0,0
교육기관,교육부,서촌초등학교,교육부 충청북도교육청 충청북도청주교육지원청 서촌초등학교,16,16,0,16,0,16,0,0
교육기관,교육부,서현중학교,교육부 충청북도교육청 충청북도청주교육지원청 서현중학교,35,35,0,35,15,18,2,0
교육기관,교육부,서현초등학교,교육부 충청북도교육청 충청북도청주교육지원청 서현초등학교,30,30,0,30,3,27,0,0
교육기관,교육부,석성초등학교,교육부 충청북도교육청 충청북도청주교육지원청 석성초등학교,9,9,0,9,0,9,0,0
교육기관,교육부,성화중학교,교육부 충청북도교육청 충청북도청주교육지원청 성화중학교,60,59,1,59,59,0,0,0
교육기관,교육부,성화초등학교,교육부 충청북도교육청 충청북도청주교육지원청 성화초등학교,44,44,0,44,36,6,2,0
교육기관,교육부,세광중학교,교육부 충청북도교육청 충청북도청주교육지원청 세광중학교,47,46,1,46,46,0,0,0
교육기관,교육부,솔밭중학교,교육부 충청북도교육청 충청북도청주교육지원청 솔밭중학교,52,52,0,52,10,42,0,0
교육기관,교육부,솔밭초등학교,교육부 충청북도교육청 충청북도청주교육지원청 솔밭초등학교,27,27,0,27,0,27,0,0
교육기관,교육부,수곡중학교,교육부 충청북도교육청 충청북도청주교육지원청 수곡중학교,47,47,0,47,0,47,0,0
교육기관,교육부,수곡초등학교,교육부 충청북도교육청 충청북도청주교육지원청 수곡초등학교,32,32,0,32,0,32,0,0
교육기관,교육부,수성초등학교,교육부 충청북도교육청 충청북도청주교육지원청 수성초등학교,35,35,0,35,35,0,0,0
교육기관,교육부,신송초등학교,교육부 충청북도교육청 충청북도청주교육지원청 신송초등학교,18,18,0,18,18,0,0,0
교육기관,교육부,양청중학교,교육부 충청북도교육청 충청북도청주교육지원청 양청중학교,42,42,0,42,31,11,0,0
교육기관,교육부,양청초등학교,교육부 충청북도교육청 충청북도청주교육지원청 양청초등학교,48,48,0,48,20,28,0,0
교육기관,교육부,오송유치원,교육부 충청북도교육청 충청북도청주교육지원청 오송유치원,8,8,0,8,0,8,0,0
교육기관,교육부,오송중학교,교육부 충청북도교육청 충청북도청주교육지원청 오송중학교,69,14,55,14,0,14,0,0
교육기관,교육부,오송초등학교,교육부 충청북도교육청 충청북도청주교육지원청 오송초등학교,32,19,13,19,0,19,0,0
교육기관,교육부,오창중학교,교육부 충청북도교육청 충청북도청주교육지원청 오창중학교,52,52,0,52,13,36,3,0
교육기관,교육부,오창초등학교,교육부 충청북도교육청 충청북도청주교육지원청 오창초등학교,32,32,0,32,0,32,0,0
교육기관,교육부,옥산유치원,교육부 충청북도교육청 충청북도청주교육지원청 옥산유치원,11,11,0,11,0,11,0,0
교육기관,교육부,옥산중학교,교육부 충청북도교육청 충청북도청주교육지원청 옥산중학교,35,35,0,35,16,19,0,0
교육기관,교육부,옥산초등학교,교육부 충청북도교육청 충청북도청주교육지원청 옥산초등학교,17,17,0,17,0,17,0,0
교육기관,교육부,옥포초등학교,교육부 충청북도교육청 충청북도청주교육지원청 옥포초등학교,16,16,0,16,10,5,1,0
교육기관,교육부,용담초등학교,교육부 충청북도교육청 충청북도청주교육지원청 용담초등학교,52,52,0,52,52,0,0,0
교육기관,교육부,용성중학교,교육부 충청북도교육청 충청북도청주교육지원청 용성중학교,37,37,0,37,22,15,0,0
교육기관,교육부,용성초등학교,교육부 충청북도교육청 충청북도청주교육지원청 용성초등학교,36,36,0,36,0,36,0,0
교육기관,교육부,용아초등학교,교육부 충청북도교육청 충청북도청주교육지원청 용아초등학교,27,27,0,27,27,0,0,0
교육기관,교육부,용암중학교,교육부 충청북도교육청 충청북도청주교육지원청 용암중학교,75,75,0,75,19,56,0,0
교육기관,교육부,용암초등학교,교육부 충청북도교육청 충청북도청주교육지원청 용암초등학교,36,36,0,36,0,36,0,0
교육기관,교육부,우암초등학교,교육부 충청북도교육청 충청북도청주교육지원청 우암초등학교,18,18,0,18,18,0,0,0
교육기관,교육부,운동중학교,교육부 충청북도교육청 충청북도청주교육지원청 운동중학교,48,48,0,48,42,5,1,0
교육기관,교육부,운동초등학교,교육부 충청북도교육청 충청북도청주교육지원청 운동초등학교,33,33,0,33,23,10,0,0
교육기관,교육부,운천초등학교,교육부 충청북도교육청 충청북도청주교육지원청 운천초등학교,24,24,0,24,24,0,0,0
교육기관,교육부,운호중학교,교육부 충청북도교육청 충청북도청주교육지원청 운호중학교,36,36,0,36,26,10,0,0
교육기관,교육부,원봉중학교,교육부 충청북도교육청 충청북도청주교육지원청 원봉중학교,54,54,0,54,54,0,0,0
교육기관,교육부,원봉초등학교,교육부 충청북도교육청 충청북도청주교육지원청 원봉초등학교,16,16,0,16,16,0,0,0
교육기관,교육부,원평중학교,교육부 충청북도교육청 충청북도청주교육지원청 원평중학교,54,54,0,54,54,0,0,0
교육기관,교육부,원평초등학교,교육부 충청북도교육청 충청북도청주교육지원청 원평초등학교,31,31,0,31,0,31,0,0
교육기관,교육부,율량중학교,교육부 충청북도교육청 충청북도청주교육지원청 율량중학교,60,60,0,60,42,18,0,0
교육기관,교육부,율량초등학교,교육부 충청북도교육청 충청북도청주교육지원청 율량초등학교,15,15,0,15,6,9,0,0
교육기관,교육부,율봉유치원,교육부 충청북도교육청 충청북도청주교육지원청 율봉유치원,18,7,11,7,0,7,0,0
교육기관,교육부,일신여자중학교,교육부 충청북도교육청 충청북도청주교육지원청 일신여자중학교,59,59,0,59,59,0,0,0
교육기관,교육부,주성중학교,교육부 충청북도교육청 충청북도청주교육지원청 주성중학교,41,38,3,38,21,17,0,0
교육기관,교육부,주성초등학교,교육부 충청북도교육청 충청북도청주교육지원청 주성초등학교,18,12,6,12,0,12,0,0
교육기관,교육부,주중초등학교,교육부 충청북도교육청 충청북도청주교육지원청 주중초등학교,20,20,0,20,20,0,0,0
교육기관,교육부,죽림초등학교,교육부 충청북도교육청 충청북도청주교육지원청 죽림초등학교,32,32,0,32,0,32,0,0
교육기관,교육부,중앙초등학교,교육부 충청북도교육청 충청북도청주교육지원청 중앙초등학교,56,56,0,56,19,37,0,0
교육기관,교육부,증안초등학교,교육부 충청북도교육청 충청북도청주교육지원청 증안초등학교,24,24,0,24,24,0,0,0
교육기관,교육부,직지초등학교,교육부 충청북도교육청 충청북도청주교육지원청 직지초등학교,38,38,0,38,38,0,0,0
교육기관,교육부,진흥초등학교,교육부 충청북도교육청 충청북도청주교육지원청 진흥초등학교,22,22,0,22,22,0,0,0
교육기관,교육부,창리초등학교,교육부 충청북도교육청 충청북도청주교육지원청 창리초등학교,32,32,0,32,16,16,0,0
교육기관,교육부,창신유치원,교육부 충청북도교육청 충청북도청주교육지원청 창신유치원,22,22,0,22,0,22,0,0
교육기관,교육부,창신초등학교,교육부 충청북도교육청 충청북도청주교육지원청 창신초등학교,28,28,0,28,28,0,0,0
교육기관,교육부,청남초등학교,교육부 충청북도교육청 충청북도청주교육지원청 청남초등학교,32,32,0,32,30,2,0,0
교육기관,교육부,청운중학교,교육부 충청북도교육청 충청북도청주교육지원청 청운중학교,64,64,0,64,42,19,2,1
교육기관,교육부,청원초등학교,교육부 충청북도교육청 충청북도청주교육지원청 청원초등학교,14,14,0,14,9,5,0,0
교육기관,교육부,청주남중학교,교육부 충청북도교육청 충청북도청주교육지원청 청주남중학교,42,15,27,15,10,5,0,0
교육기관,교육부,청주내곡초등학교,교육부 충청북도교육청 충청북도청주교육지원청 청주내곡초등학교,39,18,21,18,0,18,0,0
교육기관,교육부,청주내덕초등학교,교육부 충청북도교육청 충청북도청주교육지원청 청주내덕초등학교,13,13,0,13,12,1,0,0
교육기관,교육부,청주동중학교,교육부 충청북도교육청 충청북도청주교육지원청 청주동중학교,55,55,0,55,28,27,0,0
교육기관,교육부,청주소로초등학교,교육부 충청북도교육청 충청북도청주교육지원청 청주소로초등학교,32,32,0,32,4,28,0,0
교육기관,교육부,청주여자중학교,교육부 충청북도교육청 충청북도청주교육지원청 청주여자중학교,38,38,0,38,20,18,0,0
교육기관,교육부,청주중앙여자중학교,교육부 충청북도교육청 충청북도청주교육지원청 청주중앙여자중학교,37,37,0,37,18,19,0,0
교육기관,교육부,청주중앙중학교,교육부 충청북도교육청 충청북도청주교육지원청 청주중앙중학교,49,49,0,49,49,0,0,0
교육기관,교육부,청주중학교,교육부 충청북도교육청 충청북도청주교육지원청 청주중학교,61,61,0,61,61,0,0,0
교육기관,교육부,초롱꽃유치원,교육부 충청북도교육청 충청북도청주교육지원청 초롱꽃유치원,21,21,0,21,0,21,0,0
교육기관,교육부,충북여자중학교,교육부 충청북도교육청 충청북도청주교육지원청 충북여자중학교,38,38,0,38,0,38,0,0
교육기관,교육부,풍광초등학교,교육부 충청북도교육청 충청북도청주교육지원청 풍광초등학교,24,24,0,24,24,0,0,0
교육기관,교육부,한벌초등학교,교육부 충청북도교육청 충청북도청주교육지원청 한벌초등학교,25,25,0,25,25,0,0,0
교육기관,교육부,한솔초등학교,교육부 충청북도교육청 충청북도청주교육지원청 한솔초등학교,14,13,1,13,7,6,0,0
교육기관,교육부,행정초등학교,교육부 충청북도교육청 충청북도청주교육지원청 행정초등학교,8,8,0,8,2,6,0,0
교육기관,교육부,현도중학교,교육부 충청북도교육청 충청북도청주교육지원청 현도중학교,17,17,0,17,0,17,0,0
교육기관,교육부,현도초등학교,교육부 충청북도교육청 충청북도청주교육지원청 현도초등학교,20,20,0,20,6,14,0,0
교육기관,교육부,흥덕초등학교,교육부 충청북도교육청 충청북도청주교육지원청 흥덕초등학교,24,24,0,24,10,14,0,0
교육기관,교육부,충청북도충주교육지원청,교육부 충청북도교육청 충청북도충주교육지원청,28,28,0,28,14,14,0,0
교육기관,교육부,가흥초등학교,교육부 충청북도교육청 충청북도충주교육지원청 가흥초등학교,8,8,0,8,8,0,0,0
교육기관,교육부,국원유치원,교육부 충청북도교육청 충청북도충주교육지원청 국원유치원,17,17,0,17,4,13,0,0
교육기관,교육부,국원초등학교,교육부 충청북도교육청 충청북도충주교육지원청 국원초등학교,51,47,4,47,47,0,0,0
교육기관,교육부,금가초등학교,교육부 충청북도교육청 충청북도충주교육지원청 금가초등학교,19,19,0,19,0,19,0,0
교육기관,교육부,노은중학교,교육부 충청북도교육청 충청북도충주교육지원청 노은중학교,8,8,0,8,4,4,0,0
교육기관,교육부,노은초등학교,교육부 충청북도교육청 충청북도충주교육지원청 노은초등학교,20,20,0,20,7,10,0,3
교육기관,교육부,단월초등학교,교육부 충청북도교육청 충청북도충주교육지원청 단월초등학교,20,13,7,13,5,8,0,0
교육기관,교육부,달천초등학교,교육부 충청북도교육청 충청북도충주교육지원청 달천초등학교,15,15,0,15,15,0,0,0
교육기관,교육부,대미초등학교,교육부 충청북도교육청 충청북도충주교육지원청 대미초등학교,16,16,0,16,10,6,0,0
교육기관,교육부,덕신초등학교,교육부 충청북도교육청 충청북도충주교육지원청 덕신초등학교,22,22,0,22,16,4,1,1
교육기관,교육부,동량초등학교,교육부 충청북도교육청 충청북도충주교육지원청 동량초등학교,15,15,0,15,3,12,0,0
교육기관,교육부,목행초등학교,교육부 충청북도교육청 충청북도충주교육지원청 목행초등학교,24,24,0,24,20,4,0,0
교육기관,교육부,산척중학교,교육부 충청북도교육청 충청북도충주교육지원청 산척중학교,24,24,0,24,24,0,0,0
교육기관,교육부,산척초등학교,교육부 충청북도교육청 충청북도충주교육지원청 산척초등학교,24,24,0,24,24,0,0,0
교육기관,교육부,세성초등학교,교육부 충청북도교육청 충청북도충주교육지원청 세성초등학교,12,12,0,12,6,6,0,0
교육기관,교육부,소태초등학교,교육부 충청북도교육청 충청북도충주교육지원청 소태초등학교,12,12,0,12,6,6,0,0
교육기관,교육부,수안보중학교,교육부 충청북도교육청 충청북도충주교육지원청 수안보중학교,16,16,0,16,7,9,0,0
교육기관,교육부,수안보초등학교,교육부 충청북도교육청 충청북도충주교육지원청 수안보초등학교,6,6,0,6,0,6,0,0
교육기관,교육부,수회초등학교,교육부 충청북도교육청 충청북도충주교육지원청 수회초등학교,9,9,0,9,3,6,0,0
교육기관,교육부,신니중학교,교육부 충청북도교육청 충청북도충주교육지원청 신니중학교,16,15,1,15,8,7,0,0
교육기관,교육부,신명중학교,교육부 충청북도교육청 충청북도충주교육지원청 신명중학교,24,24,0,24,8,16,0,0
교육기관,교육부,앙성중학교,교육부 충청북도교육청 충청북도충주교육지원청 앙성중학교,16,16,0,16,8,8,0,0
교육기관,교육부,앙성초등학교,교육부 충청북도교육청 충청북도충주교육지원청 앙성초등학교,28,28,0,28,14,14,0,0
교육기관,교육부,엄정초등학교,교육부 충청북도교육청 충청북도충주교육지원청 엄정초등학교,19,19,0,19,3,16,0,0
교육기관,교육부,연수초등학교,교육부 충청북도교육청 충청북도충주교육지원청 연수초등학교,14,14,0,14,14,0,0,0
교육기관,교육부,오석초등학교,교육부 충청북도교육청 충청북도충주교육지원청 오석초등학교,16,16,0,16,0,16,0,0
교육기관,교육부,용원초등학교,교육부 충청북도교육청 충청북도충주교육지원청 용원초등학교,29,29,0,29,26,2,1,0
교육기관,교육부,주덕중학교,교육부 충청북도교육청 충청북도충주교육지원청 주덕중학교,25,25,0,25,0,25,0,0
교육기관,교육부,주덕초등학교,교육부 충청북도교육청 충청북도충주교육지원청 주덕초등학교,10,10,0,10,4,6,0,0
교육기관,교육부,중앙탑중학교,교육부 충청북도교육청 충청북도충주교육지원청 중앙탑중학교,48,48,0,48,0,48,0,0
교육기관,교육부,중원중학교,교육부 충청북도교육청 충청북도충주교육지원청 중원중학교,16,16,0,16,6,8,1,1
교육기관,교육부,충일중학교,교육부 충청북도교육청 충청북도충주교육지원청 충일중학교,35,35,0,35,0,35,0,0
교육기관,교육부,충주교현초등학교,교육부 충청북도교육청 충청북도충주교육지원청 충주교현초등학교,27,27,0,27,27,0,0,0
교육기관,교육부,충주금릉초등학교,교육부 충청북도교육청 충청북도충주교육지원청 충주금릉초등학교,28,28,0,28,28,0,0,0
교육기관,교육부,충주남산유치원,교육부 충청북도교육청 충청북도충주교육지원청 충주남산유치원,16,16,0,16,7,6,1,2
교육기관,교육부,충주남산초등학교,교육부 충청북도교육청 충청북도충주교육지원청 충주남산초등학교,32,32,0,32,28,1,3,0
교육기관,교육부,충주남한강초등학교,교육부 충청북도교육청 충청북도충주교육지원청 충주남한강초등학교,16,16,0,16,12,4,0,0
교육기관,교육부,충주대림초등학교,교육부 충청북도교육청 충청북도충주교육지원청 충주대림초등학교,40,40,0,40,17,23,0,0
교육기관,교육부,충주대소원중학교,교육부 충청북도교육청 충청북도충주교육지원청 충주대소원중학교,7,7,0,7,7,0,0,0
교육기관,교육부,충주대소원초등학교,교육부 충청북도교육청 충청북도충주교육지원청 충주대소원초등학교,67,67,0,67,33,34,0,0
교육기관,교육부,충주미덕중학교,교육부 충청북도교육청 충청북도충주교육지원청 충주미덕중학교,48,48,0,48,34,14,0,0
교육기관,교육부,충주북여자중학교,교육부 충청북도교육청 충청북도충주교육지원청 충주북여자중학교,28,28,0,28,14,14,0,0
교육기관,교육부,충주삼원초등학교,교육부 충청북도교육청 충청북도충주교육지원청 충주삼원초등학교,20,20,0,20,11,6,0,3
교육기관,교육부,충주성남초등학교,교육부 충청북도교육청 충청북도충주교육지원청 충주성남초등학교,41,40,1,40,36,4,0,0
교육기관,교육부,충주여자중학교,교육부 충청북도교육청 충청북도충주교육지원청 충주여자중학교,35,35,0,35,30,5,0,0
교육기관,교육부,충주예성여자중학교,교육부 충청북도교육청 충청북도충주교육지원청 충주예성여자중학교,35,35,0,35,0,35,0,0
교육기관,교육부,충주예성초등학교,교육부 충청북도교육청 충청북도충주교육지원청 충주예성초등학교,16,16,0,16,16,0,0,0
교육기관,교육부,충주용산초등학교,교육부 충청북도교육청 충청북도충주교육지원청 충주용산초등학교,21,20,1,20,20,0,0,0
교육기관,교육부,충주중앙중학교,교육부 충청북도교육청 충청북도충주교육지원청 충주중앙중학교,56,56,0,56,2,54,0,0
교육기관,교육부,충주중앙초등학교,교육부 충청북도교육청 충청북도충주교육지원청 충주중앙초등학교,24,24,0,24,18,6,0,0
교육기관,교육부,충주중앙탑초등학교,교육부 충청북도교육청 충청북도충주교육지원청 충주중앙탑초등학교,36,36,0,36,36,0,0,0
교육기관,교육부,충주중학교,교육부 충청북도교육청 충청북도충주교육지원청 충주중학교,38,38,0,38,34,4,0,0
교육기관,교육부,칠금중학교,교육부 충청북도교육청 충청북도충주교육지원청 칠금중학교,33,33,0,33,33,0,0,0
교육기관,교육부,칠금초등학교,교육부 충청북도교육청 충청북도충주교육지원청 칠금초등학교,31,31,0,31,26,5,0,0
교육기관,교육부,탄금유치원,교육부 충청북도교육청 충청북도충주교육지원청 탄금유치원,14,14,0,14,5,9,0,0
교육기관,교육부,탄금중학교,교육부 충청북도교육청 충청북도충주교육지원청 탄금중학교,25,25,0,25,12,13,0,0
교육기관,교육부,탄금초등학교,교육부 충청북도교육청 충청북도충주교육지원청 탄금초등학교,18,18,0,18,5,13,0,0
교육기관,교육부,충청북도특수교육원,교육부 충청북도교육청 충청북도특수교육원,27,27,0,27,0,27,0,0
교육기관,교육부,충청북도학생수련원,교육부 충청북도교육청 충청북도학생수련원,30,30,0,30,30,0,0,0
교육기관,교육부,충청북도해양교육원,교육부 충청북도교육청 충청북도해양교육원,72,72,0,72,0,72,0,0
교육기관,교육부,학산고등학교,교육부 충청북도교육청 학산고등학교,33,33,0,33,12,21,0,0
교육기관,교육부,한국바이오마이스터고등학교,교육부 충청북도교육청 한국바이오마이스터고등학교,117,117,0,117,32,85,0,0
교육기관,교육부,한국호텔관광고등학교,교육부 충청북도교육청 한국호텔관광고등학교,46,46,0,46,36,10,0,0
교육기관,교육부,한림디자인고등학교,교육부 충청북도교육청 한림디자인고등학교,94,94,0,94,0,94,0,0
교육기관,교육부,형석고등학교,교육부 충청북도교육청 형석고등학교,61,61,0,61,37,24,0,0
교육기관,교육부,황간고등학교,교육부 충청북도교육청 황간고등학교,55,54,1,54,43,5,5,1
교육기관,교육부,흥덕고등학교,교육부 충청북도교육청 흥덕고등학교,48,48,0,48,0,48,0,0
교육기관,교육부,충청남도교육청,교육부 충청남도교육청,99,99,0,99,0,99,0,0
교육기관,교육부,갈산고등학교,교육부 충청남도교육청 갈산고등학교,31,30,1,30,17,13,0,0
교육기관,교육부,강경고등학교,교육부 충청남도교육청 강경고등학교,50,50,0,50,8,42,0,0
교육기관,교육부,강경상업고등학교,교육부 충청남도교육청 강경상업고등학교,117,64,53,64,64,0,0,0
교육기관,교육부,건양고등학교,교육부 충청남도교육청 건양고등학교,73,73,0,73,52,21,0,0
교육기관,교육부,공동체비전고등학교,교육부 충청남도교육청 공동체비전고등학교,56,56,0,56,56,0,0,0
교육기관,교육부,공주고등학교,교육부 충청남도교육청 공주고등학교,35,35,0,35,27,8,0,0
교육기관,교육부,공주금성여자고등학교,교육부 충청남도교육청 공주금성여자고등학교,46,45,1,45,0,45,0,0
교육기관,교육부,공주대학교사범대학부설고등학교,교육부 충청남도교육청 공주대학교사범대학부설고등학교,94,94,0,94,0,94,0,0
교육기관,교육부,공주마이스터고등학교,교육부 충청남도교육청 공주마이스터고등학교,72,72,0,72,72,0,0,0
교육기관,교육부,공주생명과학고등학교,교육부 충청남도교육청 공주생명과학고등학교,58,58,0,58,0,58,0,0
교육기관,교육부,공주여자고등학교,교육부 충청남도교육청 공주여자고등학교,42,42,0,42,42,0,0,0
교육기관,교육부,공주정명학교,교육부 충청남도교육청 공주정명학교,30,30,0,30,30,0,0,0
교육기관,교육부,공주정보고등학교,교육부 충청남도교육청 공주정보고등학교,96,96,0,96,76,20,0,0
교육기관,교육부,금산고등학교,교육부 충청남도교육청 금산고등학교,43,43,0,43,13,30,0,0
교육기관,교육부,금산산업고등학교,교육부 충청남도교육청 금산산업고등학교,11,11,0,11,11,0,0,0
교육기관,교육부,금산여자고등학교,교육부 충청남도교육청 금산여자고등학교,9,9,0,9,7,2,0,0
교육기관,교육부,금산하이텍고등학교,교육부 충청남도교육청 금산하이텍고등학교,42,40,2,40,0,40,0,0
교육기관,교육부,나사렛새꿈학교,교육부 충청남도교육청 나사렛새꿈학교,38,38,0,38,0,38,0,0
교육기관,교육부,논산고등학교,교육부 충청남도교육청 논산고등학교,40,40,0,40,13,27,0,0
교육기관,교육부,논산공업고등학교,교육부 충청남도교육청 논산공업고등학교,47,47,0,47,0,47,0,0
교육기관,교육부,논산대건고등학교,교육부 충청남도교육청 논산대건고등학교,87,87,0,87,15,72,0,0
교육기관,교육부,논산여자고등학교,교육부 충청남도교육청 논산여자고등학교,33,33,0,33,33,0,0,0
교육기관,교육부,논산여자상업고등학교,교육부 충청남도교육청 논산여자상업고등학교,43,43,0,43,20,23,0,0
교육기관,교육부,당진고등학교,교육부 충청남도교육청 당진고등학교,122,122,0,122,117,3,1,1
교육기관,교육부,당진꿈나래학교,교육부 충청남도교육청 당진꿈나래학교,37,37,0,37,16,21,0,0
교육기관,교육부,당진정보고등학교,교육부 충청남도교육청 당진정보고등학교,46,46,0,46,46,0,0,0
교육기관,교육부,대산고등학교,교육부 충청남도교육청 대산고등학교,65,65,0,65,0,65,0,0
교육기관,교육부,대천고등학교,교육부 충청남도교육청 대천고등학교,71,71,0,71,0,71,0,0
교육기관,교육부,대천여자고등학교,교육부 충청남도교육청 대천여자고등학교,50,47,3,47,34,13,0,0
교육기관,교육부,대천여자상업고등학교,교육부 충청남도교육청 대천여자상업고등학교,21,21,0,21,20,1,0,0
교육기관,교육부,대흥고등학교,교육부 충청남도교육청 대흥고등학교,53,53,0,53,10,43,0,0
교육기관,교육부,목천고등학교,교육부 충청남도교육청 목천고등학교,37,37,0,37,32,5,0,0
교육기관,교육부,배방고등학교,교육부 충청남도교육청 배방고등학교,88,88,0,88,88,0,0,0
교육기관,교육부,병천고등학교,교육부 충청남도교육청 병천고등학교,47,47,0,47,47,0,0,0
교육기관,교육부,보령정심학교,교육부 충청남도교육청 보령정심학교,27,27,0,27,0,27,0,0
교육기관,교육부,복자여자고등학교,교육부 충청남도교육청 복자여자고등학교,32,0,32,0,0,0,0,0
교육기관,교육부,부석고등학교,교육부 충청남도교육청 부석고등학교,69,69,0,69,47,22,0,0
교육기관,교육부,부여고등학교,교육부 충청남도교육청 부여고등학교,66,66,0,66,0,66,0,0
교육기관,교육부,부여여자고등학교,교육부 충청남도교육청 부여여자고등학교,32,32,0,32,20,12,0,0
교육기관,교육부,부여전자고등학교,교육부 충청남도교육청 부여전자고등학교,19,18,1,18,2,16,0,0
교육기관,교육부,부여정보고등학교,교육부 충청남도교육청 부여정보고등학교,32,32,0,32,19,13,0,0
교육기관,교육부,북일고등학교,교육부 충청남도교육청 북일고등학교,232,231,1,231,0,231,0,0
교육기관,교육부,북일여자고등학교,교육부 충청남도교육청 북일여자고등학교,77,77,0,77,11,66,0,0
교육기관,교육부,삽교고등학교,교육부 충청남도교육청 삽교고등학교,70,70,0,70,22,48,0,0
교육기관,교육부,서령고등학교,교육부 충청남도교육청 서령고등학교,53,52,1,52,0,52,0,0
교육기관,교육부,서산고등학교,교육부 충청남도교육청 서산고등학교,59,57,2,57,57,0,0,0
교육기관,교육부,서산공업고등학교,교육부 충청남도교육청 서산공업고등학교,37,35,2,35,28,5,1,1
교육기관,교육부,서산성봉학교,교육부 충청남도교육청 서산성봉학교,27,27,0,27,0,27,0,0
교육기관,교육부,서산여자고등학교,교육부 충청남도교육청 서산여자고등학교,31,12,19,12,4,5,2,1
교육기관,교육부,서산중앙고등학교,교육부 충청남도교육청 서산중앙고등학교,16,16,0,16,0,16,0,0
교육기관,교육부,서야고등학교,교육부 충청남도교육청 서야고등학교,18,18,0,18,0,18,0,0
교육기관,교육부,서일고등학교,교육부 충청남도교육청 서일고등학교,51,49,2,49,49,0,0,0
교육기관,교육부,서천고등학교,교육부 충청남도교육청 서천고등학교,42,42,0,42,0,42,0,0
교육기관,교육부,서천여자고등학교,교육부 충청남도교육청 서천여자고등학교,33,33,0,33,0,33,0,0
교육기관,교육부,서천여자정보고등학교,교육부 충청남도교육청 서천여자정보고등학교,45,40,5,40,35,5,0,0
교육기관,교육부,서해삼육고등학교,교육부 충청남도교육청 서해삼육고등학교,54,0,54,0,0,0,0,0
교육기관,교육부,설화고등학교,교육부 충청남도교육청 설화고등학교,79,79,0,79,67,12,0,0
교육기관,교육부,성광온누리학교,교육부 충청남도교육청 성광온누리학교,25,25,0,25,0,25,0,0
교육기관,교육부,성환고등학교,교육부 충청남도교육청 성환고등학교,62,62,0,62,62,0,0,0
교육기관,교육부,송악고등학교,교육부 충청남도교육청 송악고등학교,42,40,2,40,40,0,0,0
교육기관,교육부,신평고등학교,교육부 충청남도교육청 신평고등학교,28,28,0,28,24,4,0,0
교육기관,교육부,쌘뽈여자고등학교,교육부 충청남도교육청 쌘뽈여자고등학교,29,29,0,29,29,0,0,0
교육기관,교육부,아산고등학교,교육부 충청남도교육청 아산고등학교,69,69,0,69,59,10,0,0
교육기관,교육부,아산성심학교,교육부 충청남도교육청 아산성심학교,43,43,0,43,43,0,0,0
교육기관,교육부,안면고등학교,교육부 충청남도교육청 안면고등학교,15,14,1,14,14,0,0,0
교육기관,교육부,여해학교,교육부 충청남도교육청 여해학교,51,9,42,9,0,9,0,0
교육기관,교육부,예산고등학교,교육부 충청남도교육청 예산고등학교,131,34,97,34,0,34,0,0
교육기관,교육부,예산꿈빛학교,교육부 충청남도교육청 예산꿈빛학교,95,25,70,25,1,20,1,3
교육기관,교육부,예산여자고등학교,교육부 충청남도교육청 예산여자고등학교,26,26,0,26,26,0,0,0
교육기관,교육부,예산전자공업고등학교,교육부 충청남도교육청 예산전자공업고등학교,46,46,0,46,23,23,0,0
교육기관,교육부,온양고등학교,교육부 충청남도교육청 온양고등학교,55,55,0,55,2,53,0,0
교육기관,교육부,온양여자고등학교,교육부 충청남도교육청 온양여자고등학교,62,62,0,62,33,23,3,3
교육기관,교육부,온양용화고등학교,교육부 충청남도교육청 온양용화고등학교,88,88,0,88,1,87,0,0
교육기관,교육부,온양한올고등학교,교육부 충청남도교육청 온양한올고등학교,49,49,0,49,19,29,1,0
교육기관,교육부,웅천고등학교,교육부 충청남도교육청 웅천고등학교,9,9,0,9,5,4,0,0
교육기관,교육부,장항공업고등학교,교육부 충청남도교육청 장항공업고등학교,75,75,0,75,68,7,0,0
교육기관,교육부,정산고등학교,교육부 충청남도교육청 정산고등학교,40,40,0,40,28,12,0,0
교육기관,교육부,주산산업고등학교,교육부 충청남도교육청 주산산업고등학교,39,39,0,39,39,0,0,0
교육기관,교육부,천안고등학교,교육부 충청남도교육청 천안고등학교,142,42,100,42,18,20,2,2
교육기관,교육부,천안늘해랑학교,교육부 충청남도교육청 천안늘해랑학교,32,32,0,32,0,32,0,0
교육기관,교육부,천안두정고등학교,교육부 충청남도교육청 천안두정고등학교,43,42,1,42,14,28,0,0
교육기관,교육부,천안불당고등학교,교육부 충청남도교육청 천안불당고등학교,76,76,0,76,50,23,2,1
교육기관,교육부,천안상업고등학교,교육부 충청남도교육청 천안상업고등학교,51,51,0,51,0,51,0,0
교육기관,교육부,천안신당고등학교,교육부 충청남도교육청 천안신당고등학교,85,85,0,85,69,16,0,0
교육기관,교육부,천안쌍용고등학교,교육부 충청남도교육청 천안쌍용고등학교,45,45,0,45,0,45,0,0
교육기관,교육부,천안업성고등학교,교육부 충청남도교육청 천안업성고등학교,64,64,0,64,64,0,0,0
교육기관,교육부,천안여자고등학교,교육부 충청남도교육청 천안여자고등학교,56,0,56,0,0,0,0,0
교육기관,교육부,천안오성고등학교,교육부 충청남도교육청 천안오성고등학교,51,36,15,36,36,0,0,0
교육기관,교육부,천안월봉고등학교,교육부 충청남도교육청 천안월봉고등학교,73,73,0,73,50,23,0,0
교육기관,교육부,천안청수고등학교,교육부 충청남도교육청 천안청수고등학교,80,80,0,80,80,0,0,0
교육기관,교육부,청양고등학교,교육부 충청남도교육청 청양고등학교,91,91,0,91,82,9,0,0
교육기관,교육부,충남다사랑학교,교육부 충청남도교육청 충남다사랑학교,38,38,0,38,37,0,1,0
교육기관,교육부,충남드론항공고등학교,교육부 충청남도교육청 충남드론항공고등학교,66,0,66,0,0,0,0,0
교육기관,교육부,충남디자인예술고등학교,교육부 충청남도교육청 충남디자인예술고등학교,28,28,0,28,28,0,0,0
교육기관,교육부,충남삼성고등학교,교육부 충청남도교육청 충남삼성고등학교,275,16,259,16,16,0,0,0
교육기관,교육부,충남예술고등학교,교육부 충청남도교육청 충남예술고등학교,85,37,48,37,8,29,0,0
교육기관,교육부,충남외국어고등학교,교육부 충청남도교육청 충남외국어고등학교,113,109,4,109,109,0,0,0
교육기관,교육부,충남인터넷고등학교,교육부 충청남도교육청 충남인터넷고등학교,32,0,32,0,0,0,0,0
교육기관,교육부,충남체육고등학교,교육부 충청남도교육청 충남체육고등학교,46,46,0,46,46,0,0,0
교육기관,교육부,충남해양과학고등학교,교육부 충청남도교육청 충남해양과학고등학교,44,44,0,44,30,14,0,0
교육기관,교육부,충무교육원,교육부 충청남도교육청 충무교육원,20,20,0,20,20,0,0,0
교육기관,교육부,경천초등학교,교육부 충청남도교육청 충청남도공주교육지원청 경천초등학교,8,8,0,8,8,0,0,0
교육기관,교육부,계룡초등학교,교육부 충청남도교육청 충청남도공주교육지원청 계룡초등학교,10,10,0,10,5,5,0,0
교육기관,교육부,공주교동초등학교,교육부 충청남도교육청 충청남도공주교육지원청 공주교동초등학교,15,15,0,15,13,2,0,0
교육기관,교육부,공주도서관,교육부 충청남도교육청 충청남도공주교육지원청 공주도서관,12,12,0,12,0,12,0,0
교육기관,교육부,공주봉황초등학교,교육부 충청남도교육청 충청남도공주교육지원청 공주봉황초등학교,11,11,0,11,0,11,0,0
교육기관,교육부,공주신월초등학교,교육부 충청남도교육청 충청남도공주교육지원청 공주신월초등학교,24,24,0,24,18,6,0,0
교육기관,교육부,공주영명중학교,교육부 충청남도교육청 충청남도공주교육지원청 공주영명중학교,18,18,0,18,10,6,1,1
교육기관,교육부,공주중동초등학교,교육부 충청남도교육청 충청남도공주교육지원청 공주중동초등학교,24,24,0,24,2,22,0,0
교육기관,교육부,공주중학교,교육부 충청남도교육청 충청남도공주교육지원청 공주중학교,33,33,0,33,33,0,0,0
교육기관,교육부,구산초등학교,교육부 충청남도교육청 충청남도공주교육지원청 구산초등학교,14,14,0,14,7,7,0,0
교육기관,교육부,귀산초등학교,교육부 충청남도교육청 충청남도공주교육지원청 귀산초등학교,7,7,0,7,7,0,0,0
교육기관,교육부,마곡초등학교,교육부 충청남도교육청 충청남도공주교육지원청 마곡초등학교,9,9,0,9,9,0,0,0
교육기관,교육부,반포중학교,교육부 충청남도교육청 충청남도공주교육지원청 반포중학교,12,12,0,12,8,4,0,0
교육기관,교육부,반포초등학교,교육부 충청남도교육청 충청남도공주교육지원청 반포초등학교,12,12,0,12,12,0,0,0
교육기관,교육부,봉황중학교,교육부 충청남도교육청 충청남도공주교육지원청 봉황중학교,53,53,0,53,53,0,0,0
교육기관,교육부,부설초등학교,교육부 충청남도교육청 충청남도공주교육지원청 부설초등학교,37,37,0,37,6,31,0,0
교육기관,교육부,사곡중학교,교육부 충청남도교육청 충청남도공주교육지원청 사곡중학교,7,6,1,6,6,0,0,0
교육기관,교육부,상서초등학교,교육부 충청남도교육청 충청남도공주교육지원청 상서초등학교,12,12,0,12,12,0,0,0
교육기관,교육부,석송초등학교,교육부 충청남도교육청 충청남도공주교육지원청 석송초등학교,8,8,0,8,6,2,0,0
교육기관,교육부,수촌초등학교,교육부 충청남도교육청 충청남도공주교육지원청 수촌초등학교,13,13,0,13,13,0,0,0
교육기관,교육부,신관초등학교,교육부 충청남도교육청 충청남도공주교육지원청 신관초등학교,28,28,0,28,15,13,0,0
교육기관,교육부,신풍초등학교,교육부 충청남도교육청 충청남도공주교육지원청 신풍초등학교,12,12,0,12,12,0,0,0
교육기관,교육부,우성중학교,교육부 충청남도교육청 충청남도공주교육지원청 우성중학교,16,16,0,16,12,4,0,0
교육기관,교육부,우성초등학교,교육부 충청남도교육청 충청남도공주교육지원청 우성초등학교,18,18,0,18,11,7,0,0
교육기관,교육부,유구중학교,교육부 충청남도교육청 충청남도공주교육지원청 유구중학교,26,26,0,26,26,0,0,0
교육기관,교육부,유구초등학교,교육부 충청남도교육청 충청남도공주교육지원청 유구초등학교,26,26,0,26,23,3,0,0
교육기관,교육부,이인중학교,교육부 충청남도교육청 충청남도공주교육지원청 이인중학교,8,7,1,7,7,0,0,0
교육기관,교육부,이인초등학교,교육부 충청남도교육청 충청남도공주교육지원청 이인초등학교,7,7,0,7,2,3,1,1
교육기관,교육부,정안중학교,교육부 충청남도교육청 충청남도공주교육지원청 정안중학교,11,10,1,10,3,7,0,0
교육기관,교육부,정안초등학교,교육부 충청남도교육청 충청남도공주교육지원청 정안초등학교,8,8,0,8,0,8,0,0
교육기관,교육부,탄천중학교,교육부 충청남도교육청 충청남도공주교육지원청 탄천중학교,15,15,0,15,2,13,0,0
교육기관,교육부,탄천초등학교,교육부 충청남도교육청 충청남도공주교육지원청 탄천초등학교,8,8,0,8,8,0,0,0
교육기관,교육부,태봉초등학교,교육부 충청남도교육청 충청남도공주교육지원청 태봉초등학교,15,15,0,15,5,10,0,0
교육기관,교육부,학봉초등학교,교육부 충청남도교육청 충청남도공주교육지원청 학봉초등학교,14,14,0,14,0,14,0,0
교육기관,교육부,호계초등학교,교육부 충청남도교육청 충청남도공주교육지원청 호계초등학교,6,6,0,6,6,0,0,0
교육기관,교육부,효포초등학교,교육부 충청남도교육청 충청남도공주교육지원청 효포초등학교,11,11,0,11,11,0,0,0
교육기관,교육부,충청남도교육청과학교육원,교육부 충청남도교육청 충청남도교육청과학교육원,107,107,0,107,0,107,0,0
교육기관,교육부,충청남도교육청교육연수원,교육부 충청남도교육청 충청남도교육청교육연수원,12,12,0,12,12,0,0,0
교육기관,교육부,충청남도교육청남부평생교육원,교육부 충청남도교육청 충청남도교육청남부평생교육원,43,43,0,43,0,43,0,0
교육기관,교육부,충청남도교육청서부평생교육원,교육부 충청남도교육청 충청남도교육청서부평생교육원,33,33,0,33,9,24,0,0
교육기관,교육부,충청남도교육청안전수련원,교육부 충청남도교육청 충청남도교육청안전수련원,91,91,0,91,0,91,0,0
교육기관,교육부,충청남도교육청외국어교육원,교육부 충청남도교육청 충청남도교육청외국어교육원,16,16,0,16,0,16,0,0
교육기관,교육부,충청남도교육청유아교육원,교육부 충청남도교육청 충청남도교육청유아교육원,40,40,0,40,0,40,0,0
교육기관,교육부,남부체험교육원,교육부 충청남도교육청 충청남도교육청유아교육원 남부체험교육원,35,35,0,35,18,17,0,0
교육기관,교육부,북부체험교육원,교육부 충청남도교육청 충청남도교육청유아교육원 북부체험교육원,53,49,4,49,30,19,0,0
교육기관,교육부,충청남도교육청진로융합교육원,교육부 충청남도교육청 충청남도교육청진로융합교육원,37,37,0,37,0,37,0,0
교육기관,교육부,충청남도교육청평생교육원,교육부 충청남도교육청 충청남도교육청평생교육원,29,29,0,29,0,29,0,0
교육기관,교육부,충청남도교육청학생교육문화원,교육부 충청남도교육청 충청남도교육청학생교육문화원,58,58,0,58,0,58,0,0
교육기관,교육부,충청남도교육청해양수련원,교육부 충청남도교육청 충청남도교육청해양수련원,70,70,0,70,0,70,0,0
교육기관,교육부,충청남도금산교육지원청,교육부 충청남도교육청 충청남도금산교육지원청,35,35,0,35,1,34,0,0
교육기관,교육부,군북초등학교,교육부 충청남도교육청 충청남도금산교육지원청 군북초등학교,15,15,0,15,15,0,0,0
교육기관,교육부,금산도서관,교육부 충청남도교육청 충청남도금산교육지원청 금산도서관,8,8,0,8,0,8,0,0
교육기관,교육부,금산여자중학교,교육부 충청남도교육청 충청남도금산교육지원청 금산여자중학교,22,20,2,20,18,2,0,0
교육기관,교육부,금산중앙초등학교,교육부 충청남도교육청 충청남도금산교육지원청 금산중앙초등학교,25,25,0,25,25,0,0,0
교육기관,교육부,금산중학교,교육부 충청남도교육청 충청남도금산교육지원청 금산중학교,14,12,2,12,8,3,1,0
교육기관,교육부,금산초등학교,교육부 충청남도교육청 충청남도금산교육지원청 금산초등학교,31,31,0,31,0,31,0,0
교육기관,교육부,금성초등학교,교육부 충청남도교육청 충청남도금산교육지원청 금성초등학교,15,15,0,15,15,0,0,0
교육기관,교육부,남이초등학교,교육부 충청남도교육청 충청남도금산교육지원청 남이초등학교,12,12,0,12,8,4,0,0
교육기관,교육부,남일초등학교,교육부 충청남도교육청 충청남도금산교육지원청 남일초등학교,9,9,0,9,5,4,0,0
교육기관,교육부,복수중학교,교육부 충청남도교육청 충청남도금산교육지원청 복수중학교,12,11,1,11,5,6,0,0
교육기관,교육부,복수초등학교,교육부 충청남도교육청 충청남도금산교육지원청 복수초등학교,13,13,0,13,13,0,0,0
교육기관,교육부,부리중학교,교육부 충청남도교육청 충청남도금산교육지원청 부리중학교,8,8,0,8,4,4,0,0
교육기관,교육부,부리초등학교,교육부 충청남도교육청 충청남도금산교육지원청 부리초등학교,7,7,0,7,7,0,0,0
교육기관,교육부,상곡초등학교,교육부 충청남도교육청 충청남도금산교육지원청 상곡초등학교,16,16,0,16,0,16,0,0
교육기관,교육부,용문초등학교,교육부 충청남도교육청 충청남도금산교육지원청 용문초등학교,16,16,0,16,14,2,0,0
교육기관,교육부,제원중학교,교육부 충청남도교육청 충청남도금산교육지원청 제원중학교,17,17,0,17,17,0,0,0
교육기관,교육부,제원초등학교,교육부 충청남도교육청 충청남도금산교육지원청 제원초등학교,22,22,0,22,11,11,0,0
교육기관,교육부,진산중학교,교육부 충청남도교육청 충청남도금산교육지원청 진산중학교,8,8,0,8,5,3,0,0
교육기관,교육부,진산초등학교,교육부 충청남도교육청 충청남도금산교육지원청 진산초등학교,16,16,0,16,12,4,0,0
교육기관,교육부,추부중학교,교육부 충청남도교육청 충청남도금산교육지원청 추부중학교,25,25,0,25,8,1,1,15
교육기관,교육부,추부초등학교,교육부 충청남도교육청 충청남도금산교육지원청 추부초등학교,15,15,0,15,15,0,0,0
교육기관,교육부,충청남도논산계룡교육지원청,교육부 충청남도교육청 충청남도논산계룡교육지원청,15,7,8,7,0,7,0,0
교육기관,교육부,가야곡중학교,교육부 충청남도교육청 충청남도논산계룡교육지원청 가야곡중학교,14,14,0,14,14,0,0,0
교육기관,교육부,가야곡초등학교,교육부 충청남도교육청 충청남도논산계룡교육지원청 가야곡초등학교,14,14,0,14,10,4,0,0
교육기관,교육부,감곡초등학교,교육부 충청남도교육청 충청남도논산계룡교육지원청 감곡초등학교,16,16,0,16,16,0,0,0
교육기관,교육부,강경산양초등학교,교육부 충청남도교육청 충청남도논산계룡교육지원청 강경산양초등학교,22,22,0,22,19,3,0,0
교육기관,교육부,강경여자중학교,교육부 충청남도교육청 충청남도논산계룡교육지원청 강경여자중학교,16,16,0,16,11,5,0,0
교육기관,교육부,강경중앙초등학교,교육부 충청남도교육청 충청남도논산계룡교육지원청 강경중앙초등학교,8,8,0,8,8,0,0,0
교육기관,교육부,강경중학교,교육부 충청남도교육청 충청남도논산계룡교육지원청 강경중학교,37,37,0,37,2,35,0,0
교육기관,교육부,강경황산초등학교,교육부 충청남도교육청 충청남도논산계룡교육지원청 강경황산초등학교,10,10,0,10,10,0,0,0
교육기관,교육부,계룡중학교,교육부 충청남도교육청 충청남도논산계룡교육지원청 계룡중학교,38,38,0,38,25,13,0,0
교육기관,교육부,광석중학교,교육부 충청남도교육청 충청남도논산계룡교육지원청 광석중학교,18,18,0,18,0,18,0,0
교육기관,교육부,광석초등학교,교육부 충청남도교육청 충청남도논산계룡교육지원청 광석초등학교,9,9,0,9,9,0,0,0
교육기관,교육부,구자곡초등학교,교육부 충청남도교육청 충청남도논산계룡교육지원청 구자곡초등학교,10,10,0,10,10,0,0,0
교육기관,교육부,금암초등학교,교육부 충청남도교육청 충청남도논산계룡교육지원청 금암초등학교,14,14,0,14,8,6,0,0
교육기관,교육부,기민중학교,교육부 충청남도교육청 충청남도논산계룡교육지원청 기민중학교,36,36,0,36,22,14,0,0
교육기관,교육부,노성중학교,교육부 충청남도교육청 충청남도논산계룡교육지원청 노성중학교,16,16,0,16,16,0,0,0
교육기관,교육부,노성초등학교,교육부 충청남도교육청 충청남도논산계룡교육지원청 노성초등학교,8,8,0,8,2,6,0,0
교육기관,교육부,논산내동초등학교,교육부 충청남도교육청 충청남도논산계룡교육지원청 논산내동초등학교,22,22,0,22,22,0,0,0
교육기관,교육부,논산대건중학교,교육부 충청남도교육청 충청남도논산계룡교육지원청 논산대건중학교,27,27,0,27,11,16,0,0
교육기관,교육부,논산동성초등학교,교육부 충청남도교육청 충청남도논산계룡교육지원청 논산동성초등학교,19,19,0,19,18,1,0,0
교육기관,교육부,논산반월초등학교,교육부 충청남도교육청 충청남도논산계룡교육지원청 논산반월초등학교,11,11,0,11,11,0,0,0
교육기관,교육부,논산부창초등학교,교육부 충청남도교육청 충청남도논산계룡교육지원청 논산부창초등학교,23,23,0,23,23,0,0,0
교육기관,교육부,논산여자중학교,교육부 충청남도교육청 충청남도논산계룡교육지원청 논산여자중학교,29,27,2,27,8,17,2,0
교육기관,교육부,논산중앙초등학교,교육부 충청남도교육청 충청남도논산계룡교육지원청 논산중앙초등학교,17,17,0,17,9,8,0,0
교육기관,교육부,논산중학교,교육부 충청남도교육청 충청남도논산계룡교육지원청 논산중학교,44,44,0,44,38,6,0,0
교육기관,교육부,도산초등학교,교육부 충청남도교육청 충청남도논산계룡교육지원청 도산초등학교,18,18,0,18,13,3,2,0
교육기관,교육부,두마초등학교,교육부 충청남도교육청 충청남도논산계룡교육지원청 두마초등학교,34,0,34,0,0,0,0,0
교육기관,교육부,반곡초등학교,교육부 충청남도교육청 충청남도논산계룡교육지원청 반곡초등학교,8,8,0,8,4,4,0,0
교육기관,교육부,백석초등학교,교육부 충청남도교육청 충청남도논산계룡교육지원청 백석초등학교,15,15,0,15,0,15,0,0
교육기관,교육부,벌곡초등학교,교육부 충청남도교육청 충청남도논산계룡교육지원청 벌곡초등학교,12,12,0,12,6,6,0,0
교육기관,교육부,부적초등학교,교육부 충청남도교육청 충청남도논산계룡교육지원청 부적초등학교,9,9,0,9,0,9,0,0
교육기관,교육부,상월초등학교,교육부 충청남도교육청 충청남도논산계룡교육지원청 상월초등학교,11,11,0,11,0,11,0,0
교육기관,교육부,성덕초등학교,교육부 충청남도교육청 충청남도논산계룡교육지원청 성덕초등학교,12,0,12,0,0,0,0,0
교육기관,교육부,성동초등학교,교육부 충청남도교육청 충청남도논산계룡교육지원청 성동초등학교,8,8,0,8,0,8,0,0
교육기관,교육부,신도초등학교,교육부 충청남도교육청 충청남도논산계룡교육지원청 신도초등학교,15,15,0,15,0,15,0,0
교육기관,교육부,쌘뽈여자중학교,교육부 충청남도교육청 충청남도논산계룡교육지원청 쌘뽈여자중학교,17,17,0,17,0,17,0,0
교육기관,교육부,양촌초등학교,교육부 충청남도교육청 충청남도논산계룡교육지원청 양촌초등학교,15,15,0,15,11,3,1,0
교육기관,교육부,엄사중학교,교육부 충청남도교육청 충청남도논산계룡교육지원청 엄사중학교,85,85,0,85,80,5,0,0
교육기관,교육부,엄사초등학교,교육부 충청남도교육청 충청남도논산계룡교육지원청 엄사초등학교,22,16,6,16,10,4,1,1
교육기관,교육부,연무중앙초등학교,교육부 충청남도교육청 충청남도논산계룡교육지원청 연무중앙초등학교,14,14,0,14,6,6,1,1
교육기관,교육부,연무중학교,교육부 충청남도교육청 충청남도논산계룡교육지원청 연무중학교,25,25,0,25,12,13,0,0
교육기관,교육부,연무초등학교,교육부 충청남도교육청 충청남도논산계룡교육지원청 연무초등학교,9,9,0,9,9,0,0,0
교육기관,교육부,연산중학교,교육부 충청남도교육청 충청남도논산계룡교육지원청 연산중학교,35,35,0,35,0,35,0,0
교육기관,교육부,연산초등학교,교육부 충청남도교육청 충청남도논산계룡교육지원청 연산초등학교,22,22,0,22,11,11,0,0
교육기관,교육부,왕전초등학교,교육부 충청남도교육청 충청남도논산계룡교육지원청 왕전초등학교,7,7,0,7,6,1,0,0
교육기관,교육부,용남중학교,교육부 충청남도교육청 충청남도논산계룡교육지원청 용남중학교,28,13,15,13,10,3,0,0
교육기관,교육부,용남초등학교,교육부 충청남도교육청 충청남도논산계룡교육지원청 용남초등학교,25,25,0,25,25,0,0,0
교육기관,교육부,원봉초등학교,교육부 충청남도교육청 충청남도논산계룡교육지원청 원봉초등학교,8,8,0,8,8,0,0,0
교육기관,교육부,은진초등학교,교육부 충청남도교육청 충청남도논산계룡교육지원청 은진초등학교,16,16,0,16,16,0,0,0
교육기관,교육부,이화초등학교,교육부 충청남도교육청 충청남도논산계룡교육지원청 이화초등학교,12,12,0,12,12,0,0,0
교육기관,교육부,채운초등학교,교육부 충청남도교육청 충청남도논산계룡교육지원청 채운초등학교,14,14,0,14,14,0,0,0
교육기관,교육부,청동초등학교,교육부 충청남도교육청 충청남도논산계룡교육지원청 청동초등학교,8,8,0,8,0,8,0,0
교육기관,교육부,충청남도당진교육지원청,교육부 충청남도교육청 충청남도당진교육지원청,18,18,0,18,0,18,0,0
교육기관,교육부,계성초등학교,교육부 충청남도교육청 충청남도당진교육지원청 계성초등학교,32,32,0,32,32,0,0,0
교육기관,교육부,고대중학교,교육부 충청남도교육청 충청남도당진교육지원청 고대중학교,14,14,0,14,10,4,0,0
교육기관,교육부,고대초등학교,교육부 충청남도교육청 충청남도당진교육지원청 고대초등학교,14,14,0,14,2,10,2,0
교육기관,교육부,고산초등학교,교육부 충청남도교육청 충청남도당진교육지원청 고산초등학교,9,9,0,9,9,0,0,0
교육기관,교육부,기지초등학교,교육부 충청남도교육청 충청남도당진교육지원청 기지초등학교,25,25,0,25,25,0,0,0
교육기관,교육부,당산초등학교,교육부 충청남도교육청 충청남도당진교육지원청 당산초등학교,13,13,0,13,0,13,0,0
교육기관,교육부,당진도서관,교육부 충청남도교육청 충청남도당진교육지원청 당진도서관,16,16,0,16,0,16,0,0
교육기관,교육부,당진중학교,교육부 충청남도교육청 충청남도당진교육지원청 당진중학교,42,42,0,42,18,18,6,0
교육기관,교육부,당진중학교대호지분교장,교육부 충청남도교육청 충청남도당진교육지원청 당진중학교대호지분교장,10,10,0,10,2,8,0,0
교육기관,교육부,당진초등학교,교육부 충청남도교육청 충청남도당진교육지원청 당진초등학교,36,36,0,36,36,0,0,0
교육기관,교육부,대덕초등학교,교육부 충청남도교육청 충청남도당진교육지원청 대덕초등학교,59,59,0,59,41,18,0,0
교육기관,교육부,면천초등학교,교육부 충청남도교육청 충청남도당진교육지원청 면천초등학교,32,32,0,32,16,16,0,0
교육기관,교육부,북창초등학교,교육부 충청남도교육청 충청남도당진교육지원청 북창초등학교,26,26,0,26,12,12,2,0
교육기관,교육부,삼봉초등학교,교육부 충청남도교육청 충청남도당진교육지원청 삼봉초등학교,16,16,0,16,8,8,0,0
교육기관,교육부,상록초등학교,교육부 충청남도교육청 충청남도당진교육지원청 상록초등학교,22,22,0,22,17,5,0,0
교육기관,교육부,서야중학교,교육부 충청남도교육청 충청남도당진교육지원청 서야중학교,4,4,0,4,0,4,0,0
교육기관,교육부,서정초등학교,교육부 충청남도교육청 충청남도당진교육지원청 서정초등학교,35,35,0,35,35,0,0,0
교육기관,교육부,석문중학교,교육부 충청남도교육청 충청남도당진교육지원청 석문중학교,24,23,1,23,0,23,0,0
교육기관,교육부,석문초등학교,교육부 충청남도교육청 충청남도당진교육지원청 석문초등학교,16,16,0,16,16,0,0,0
교육기관,교육부,송산중학교,교육부 충청남도교육청 충청남도당진교육지원청 송산중학교,23,23,0,23,21,2,0,0
교육기관,교육부,송산초등학교,교육부 충청남도교육청 충청남도당진교육지원청 송산초등학교,12,12,0,12,12,0,0,0
교육기관,교육부,송악중학교,교육부 충청남도교육청 충청남도당진교육지원청 송악중학교,46,45,1,45,43,1,1,0
교육기관,교육부,송악초등학교,교육부 충청남도교육청 충청남도당진교육지원청 송악초등학교,20,20,0,20,0,20,0,0
교육기관,교육부,순성중학교,교육부 충청남도교육청 충청남도당진교육지원청 순성중학교,29,28,1,28,27,1,0,0
교육기관,교육부,순성초등학교,교육부 충청남도교육청 충청남도당진교육지원청 순성초등학교,32,32,0,32,32,0,0,0
교육기관,교육부,신촌초등학교,교육부 충청남도교육청 충청남도당진교육지원청 신촌초등학교,11,11,0,11,8,1,1,1
교육기관,교육부,신평중학교,교육부 충청남도교육청 충청남도당진교육지원청 신평중학교,27,27,0,27,27,0,0,0
교육기관,교육부,신평초등학교,교육부 충청남도교육청 충청남도당진교육지원청 신평초등학교,16,16,0,16,15,1,0,0
교육기관,교육부,우강초등학교,교육부 충청남도교육청 충청남도당진교육지원청 우강초등학교,17,17,0,17,8,9,0,0
교육기관,교육부,원당중학교,교육부 충청남도교육청 충청남도당진교육지원청 원당중학교,40,40,0,40,40,0,0,0
교육기관,교육부,원당초등학교,교육부 충청남도교육청 충청남도당진교육지원청 원당초등학교,41,41,0,41,27,14,0,0
교육기관,교육부,유곡초등학교,교육부 충청남도교육청 충청남도당진교육지원청 유곡초등학교,16,16,0,16,11,5,0,0
교육기관,교육부,전대초등학교,교육부 충청남도교육청 충청남도당진교육지원청 전대초등학교,14,14,0,14,14,0,0,0
교육기관,교육부,정미초등학교,교육부 충청남도교육청 충청남도당진교육지원청 정미초등학교,16,16,0,16,9,7,0,0
교육기관,교육부,조금초등학교,교육부 충청남도교육청 충청남도당진교육지원청 조금초등학교,12,12,0,12,6,6,0,0
교육기관,교육부,천의초등학교,교육부 충청남도교육청 충청남도당진교육지원청 천의초등학교,21,17,4,17,5,12,0,0
교육기관,교육부,초락초등학교,교육부 충청남도교육청 충청남도당진교육지원청 초락초등학교,8,8,0,8,4,4,0,0
교육기관,교육부,탑동초등학교,교육부 충청남도교육청 충청남도당진교육지원청 탑동초등학교,34,34,0,34,24,4,5,1
교육기관,교육부,한정초등학교,교육부 충청남도교육청 충청남도당진교육지원청 한정초등학교,24,24,0,24,24,0,0,0
교육기관,교육부,합덕여자중학교,교육부 충청남도교육청 충청남도당진교육지원청 합덕여자중학교,11,10,1,10,10,0,0,0
교육기관,교육부,합덕중학교,교육부 충청남도교육청 충청남도당진교육지원청 합덕중학교,5,5,0,5,0,5,0,0
교육기관,교육부,합도초등학교,교육부 충청남도교육청 충청남도당진교육지원청 합도초등학교,18,18,0,18,16,1,0,1
교육기관,교육부,호서중학교,교육부 충청남도교육청 충청남도당진교육지원청 호서중학교,31,31,0,31,6,25,0,0
교육기관,교육부,충청남도보령교육지원청,교육부 충청남도교육청 충청남도보령교육지원청,5,5,0,5,5,0,0,0
교육기관,교육부,개화초등학교,교육부 충청남도교육청 충청남도보령교육지원청 개화초등학교,8,8,0,8,4,4,0,0
교육기관,교육부,관당초등학교,교육부 충청남도교육청 충청남도보령교육지원청 관당초등학교,8,8,0,8,0,8,0,0
교육기관,교육부,관창초등학교,교육부 충청남도교육청 충청남도보령교육지원청 관창초등학교,6,6,0,6,6,0,0,0
교육기관,교육부,광명초등학교,교육부 충청남도교육청 충청남도보령교육지원청 광명초등학교,8,8,0,8,6,2,0,0
교육기관,교육부,낙동초등학교,교육부 충청남도교육청 충청남도보령교육지원청 낙동초등학교,4,4,0,4,0,4,0,0
교육기관,교육부,남포중학교,교육부 충청남도교육청 충청남도보령교육지원청 남포중학교,7,7,0,7,7,0,0,0
교육기관,교육부,남포초등학교,교육부 충청남도교육청 충청남도보령교육지원청 남포초등학교,6,6,0,6,6,0,0,0
교육기관,교육부,대관초등학교,교육부 충청남도교육청 충청남도보령교육지원청 대관초등학교,16,16,0,16,3,13,0,0
교육기관,교육부,대남초등학교,교육부 충청남도교육청 충청남도보령교육지원청 대남초등학교,8,8,0,8,5,3,0,0
교육기관,교육부,대명중학교,교육부 충청남도교육청 충청남도보령교육지원청 대명중학교,23,23,0,23,19,1,2,1
교육기관,교육부,대천동대초등학교,교육부 충청남도교육청 충청남도보령교육지원청 대천동대초등학교,36,36,0,36,36,0,0,0
교육기관,교육부,대천서중학교,교육부 충청남도교육청 충청남도보령교육지원청 대천서중학교,13,13,0,13,11,2,0,0
교육기관,교육부,대천여자중학교,교육부 충청남도교육청 충청남도보령교육지원청 대천여자중학교,20,20,0,20,16,4,0,0
교육기관,교육부,대천중학교,교육부 충청남도교육청 충청남도보령교육지원청 대천중학교,47,18,29,18,0,18,0,0
교육기관,교육부,대천초등학교,교육부 충청남도교육청 충청남도보령교육지원청 대천초등학교,16,16,0,16,16,0,0,0
교육기관,교육부,명천초등학교,교육부 충청남도교육청 충청남도보령교육지원청 명천초등학교,13,13,0,13,7,6,0,0
교육기관,교육부,미산중학교,교육부 충청남도교육청 충청남도보령교육지원청 미산중학교,14,13,1,13,1,12,0,0
교육기관,교육부,보령중학교,교육부 충청남도교육청 충청남도보령교육지원청 보령중학교,8,8,0,8,4,4,0,0
교육기관,교육부,성주초등학교,교육부 충청남도교육청 충청남도보령교육지원청 성주초등학교,7,7,0,7,5,2,0,0
교육기관,교육부,오천초등학교,교육부 충청남도교육청 충청남도보령교육지원청 오천초등학교,8,8,0,8,3,3,1,1
교육기관,교육부,옥계초등학교,교육부 충청남도교육청 충청남도보령교육지원청 옥계초등학교,10,10,0,10,5,5,0,0
교육기관,교육부,외연도초등학교,교육부 충청남도교육청 충청남도보령교육지원청 외연도초등학교,8,8,0,8,8,0,0,0
교육기관,교육부,웅천중학교,교육부 충청남도교육청 충청남도보령교육지원청 웅천중학교,13,13,0,13,13,0,0,0
교육기관,교육부,월전초등학교,교육부 충청남도교육청 충청남도보령교육지원청 월전초등학교,8,8,0,8,5,3,0,0
교육기관,교육부,주산중학교,교육부 충청남도교육청 충청남도보령교육지원청 주산중학교,8,8,0,8,4,4,0,0
교육기관,교육부,주산초등학교,교육부 충청남도교육청 충청남도보령교육지원청 주산초등학교,8,8,0,8,4,4,0,0
교육기관,교육부,주포초등학교,교육부 충청남도교육청 충청남도보령교육지원청 주포초등학교,12,12,0,12,0,12,0,0
교육기관,교육부,천북중학교,교육부 충청남도교육청 충청남도보령교육지원청 천북중학교,8,7,1,7,5,2,0,0
교육기관,교육부,천북초등학교,교육부 충청남도교육청 충청남도보령교육지원청 천북초등학교,13,13,0,13,0,13,0,0
교육기관,교육부,청라중학교,교육부 충청남도교육청 충청남도보령교육지원청 청라중학교,30,29,1,29,29,0,0,0
교육기관,교육부,청라초등학교,교육부 충청남도교육청 충청남도보령교육지원청 청라초등학교,8,8,0,8,8,0,0,0
교육기관,교육부,청룡초등학교,교육부 충청남도교육청 충청남도보령교육지원청 청룡초등학교,12,12,0,12,0,12,0,0
교육기관,교육부,청소초등학교,교육부 충청남도교육청 충청남도보령교육지원청 청소초등학교,8,8,0,8,8,0,0,0
교육기관,교육부,청파초등학교,교육부 충청남도교육청 충청남도보령교육지원청 청파초등학교,6,6,0,6,6,0,0,0
교육기관,교육부,충청남도보령교육지원청웅천도서관,교육부 충청남도교육청 충청남도보령교육지원청 충청남도보령교육지원청웅천도서관,7,7,0,7,3,4,0,0
교육기관,교육부,한내여자중학교,교육부 충청남도교육청 충청남도보령교육지원청 한내여자중학교,31,31,0,31,31,0,0,0
교육기관,교육부,한내초등학교,교육부 충청남도교육청 충청남도보령교육지원청 한내초등학교,21,21,0,21,6,15,0,0
교육기관,교육부,충청남도부여교육지원청,교육부 충청남도교육청 충청남도부여교육지원청,10,10,0,10,0,10,0,0
교육기관,교육부,구룡초등학교,교육부 충청남도교육청 충청남도부여교육지원청 구룡초등학교,14,14,0,14,12,2,0,0
교육기관,교육부,궁남초등학교,교육부 충청남도교육청 충청남도부여교육지원청 궁남초등학교,15,15,0,15,15,0,0,0
교육기관,교육부,규암초등학교,교육부 충청남도교육청 충청남도부여교육지원청 규암초등학교,18,18,0,18,18,0,0,0
교육기관,교육부,내산초등학교,교육부 충청남도교육청 충청남도부여교육지원청 내산초등학교,8,8,0,8,4,4,0,0
교육기관,교육부,대왕초등학교,교육부 충청남도교육청 충청남도부여교육지원청 대왕초등학교,11,11,0,11,11,0,0,0
교육기관,교육부,마정초등학교,교육부 충청남도교육청 충청남도부여교육지원청 마정초등학교,7,7,0,7,7,0,0,0
교육기관,교육부,백강초등학교,교육부 충청남도교육청 충청남도부여교육지원청 백강초등학교,7,7,0,7,7,0,0,0
교육기관,교육부,백제중학교,교육부 충청남도교육청 충청남도부여교육지원청 백제중학교,46,46,0,46,26,20,0,0
교육기관,교육부,백제초등학교,교육부 충청남도교육청 충청남도부여교육지원청 백제초등학교,16,16,0,16,16,0,0,0
교육기관,교육부,부여도서관,교육부 충청남도교육청 충청남도부여교육지원청 부여도서관,14,14,0,14,0,14,0,0
교육기관,교육부,부여여자중학교,교육부 충청남도교육청 충청남도부여교육지원청 부여여자중학교,42,42,0,42,16,26,0,0
교육기관,교육부,부여중학교,교육부 충청남도교육청 충청남도부여교육지원청 부여중학교,62,62,0,62,45,15,1,1
교육기관,교육부,부여초등학교,교육부 충청남도교육청 충청남도부여교육지원청 부여초등학교,18,18,0,18,18,0,0,0
교육기관,교육부,석성중학교,교육부 충청남도교육청 충청남도부여교육지원청 석성중학교,10,10,0,10,8,2,0,0
교육기관,교육부,석성초등학교,교육부 충청남도교육청 충청남도부여교육지원청 석성초등학교,10,10,0,10,10,0,0,0
교육기관,교육부,석양초등학교,교육부 충청남도교육청 충청남도부여교육지원청 석양초등학교,15,15,0,15,15,0,0,0
교육기관,교육부,세도중학교,교육부 충청남도교육청 충청남도부여교육지원청 세도중학교,11,10,1,10,0,10,0,0
교육기관,교육부,세도초등학교,교육부 충청남도교육청 충청남도부여교육지원청 세도초등학교,8,8,0,8,3,5,0,0
교육기관,교육부,송간초등학교,교육부 충청남도교육청 충청남도부여교육지원청 송간초등학교,11,11,0,11,11,0,0,0
교육기관,교육부,양화중학교,교육부 충청남도교육청 충청남도부여교육지원청 양화중학교,8,8,0,8,4,4,0,0
교육기관,교육부,양화초등학교,교육부 충청남도교육청 충청남도부여교육지원청 양화초등학교,5,5,0,5,5,0,0,0
교육기관,교육부,외산초등학교,교육부 충청남도교육청 충청남도부여교육지원청 외산초등학교,10,10,0,10,5,5,0,0
교육기관,교육부,용강중학교,교육부 충청남도교육청 충청남도부여교육지원청 용강중학교,24,24,0,24,24,0,0,0
교육기관,교육부,용당초등학교,교육부 충청남도교육청 충청남도부여교육지원청 용당초등학교,11,11,0,11,7,4,0,0
교육기관,교육부,은산중학교,교육부 충청남도교육청 충청남도부여교육지원청 은산중학교,24,24,0,24,18,4,1,1
교육기관,교육부,은산초등학교,교육부 충청남도교육청 충청남도부여교육지원청 은산초등학교,15,15,0,15,10,3,1,1
교육기관,교육부,임천중학교,교육부 충청남도교육청 충청남도부여교육지원청 임천중학교,16,15,1,15,0,15,0,0
교육기관,교육부,임천초등학교,교육부 충청남도교육청 충청남도부여교육지원청 임천초등학교,8,8,0,8,8,0,0,0
교육기관,교육부,장암초등학교,교육부 충청남도교육청 충청남도부여교육지원청 장암초등학교,12,12,0,12,12,0,0,0
교육기관,교육부,초촌초등학교,교육부 충청남도교육청 충청남도부여교육지원청 초촌초등학교,12,12,0,12,6,6,0,0
교육기관,교육부,충화초등학교,교육부 충청남도교육청 충청남도부여교육지원청 충화초등학교,10,10,0,10,8,2,0,0
교육기관,교육부,합송초등학교,교육부 충청남도교육청 충청남도부여교육지원청 합송초등학교,10,10,0,10,4,3,2,1
교육기관,교육부,홍산중학교,교육부 충청남도교육청 충청남도부여교육지원청 홍산중학교,12,12,0,12,12,0,0,0
교육기관,교육부,홍산초등학교,교육부 충청남도교육청 충청남도부여교육지원청 홍산초등학교,11,11,0,11,11,0,0,0
교육기관,교육부,충청남도서산교육지원청,교육부 충청남도교육청 충청남도서산교육지원청,32,32,0,32,0,32,0,0
교육기관,교육부,가사초등학교,교육부 충청남도교육청 충청남도서산교육지원청 가사초등학교,12,12,0,12,8,4,0,0
교육기관,교육부,강당초등학교,교육부 충청남도교육청 충청남도서산교육지원청 강당초등학교,9,9,0,9,4,5,0,0
교육기관,교육부,고북중학교,교육부 충청남도교육청 충청남도서산교육지원청 고북중학교,15,14,1,14,14,0,0,0
교육기관,교육부,고북초등학교,교육부 충청남도교육청 충청남도서산교육지원청 고북초등학교,22,22,0,22,22,0,0,0
교육기관,교육부,대산중학교,교육부 충청남도교육청 충청남도서산교육지원청 대산중학교,26,25,1,25,25,0,0,0
교육기관,교육부,대산초등학교,교육부 충청남도교육청 충청남도서산교육지원청 대산초등학교,28,28,0,28,14,14,0,0
교육기관,교육부,대철중학교,교육부 충청남도교육청 충청남도서산교육지원청 대철중학교,25,23,2,23,23,0,0,0
교육기관,교육부,동암초등학교,교육부 충청남도교육청 충청남도서산교육지원청 동암초등학교,16,16,0,16,16,0,0,0
교육기관,교육부,명지초등학교,교육부 충청남도교육청 충청남도서산교육지원청 명지초등학교,9,9,0,9,9,0,0,0
교육기관,교육부,부석중학교,교육부 충청남도교육청 충청남도서산교육지원청 부석중학교,13,0,13,0,0,0,0,0
교육기관,교육부,부석초등학교,교육부 충청남도교육청 충청남도서산교육지원청 부석초등학교,16,16,0,16,0,16,0,0
교육기관,교육부,부성초등학교,교육부 충청남도교육청 충청남도서산교육지원청 부성초등학교,17,17,0,17,17,0,0,0
교육기관,교육부,부춘초등학교,교육부 충청남도교육청 충청남도서산교육지원청 부춘초등학교,22,22,0,22,22,0,0,0
교육기관,교육부,서동초등학교,교육부 충청남도교육청 충청남도서산교육지원청 서동초등학교,15,15,0,15,0,15,0,0
교육기관,교육부,서령중학교,교육부 충청남도교육청 충청남도서산교육지원청 서령중학교,33,14,19,14,4,7,1,2
교육기관,교육부,서령초등학교,교육부 충청남도교육청 충청남도서산교육지원청 서령초등학교,12,12,0,12,0,12,0,0
교육기관,교육부,서림초등학교,교육부 충청남도교육청 충청남도서산교육지원청 서림초등학교,14,14,0,14,0,14,0,0
교육기관,교육부,서산대진초등학교,교육부 충청남도교육청 충청남도서산교육지원청 서산대진초등학교,8,8,0,8,4,4,0,0
교육기관,교육부,서산동문초등학교,교육부 충청남도교육청 충청남도서산교육지원청 서산동문초등학교,32,32,0,32,16,16,0,0
교육기관,교육부,서산명지중학교,교육부 충청남도교육청 충청남도서산교육지원청 서산명지중학교,35,34,1,34,34,0,0,0
교육기관,교육부,서산부춘중학교,교육부 충청남도교육청 충청남도서산교육지원청 서산부춘중학교,35,34,1,34,21,13,0,0
교육기관,교육부,서산서남초등학교,교육부 충청남도교육청 충청남도서산교육지원청 서산서남초등학교,64,64,0,64,0,64,0,0
교육기관,교육부,서산석림중학교,교육부 충청남도교육청 충청남도서산교육지원청 서산석림중학교,48,48,0,48,48,0,0,0
교육기관,교육부,서산석림초등학교,교육부 충청남도교육청 충청남도서산교육지원청 서산석림초등학교,27,27,0,27,10,17,0,0
교육기관,교육부,서산예천초등학교,교육부 충청남도교육청 충청남도서산교육지원청 서산예천초등학교,28,28,0,28,28,0,0,0
교육기관,교육부,서산중학교,교육부 충청남도교육청 충청남도서산교육지원청 서산중학교,58,58,0,58,45,7,6,0
교육기관,교육부,서산초등학교,교육부 충청남도교육청 충청남도서산교육지원청 서산초등학교,16,16,0,16,0,16,0,0
교육기관,교육부,서산해미도서관,교육부 충청남도교육청 충청남도서산교육지원청 서산해미도서관,4,4,0,4,0,4,0,0
교육기관,교육부,서일중학교,교육부 충청남도교육청 충청남도서산교육지원청 서일중학교,17,15,2,15,15,0,0,0
교육기관,교육부,성연중학교,교육부 충청남도교육청 충청남도서산교육지원청 성연중학교,24,24,0,24,24,0,0,0
교육기관,교육부,성연초등학교,교육부 충청남도교육청 충청남도서산교육지원청 성연초등학교,52,52,0,52,52,0,0,0
교육기관,교육부,언암초등학교,교육부 충청남도교육청 충청남도서산교육지원청 언암초등학교,18,18,0,18,18,0,0,0
교육기관,교육부,오산초등학교,교육부 충청남도교육청 충청남도서산교육지원청 오산초등학교,9,9,0,9,4,5,0,0
교육기관,교육부,운산초등학교,교육부 충청남도교육청 충청남도서산교육지원청 운산초등학교,21,21,0,21,14,7,0,0
교육기관,교육부,운신초등학교,교육부 충청남도교육청 충청남도서산교육지원청 운신초등학교,6,6,0,6,1,4,1,0
교육기관,교육부,음암중학교,교육부 충청남도교육청 충청남도서산교육지원청 음암중학교,18,8,10,8,7,1,0,0
교육기관,교육부,음암초등학교,교육부 충청남도교육청 충청남도서산교육지원청 음암초등학교,12,12,0,12,12,0,0,0
교육기관,교육부,인지중학교,교육부 충청남도교육청 충청남도서산교육지원청 인지중학교,35,35,0,35,27,7,1,0
교육기관,교육부,인지초등학교,교육부 충청남도교육청 충청남도서산교육지원청 인지초등학교,18,18,0,18,9,6,2,1
교육기관,교육부,차동초등학교,교육부 충청남도교육청 충청남도서산교육지원청 차동초등학교,6,6,0,6,6,0,0,0
교육기관,교육부,팔봉중학교,교육부 충청남도교육청 충청남도서산교육지원청 팔봉중학교,19,19,0,19,11,8,0,0
교육기관,교육부,팔봉초등학교,교육부 충청남도교육청 충청남도서산교육지원청 팔봉초등학교,13,13,0,13,13,0,0,0
교육기관,교육부,학돌초등학교,교육부 충청남도교육청 충청남도서산교육지원청 학돌초등학교,23,23,0,23,23,0,0,0
교육기관,교육부,해미중학교,교육부 충청남도교육청 충청남도서산교육지원청 해미중학교,16,15,1,15,15,0,0,0
교육기관,교육부,해미초등학교,교육부 충청남도교육청 충청남도서산교육지원청 해미초등학교,11,0,11,0,0,0,0,0
교육기관,교육부,충청남도서천교육지원청,교육부 충청남도교육청 충청남도서천교육지원청,11,11,0,11,2,9,0,0
교육기관,교육부,기산초등학교,교육부 충청남도교육청 충청남도서천교육지원청 기산초등학교,13,13,0,13,13,0,0,0
교육기관,교육부,동강중학교,교육부 충청남도교육청 충청남도서천교육지원청 동강중학교,53,53,0,53,53,0,0,0
교육기관,교육부,마동초등학교,교육부 충청남도교육청 충청남도서천교육지원청 마동초등학교,16,16,0,16,12,4,0,0
교육기관,교육부,마산초등학교,교육부 충청남도교육청 충청남도서천교육지원청 마산초등학교,16,16,0,16,0,16,0,0
교육기관,교육부,문산초등학교,교육부 충청남도교육청 충청남도서천교육지원청 문산초등학교,17,17,0,17,13,3,1,0
교육기관,교육부,부내초등학교,교육부 충청남도교육청 충청남도서천교육지원청 부내초등학교,16,16,0,16,7,9,0,0
교육기관,교육부,비인중학교,교육부 충청남도교육청 충청남도서천교육지원청 비인중학교,12,11,1,11,6,3,1,1
교육기관,교육부,비인초등학교,교육부 충청남도교육청 충청남도서천교육지원청 비인초등학교,25,25,0,25,0,25,0,0
교육기관,교육부,서남초등학교,교육부 충청남도교육청 충청남도서천교육지원청 서남초등학교,16,16,0,16,16,0,0,0
교육기관,교육부,서도초등학교,교육부 충청남도교육청 충청남도서천교육지원청 서도초등학교,16,16,0,16,14,2,0,0
교육기관,교육부,서림여자중학교,교육부 충청남도교육청 충청남도서천교육지원청 서림여자중학교,4,3,1,3,0,3,0,0
교육기관,교육부,서면중학교,교육부 충청남도교육청 충청남도서천교육지원청 서면중학교,21,20,1,20,20,0,0,0
교육기관,교육부,서면초등학교,교육부 충청남도교육청 충청남도서천교육지원청 서면초등학교,21,21,0,21,18,3,0,0
교육기관,교육부,서천도서관,교육부 충청남도교육청 충청남도서천교육지원청 서천도서관,21,21,0,21,8,13,0,0
교육기관,교육부,서천여자중학교,교육부 충청남도교육청 충청남도서천교육지원청 서천여자중학교,22,20,2,20,1,17,1,1
교육기관,교육부,서천중학교,교육부 충청남도교육청 충청남도서천교육지원청 서천중학교,32,32,0,32,0,32,0,0
교육기관,교육부,서천초등학교,교육부 충청남도교육청 충청남도서천교육지원청 서천초등학교,38,38,0,38,38,0,0,0
교육기관,교육부,송림초등학교,교육부 충청남도교육청 충청남도서천교육지원청 송림초등학교,17,17,0,17,17,0,0,0
교육기관,교육부,송석초등학교,교육부 충청남도교육청 충청남도서천교육지원청 송석초등학교,16,12,4,12,10,2,0,0
교육기관,교육부,시초초등학교,교육부 충청남도교육청 충청남도서천교육지원청 시초초등학교,13,13,0,13,11,2,0,0
교육기관,교육부,오성초등학교,교육부 충청남도교육청 충청남도서천교육지원청 오성초등학교,18,18,0,18,7,7,4,0
교육기관,교육부,장항중학교,교육부 충청남도교육청 충청남도서천교육지원청 장항중학교,29,29,0,29,29,0,0,0
교육기관,교육부,장항초등학교,교육부 충청남도교육청 충청남도서천교육지원청 장항초등학교,24,24,0,24,0,24,0,0
교육기관,교육부,판교중학교,교육부 충청남도교육청 충청남도서천교육지원청 판교중학교,16,16,0,16,12,4,0,0
교육기관,교육부,한산중학교,교육부 충청남도교육청 충청남도서천교육지원청 한산중학교,19,19,0,19,6,10,2,1
교육기관,교육부,한산초등학교,교육부 충청남도교육청 충청남도서천교육지원청 한산초등학교,22,22,0,22,6,16,0,0
교육기관,교육부,화양초등학교,교육부 충청남도교육청 충청남도서천교육지원청 화양초등학교,12,12,0,12,9,3,0,0
교육기관,교육부,충청남도아산교육지원청,교육부 충청남도교육청 충청남도아산교육지원청,21,11,10,11,0,11,0,0
교육기관,교육부,금곡초등학교,교육부 충청남도교육청 충청남도아산교육지원청 금곡초등학교,16,16,0,16,0,16,0,0
교육기관,교육부,남창초등학교,교육부 충청남도교육청 충청남도아산교육지원청 남창초등학교,16,16,0,16,10,6,0,0
교육기관,교육부,도고온천초등학교,교육부 충청남도교육청 충청남도아산교육지원청 도고온천초등학교,17,17,0,17,17,0,0,0
교육기관,교육부,도고중학교,교육부 충청남도교육청 충청남도아산교육지원청 도고중학교,28,28,0,28,15,13,0,0
교육기관,교육부,도고초등학교,교육부 충청남도교육청 충청남도아산교육지원청 도고초등학교,6,6,0,6,6,0,0,0
교육기관,교육부,둔포중학교,교육부 충청남도교육청 충청남도아산교육지원청 둔포중학교,35,35,0,35,10,25,0,0
교육기관,교육부,둔포초등학교,교육부 충청남도교육청 충청남도아산교육지원청 둔포초등학교,17,11,6,11,9,2,0,0
교육기관,교육부,모산중학교,교육부 충청남도교육청 충청남도아산교육지원청 모산중학교,65,65,0,65,0,65,0,0
교육기관,교육부,모산초등학교,교육부 충청남도교육청 충청남도아산교육지원청 모산초등학교,30,30,0,30,30,0,0,0
교육기관,교육부,배방초등학교,교육부 충청남도교육청 충청남도아산교육지원청 배방초등학교,26,26,0,26,26,0,0,0
교육기관,교육부,선도중학교,교육부 충청남도교육청 충청남도아산교육지원청 선도중학교,21,21,0,21,10,11,0,0
교육기관,교육부,설화중학교,교육부 충청남도교육청 충청남도아산교육지원청 설화중학교,112,112,0,112,112,0,0,0
교육기관,교육부,송곡초등학교,교육부 충청남도교육청 충청남도아산교육지원청 송곡초등학교,25,25,0,25,17,8,0,0
교육기관,교육부,송남중학교,교육부 충청남도교육청 충청남도아산교육지원청 송남중학교,19,19,0,19,12,7,0,0
교육기관,교육부,송남초등학교,교육부 충청남도교육청 충청남도아산교육지원청 송남초등학교,21,21,0,21,21,0,0,0
교육기관,교육부,신광초등학교,교육부 충청남도교육청 충청남도아산교육지원청 신광초등학교,20,20,0,20,5,5,4,6
교육기관,교육부,신리초등학교,교육부 충청남도교육청 충청남도아산교육지원청 신리초등학교,46,46,0,46,0,46,0,0
교육기관,교육부,신창중학교,교육부 충청남도교육청 충청남도아산교육지원청 신창중학교,27,27,0,27,10,17,0,0
교육기관,교육부,신창초등학교,교육부 충청남도교육청 충청남도아산교육지원청 신창초등학교,20,20,0,20,20,0,0,0
교육기관,교육부,신화초등학교,교육부 충청남도교육청 충청남도아산교육지원청 신화초등학교,7,7,0,7,0,7,0,0
교육기관,교육부,쌍룡초등학교,교육부 충청남도교육청 충청남도아산교육지원청 쌍룡초등학교,16,16,0,16,0,16,0,0
교육기관,교육부,아산공수초등학교,교육부 충청남도교육청 충청남도아산교육지원청 아산공수초등학교,83,83,0,83,0,83,0,0
교육기관,교육부,아산남성초등학교,교육부 충청남도교육청 충청남도아산교육지원청 아산남성초등학교,28,28,0,28,7,21,0,0
교육기관,교육부,아산배방중학교,교육부 충청남도교육청 충청남도아산교육지원청 아산배방중학교,55,55,0,55,30,25,0,0
교육기관,교육부,아산북수초등학교,교육부 충청남도교육청 충청남도아산교육지원청 아산북수초등학교,55,55,0,55,55,0,0,0
교육기관,교육부,아산세교초등학교,교육부 충청남도교육청 충청남도아산교육지원청 아산세교초등학교,56,56,0,56,5,51,0,0
교육기관,교육부,아산용연초등학교,교육부 충청남도교육청 충청남도아산교육지원청 아산용연초등학교,49,49,0,49,17,32,0,0
교육기관,교육부,아산중학교,교육부 충청남도교육청 충청남도아산교육지원청 아산중학교,41,41,0,41,38,3,0,0
교육기관,교육부,아산초등학교,교육부 충청남도교육청 충청남도아산교육지원청 아산초등학교,50,50,0,50,0,50,0,0
교육기관,교육부,아산테크노중학교,교육부 충청남도교육청 충청남도아산교육지원청 아산테크노중학교,49,49,0,49,0,49,0,0
교육기관,교육부,연화초등학교,교육부 충청남도교육청 충청남도아산교육지원청 연화초등학교,44,25,19,25,24,1,0,0
교육기관,교육부,염작초등학교,교육부 충청남도교육청 충청남도아산교육지원청 염작초등학교,59,59,0,59,59,0,0,0
교육기관,교육부,염티초등학교,교육부 충청남도교육청 충청남도아산교육지원청 염티초등학교,27,27,0,27,27,0,0,0
교육기관,교육부,영인중학교,교육부 충청남도교육청 충청남도아산교육지원청 영인중학교,24,24,0,24,24,0,0,0
교육기관,교육부,영인초등학교,교육부 충청남도교육청 충청남도아산교육지원청 영인초등학교,18,18,0,18,18,0,0,0
교육기관,교육부,오목초등학교,교육부 충청남도교육청 충청남도아산교육지원청 오목초등학교,15,15,0,15,15,0,0,0
교육기관,교육부,온양권곡초등학교,교육부 충청남도교육청 충청남도아산교육지원청 온양권곡초등학교,25,25,0,25,0,25,0,0
교육기관,교육부,온양신정중학교,교육부 충청남도교육청 충청남도아산교육지원청 온양신정중학교,57,57,0,57,57,0,0,0
교육기관,교육부,온양신정초등학교,교육부 충청남도교육청 충청남도아산교육지원청 온양신정초등학교,29,29,0,29,19,8,2,0
교육기관,교육부,온양여자중학교,교육부 충청남도교육청 충청남도아산교육지원청 온양여자중학교,67,67,0,67,67,0,0,0
교육기관,교육부,온양온천초등학교,교육부 충청남도교육청 충청남도아산교육지원청 온양온천초등학교,30,30,0,30,30,0,0,0
교육기관,교육부,온양용화중학교,교육부 충청남도교육청 충청남도아산교육지원청 온양용화중학교,70,70,0,70,52,18,0,0
교육기관,교육부,온양중앙초등학교,교육부 충청남도교육청 충청남도아산교육지원청 온양중앙초등학교,32,32,0,32,32,0,0,0
교육기관,교육부,온양중학교,교육부 충청남도교육청 충청남도아산교육지원청 온양중학교,81,0,81,0,0,0,0,0
교육기관,교육부,온양천도초등학교,교육부 충청남도교육청 충청남도아산교육지원청 온양천도초등학교,27,27,0,27,17,10,0,0
교육기관,교육부,온양초등학교,교육부 충청남도교육청 충청남도아산교육지원청 온양초등학교,26,26,0,26,9,17,0,0
교육기관,교육부,온양초사초등학교,교육부 충청남도교육청 충청남도아산교육지원청 온양초사초등학교,27,27,0,27,27,0,0,0
교육기관,교육부,온양풍기초등학교,교육부 충청남도교육청 충청남도아산교육지원청 온양풍기초등학교,37,22,15,22,22,0,0,0
교육기관,교육부,온양한올중학교,교육부 충청남도교육청 충청남도아산교육지원청 온양한올중학교,32,32,0,32,18,7,7,0
교육기관,교육부,용화초등학교,교육부 충청남도교육청 충청남도아산교육지원청 용화초등학교,26,26,0,26,14,10,1,1
교육기관,교육부,월랑초등학교,교육부 충청남도교육청 충청남도아산교육지원청 월랑초등학교,57,57,0,57,0,57,0,0
교육기관,교육부,음봉중학교,교육부 충청남도교육청 충청남도아산교육지원청 음봉중학교,66,66,0,66,0,66,0,0
교육기관,교육부,음봉초등학교,교육부 충청남도교육청 충청남도아산교육지원청 음봉초등학교,17,17,0,17,17,0,0,0
교육기관,교육부,인주중학교,교육부 충청남도교육청 충청남도아산교육지원청 인주중학교,32,32,0,32,12,20,0,0
교육기관,교육부,인주초등학교,교육부 충청남도교육청 충청남도아산교육지원청 인주초등학교,16,16,0,16,0,16,0,0
교육기관,교육부,충무초등학교,교육부 충청남도교육청 충청남도아산교육지원청 충무초등학교,27,27,0,27,15,12,0,0
교육기관,교육부,탕정미래초등학교,교육부 충청남도교육청 충청남도아산교육지원청 탕정미래초등학교,36,36,0,36,36,0,0,0
교육기관,교육부,탕정중학교,교육부 충청남도교육청 충청남도아산교육지원청 탕정중학교,41,41,0,41,0,41,0,0
교육기관,교육부,탕정초등학교,교육부 충청남도교육청 충청남도아산교육지원청 탕정초등학교,30,0,30,0,0,0,0,0
교육기관,교육부,한들물빛중학교,교육부 충청남도교육청 충청남도아산교육지원청 한들물빛중학교,60,60,0,60,30,30,0,0
교육기관,교육부,한들물빛초등학교,교육부 충청남도교육청 충청남도아산교육지원청 한들물빛초등학교,64,64,0,64,0,64,0,0
교육기관,교육부,충청남도예산교육지원청,교육부 충청남도교육청 충청남도예산교육지원청,8,8,0,8,0,8,0,0
교육기관,교육부,고덕중학교,교육부 충청남도교육청 충청남도예산교육지원청 고덕중학교,17,17,0,17,10,7,0,0
교육기관,교육부,고덕초등학교,교육부 충청남도교육청 충청남도예산교육지원청 고덕초등학교,20,20,0,20,18,2,0,0
교육기관,교육부,광시중학교,교육부 충청남도교육청 충청남도예산교육지원청 광시중학교,8,7,1,7,4,3,0,0
교육기관,교육부,대술초등학교,교육부 충청남도교육청 충청남도예산교육지원청 대술초등학교,9,9,0,9,9,0,0,0
교육기관,교육부,대흥초등학교,교육부 충청남도교육청 충청남도예산교육지원청 대흥초등학교,10,10,0,10,10,0,0,0
교육기관,교육부,덕산중학교,교육부 충청남도교육청 충청남도예산교육지원청 덕산중학교,64,64,0,64,49,15,0,0
교육기관,교육부,덕산초등학교,교육부 충청남도교육청 충청남도예산교육지원청 덕산초등학교,11,5,6,5,5,0,0,0
교육기관,교육부,보성초등학교,교육부 충청남도교육청 충청남도예산교육지원청 보성초등학교,29,15,14,15,15,0,0,0
교육기관,교육부,봉산초등학교,교육부 충청남도교육청 충청남도예산교육지원청 봉산초등학교,10,10,0,10,10,0,0,0
교육기관,교육부,삽교중학교,교육부 충청남도교육청 충청남도예산교육지원청 삽교중학교,23,23,0,23,16,5,1,1
교육기관,교육부,삽교초등학교,교육부 충청남도교육청 충청남도예산교육지원청 삽교초등학교,10,10,0,10,6,2,1,1
교육기관,교육부,수덕초등학교,교육부 충청남도교육청 충청남도예산교육지원청 수덕초등학교,5,5,0,5,0,5,0,0
교육기관,교육부,시량초등학교,교육부 충청남도교육청 충청남도예산교육지원청 시량초등학교,11,11,0,11,11,0,0,0
교육기관,교육부,신례원초등학교,교육부 충청남도교육청 충청남도예산교육지원청 신례원초등학교,22,22,0,22,12,10,0,0
교육기관,교육부,신암초등학교,교육부 충청남도교육청 충청남도예산교육지원청 신암초등학교,8,8,0,8,8,0,0,0
교육기관,교육부,신양중학교,교육부 충청남도교육청 충청남도예산교육지원청 신양중학교,66,66,0,66,66,0,0,0
교육기관,교육부,신양초등학교,교육부 충청남도교육청 충청남도예산교육지원청 신양초등학교,12,12,0,12,10,2,0,0
교육기관,교육부,양신초등학교,교육부 충청남도교육청 충청남도예산교육지원청 양신초등학교,10,10,0,10,10,0,0,0
교육기관,교육부,예산도서관,교육부 충청남도교육청 충청남도예산교육지원청 예산도서관,16,16,0,16,0,16,0,0
교육기관,교육부,예산여자중학교,교육부 충청남도교육청 충청남도예산교육지원청 예산여자중학교,32,32,0,32,32,0,0,0
교육기관,교육부,예산중앙초등학교,교육부 충청남도교육청 충청남도예산교육지원청 예산중앙초등학교,16,16,0,16,0,16,0,0
교육기관,교육부,예산중학교,교육부 충청남도교육청 충청남도예산교육지원청 예산중학교,48,48,0,48,48,0,0,0
교육기관,교육부,예산초등학교,교육부 충청남도교육청 충청남도예산교육지원청 예산초등학교,24,24,0,24,24,0,0,0
교육기관,교육부,오가초등학교,교육부 충청남도교육청 충청남도예산교육지원청 오가초등학교,16,16,0,16,16,0,0,0
교육기관,교육부,용동초등학교,교육부 충청남도교육청 충청남도예산교육지원청 용동초등학교,7,7,0,7,7,0,0,0
교육기관,교육부,웅산초등학교,교육부 충청남도교육청 충청남도예산교육지원청 웅산초등학교,16,16,0,16,14,2,0,0
교육기관,교육부,응봉초등학교,교육부 충청남도교육청 충청남도예산교육지원청 응봉초등학교,8,8,0,8,8,0,0,0
교육기관,교육부,임성중학교,교육부 충청남도교육청 충청남도예산교육지원청 임성중학교,13,12,1,12,12,0,0,0
교육기관,교육부,조림초등학교,교육부 충청남도교육청 충청남도예산교육지원청 조림초등학교,16,16,0,16,8,8,0,0
교육기관,교육부,평촌초등학교,교육부 충청남도교육청 충청남도예산교육지원청 평촌초등학교,8,8,0,8,6,2,0,0
교육기관,교육부,충청남도천안교육지원청,교육부 충청남도교육청 충청남도천안교육지원청,48,45,3,45,11,34,0,0
교육기관,교육부,광덕초등학교,교육부 충청남도교육청 충청남도천안교육지원청 광덕초등학교,12,12,0,12,6,6,0,0
교육기관,교육부,광풍중학교,교육부 충청남도교육청 충청남도천안교육지원청 광풍중학교,20,20,0,20,12,8,0,0
교육기관,교육부,대홍초등학교,교육부 충청남도교육청 충청남도천안교육지원청 대홍초등학교,16,16,0,16,8,8,0,0
교육기관,교육부,도장초등학교,교육부 충청남도교육청 충청남도천안교육지원청 도장초등학교,10,10,0,10,9,1,0,0
교육기관,교육부,도하초등학교,교육부 충청남도교육청 충청남도천안교육지원청 도하초등학교,16,16,0,16,16,0,0,0
교육기관,교육부,목천중학교,교육부 충청남도교육청 충청남도천안교육지원청 목천중학교,11,11,0,11,11,0,0,0
교육기관,교육부,목천초등학교,교육부 충청남도교육청 충청남도천안교육지원청 목천초등학교,11,11,0,11,11,0,0,0
교육기관,교육부,미죽초등학교,교육부 충청남도교육청 충청남도천안교육지원청 미죽초등학교,11,11,0,11,11,0,0,0
교육기관,교육부,병천중학교,교육부 충청남도교육청 충청남도천안교육지원청 병천중학교,13,13,0,13,8,5,0,0
교육기관,교육부,병천초등학교,교육부 충청남도교육청 충청남도천안교육지원청 병천초등학교,15,15,0,15,15,0,0,0
교육기관,교육부,보산원초등학교,교육부 충청남도교육청 충청남도천안교육지원청 보산원초등학교,17,17,0,17,0,17,0,0
교육기관,교육부,삼은초등학교,교육부 충청남도교육청 충청남도천안교육지원청 삼은초등학교,20,20,0,20,6,14,0,0
교육기관,교육부,성거초등학교,교육부 충청남도교육청 충청남도천안교육지원청 성거초등학교,20,20,0,20,20,0,0,0
교육기관,교육부,성남초등학교,교육부 충청남도교육청 충청남도천안교육지원청 성남초등학교,9,9,0,9,8,1,0,0
교육기관,교육부,성신초등학교,교육부 충청남도교육청 충청남도천안교육지원청 성신초등학교,15,15,0,15,0,15,0,0
교육기관,교육부,성환중학교,교육부 충청남도교육청 충청남도천안교육지원청 성환중학교,49,49,0,49,30,19,0,0
교육기관,교육부,성환초등학교,교육부 충청남도교육청 충청남도천안교육지원청 성환초등학교,32,32,0,32,21,11,0,0
교육기관,교육부,소망초등학교,교육부 충청남도교육청 충청남도천안교육지원청 소망초등학교,19,19,0,19,19,0,0,0
교육기관,교육부,수신초등학교,교육부 충청남도교육청 충청남도천안교육지원청 수신초등학교,8,8,0,8,0,8,0,0
교육기관,교육부,신가초등학교,교육부 충청남도교육청 충청남도천안교육지원청 신가초등학교,18,18,0,18,18,0,0,0
교육기관,교육부,신계초등학교,교육부 충청남도교육청 충청남도천안교육지원청 신계초등학교,9,9,0,9,8,1,0,0
교육기관,교육부,신방초등학교,교육부 충청남도교육청 충청남도천안교육지원청 신방초등학교,10,10,0,10,10,0,0,0
교육기관,교육부,신사초등학교,교육부 충청남도교육청 충청남도천안교육지원청 신사초등학교,7,7,0,7,7,0,0,0
교육기관,교육부,신흥초등학교,교육부 충청남도교육청 충청남도천안교육지원청 신흥초등학교,24,24,0,24,24,0,0,0
교육기관,교육부,안서초등학교,교육부 충청남도교육청 충청남도천안교육지원청 안서초등학교,9,0,9,0,0,0,0,0
교육기관,교육부,양당초등학교,교육부 충청남도교육청 충청남도천안교육지원청 양당초등학교,19,19,0,19,14,5,0,0
교육기관,교육부,양대초등학교,교육부 충청남도교육청 충청남도천안교육지원청 양대초등학교,16,16,0,16,8,8,0,0
교육기관,교육부,용정초등학교,교육부 충청남도교육청 충청남도천안교육지원청 용정초등학교,12,12,0,12,4,8,0,0
교육기관,교육부,위례초등학교,교육부 충청남도교육청 충청남도천안교육지원청 위례초등학교,12,12,0,12,12,0,0,0
교육기관,교육부,은석초등학교,교육부 충청남도교육청 충청남도천안교육지원청 은석초등학교,15,15,0,15,15,0,0,0
교육기관,교육부,입장중학교,교육부 충청남도교육청 충청남도천안교육지원청 입장중학교,29,29,0,29,0,29,0,0
교육기관,교육부,입장초등학교,교육부 충청남도교육청 충청남도천안교육지원청 입장초등학교,18,18,0,18,0,18,0,0
교육기관,교육부,직산초등학교,교육부 충청남도교육청 충청남도천안교육지원청 직산초등학교,20,20,0,20,0,20,0,0
교육기관,교육부,천남중학교,교육부 충청남도교육청 충청남도천안교육지원청 천남중학교,19,19,0,19,19,0,0,0
교육기관,교육부,천동초등학교,교육부 충청남도교육청 충청남도천안교육지원청 천동초등학교,10,10,0,10,10,0,0,0
교육기관,교육부,천성중학교,교육부 충청남도교육청 충청남도천안교육지원청 천성중학교,36,35,1,35,35,0,0,0
교육기관,교육부,천안가온중학교,교육부 충청남도교육청 충청남도천안교육지원청 천안가온중학교,75,75,0,75,75,0,0,0
교육기관,교육부,천안가온초등학교,교육부 충청남도교육청 충청남도천안교육지원청 천안가온초등학교,20,20,0,20,0,20,0,0
교육기관,교육부,천안계광중학교,교육부 충청남도교육청 충청남도천안교육지원청 천안계광중학교,34,34,0,34,33,1,0,0
교육기관,교육부,천안구성초등학교,교육부 충청남도교육청 충청남도천안교육지원청 천안구성초등학교,21,21,0,21,0,21,0,0
교육기관,교육부,천안동성중학교,교육부 충청남도교육청 충청남도천안교육지원청 천안동성중학교,42,42,0,42,42,0,0,0
교육기관,교육부,천안동중학교,교육부 충청남도교육청 충청남도천안교육지원청 천안동중학교,51,51,0,51,51,0,0,0
교육기관,교육부,천안두정중학교,교육부 충청남도교육청 충청남도천안교육지원청 천안두정중학교,36,36,0,36,36,0,0,0
교육기관,교육부,천안두정초등학교,교육부 충청남도교육청 충청남도천안교육지원청 천안두정초등학교,28,28,0,28,0,28,0,0
교육기관,교육부,천안미라초등학교,교육부 충청남도교육청 충청남도천안교육지원청 천안미라초등학교,32,32,0,32,8,24,0,0
교육기관,교육부,천안백석중학교,교육부 충청남도교육청 충청남도천안교육지원청 천안백석중학교,80,80,0,80,80,0,0,0
교육기관,교육부,천안백석초등학교,교육부 충청남도교육청 충청남도천안교육지원청 천안백석초등학교,36,36,0,36,18,18,0,0
교육기관,교육부,천안봉서중학교,교육부 충청남도교육청 충청남도천안교육지원청 천안봉서중학교,32,13,19,13,13,0,0,0
교육기관,교육부,천안봉서초등학교,교육부 충청남도교육청 충청남도천안교육지원청 천안봉서초등학교,29,29,0,29,27,2,0,0
교육기관,교육부,천안부대초등학교,교육부 충청남도교육청 충청남도천안교육지원청 천안부대초등학교,30,30,0,30,15,15,0,0
교육기관,교육부,천안부성중학교,교육부 충청남도교육청 충청남도천안교육지원청 천안부성중학교,40,40,0,40,33,7,0,0
교육기관,교육부,천안부성초등학교,교육부 충청남도교육청 충청남도천안교육지원청 천안부성초등학교,24,24,0,24,0,24,0,0
교육기관,교육부,천안부영초등학교,교육부 충청남도교육청 충청남도천안교육지원청 천안부영초등학교,18,18,0,18,14,4,0,0
교육기관,교육부,천안북중학교,교육부 충청남도교육청 충청남도천안교육지원청 천안북중학교,58,58,0,58,51,7,0,0
교육기관,교육부,천안불당중학교,교육부 충청남도교육청 충청남도천안교육지원청 천안불당중학교,63,63,0,63,0,63,0,0
교육기관,교육부,천안불당초등학교,교육부 충청남도교육청 충청남도천안교육지원청 천안불당초등학교,21,21,0,21,21,0,0,0
교육기관,교육부,천안삼거리초등학교,교육부 충청남도교육청 충청남도천안교육지원청 천안삼거리초등학교,21,21,0,21,21,0,0,0
교육기관,교육부,천안새샘중학교,교육부 충청남도교육청 충청남도천안교육지원청 천안새샘중학교,68,68,0,68,58,10,0,0
교육기관,교육부,천안새샘초등학교,교육부 충청남도교육청 충청남도천안교육지원청 천안새샘초등학교,27,27,0,27,18,9,0,0
교육기관,교육부,천안서당초등학교,교육부 충청남도교육청 충청남도천안교육지원청 천안서당초등학교,25,25,0,25,25,0,0,0
교육기관,교육부,천안서여자중학교,교육부 충청남도교육청 충청남도천안교육지원청 천안서여자중학교,58,58,0,58,0,58,0,0
교육기관,교육부,천안서초등학교,교육부 충청남도교육청 충청남도천안교육지원청 천안서초등학교,39,39,0,39,39,0,0,0
교육기관,교육부,천안성성중학교,교육부 충청남도교육청 충청남도천안교육지원청 천안성성중학교,50,0,50,0,0,0,0,0
교육기관,교육부,천안성성초등학교,교육부 충청남도교육청 충청남도천안교육지원청 천안성성초등학교,64,64,0,64,0,64,0,0
교육기관,교육부,천안성정중학교,교육부 충청남도교육청 충청남도천안교육지원청 천안성정중학교,90,90,0,90,0,90,0,0
교육기관,교육부,천안성정초등학교,교육부 충청남도교육청 충청남도천안교육지원청 천안성정초등학교,16,16,0,16,0,16,0,0
교육기관,교육부,천안수곡초등학교,교육부 충청남도교육청 충청남도천안교육지원청 천안수곡초등학교,16,16,0,16,16,0,0,0
교육기관,교육부,천안신대초등학교,교육부 충청남도교육청 충청남도천안교육지원청 천안신대초등학교,25,25,0,25,20,2,2,1
교육기관,교육부,천안신방중학교,교육부 충청남도교육청 충청남도천안교육지원청 천안신방중학교,53,53,0,53,51,2,0,0
교육기관,교육부,천안신부초등학교,교육부 충청남도교육청 충청남도천안교육지원청 천안신부초등학교,36,36,0,36,30,6,0,0
교육기관,교육부,천안신안초등학교,교육부 충청남도교육청 충청남도천안교육지원청 천안신안초등학교,21,21,0,21,14,7,0,0
교육기관,교육부,천안신용초등학교,교육부 충청남도교육청 충청남도천안교육지원청 천안신용초등학교,20,20,0,20,20,0,0,0
교육기관,교육부,천안신촌초등학교,교육부 충청남도교육청 충청남도천안교육지원청 천안신촌초등학교,27,27,0,27,7,20,0,0
교육기관,교육부,천안쌍용중학교,교육부 충청남도교육청 충청남도천안교육지원청 천안쌍용중학교,55,51,4,51,38,13,0,0
교육기관,교육부,천안쌍용초등학교,교육부 충청남도교육청 충청남도천안교육지원청 천안쌍용초등학교,27,27,0,27,27,0,0,0
교육기관,교육부,천안쌍정초등학교,교육부 충청남도교육청 충청남도천안교육지원청 천안쌍정초등학교,22,22,0,22,9,13,0,0
교육기관,교육부,천안아름초등학교,교육부 충청남도교육청 충청남도천안교육지원청 천안아름초등학교,61,61,0,61,61,0,0,0
교육기관,교육부,천안업성초등학교,교육부 충청남도교육청 충청남도천안교육지원청 천안업성초등학교,20,20,0,20,20,0,0,0
교육기관,교육부,천안여자중학교,교육부 충청남도교육청 충청남도천안교육지원청 천안여자중학교,42,42,0,42,30,12,0,0
교육기관,교육부,천안오성중학교,교육부 충청남도교육청 충청남도천안교육지원청 천안오성중학교,64,64,0,64,32,32,0,0
교육기관,교육부,천안와촌초등학교,교육부 충청남도교육청 충청남도천안교육지원청 천안와촌초등학교,19,19,0,19,15,4,0,0
교육기관,교육부,천안용곡중학교,교육부 충청남도교육청 충청남도천안교육지원청 천안용곡중학교,69,69,0,69,38,31,0,0
교육기관,교육부,천안용곡초등학교,교육부 충청남도교육청 충청남도천안교육지원청 천안용곡초등학교,21,21,0,21,21,0,0,0
교육기관,교육부,천안용소초등학교,교육부 충청남도교육청 충청남도천안교육지원청 천안용소초등학교,24,24,0,24,23,1,0,0
교육기관,교육부,천안용암초등학교,교육부 충청남도교육청 충청남도천안교육지원청 천안용암초등학교,29,29,0,29,29,0,0,0
교육기관,교육부,천안월봉중학교,교육부 충청남도교육청 충청남도천안교육지원청 천안월봉중학교,47,0,47,0,0,0,0,0
교육기관,교육부,천안월봉초등학교,교육부 충청남도교육청 충청남도천안교육지원청 천안월봉초등학교,20,20,0,20,11,9,0,0
교육기관,교육부,천안일봉초등학교,교육부 충청남도교육청 충청남도천안교육지원청 천안일봉초등학교,43,43,0,43,43,0,0,0
교육기관,교육부,천안중앙초등학교,교육부 충청남도교육청 충청남도천안교육지원청 천안중앙초등학교,21,21,0,21,13,8,0,0
교육기관,교육부,천안중학교,교육부 충청남도교육청 충청남도천안교육지원청 천안중학교,83,83,0,83,10,73,0,0
교육기관,교육부,천안차암초등학교,교육부 충청남도교육청 충청남도천안교육지원청 천안차암초등학교,60,60,0,60,60,0,0,0
교육기관,교육부,천안청당초등학교,교육부 충청남도교육청 충청남도천안교육지원청 천안청당초등학교,30,25,5,25,25,0,0,0
교육기관,교육부,천안청룡초등학교,교육부 충청남도교육청 충청남도천안교육지원청 천안청룡초등학교,20,20,0,20,20,0,0,0
교육기관,교육부,천안청수초등학교,교육부 충청남도교육청 충청남도천안교육지원청 천안청수초등학교,16,16,0,16,13,1,1,1
교육기관,교육부,천안초등학교,교육부 충청남도교육청 충청남도천안교육지원청 천안초등학교,16,16,0,16,0,16,0,0
교육기관,교육부,천안호수초등학교,교육부 충청남도교육청 충청남도천안교육지원청 천안호수초등학교,64,64,0,64,0,64,0,0
교육기관,교육부,천안희망초등학교,교육부 충청남도교육청 충청남도천안교육지원청 천안희망초등학교,56,56,0,56,37,5,14,0
교육기관,교육부,충청남도천안교육지원청성환도서관,교육부 충청남도교육청 충청남도천안교육지원청 충청남도천안교육지원청성환도서관,9,9,0,9,0,9,0,0
교육기관,교육부,행정초등학교,교육부 충청남도교육청 충청남도천안교육지원청 행정초등학교,17,17,0,17,17,0,0,0
교육기관,교육부,환서중학교,교육부 충청남도교육청 충청남도천안교육지원청 환서중학교,33,32,1,32,4,25,1,2
교육기관,교육부,환서초등학교,교육부 충청남도교육청 충청남도천안교육지원청 환서초등학교,34,34,0,34,34,0,0,0
교육기관,교육부,충청남도청양교육지원청,교육부 충청남도교육청 충청남도청양교육지원청,11,11,0,11,11,0,0,0
교육기관,교육부,남양초등학교,교육부 충청남도교육청 충청남도청양교육지원청 남양초등학교,20,20,0,20,20,0,0,0
교육기관,교육부,동영중학교,교육부 충청남도교육청 충청남도청양교육지원청 동영중학교,12,12,0,12,12,0,0,0
교육기관,교육부,미당초등학교,교육부 충청남도교육청 충청남도청양교육지원청 미당초등학교,7,7,0,7,7,0,0,0
교육기관,교육부,수정초등학교,교육부 충청남도교육청 충청남도청양교육지원청 수정초등학교,16,16,0,16,14,2,0,0
교육기관,교육부,운곡초등학교,교육부 충청남도교육청 충청남도청양교육지원청 운곡초등학교,10,10,0,10,10,0,0,0
교육기관,교육부,장평초등학교,교육부 충청남도교육청 충청남도청양교육지원청 장평초등학교,13,13,0,13,13,0,0,0
교육기관,교육부,정산중학교,교육부 충청남도교육청 충청남도청양교육지원청 정산중학교,99,99,0,99,97,2,0,0
교육기관,교육부,정산초등학교,교육부 충청남도교육청 충청남도청양교육지원청 정산초등학교,15,15,0,15,14,1,0,0
교육기관,교육부,청남초등학교,교육부 충청남도교육청 충청남도청양교육지원청 청남초등학교,11,9,2,9,7,2,0,0
교육기관,교육부,청송초등학교,교육부 충청남도교육청 충청남도청양교육지원청 청송초등학교,20,20,0,20,20,0,0,0
교육기관,교육부,청신여자중학교,교육부 충청남도교육청 충청남도청양교육지원청 청신여자중학교,22,22,0,22,12,10,0,0
교육기관,교육부,청양도서관,교육부 충청남도교육청 충청남도청양교육지원청 청양도서관,24,11,13,11,11,0,0,0
교육기관,교육부,청양중학교,교육부 충청남도교육청 충청남도청양교육지원청 청양중학교,21,21,0,21,5,16,0,0
교육기관,교육부,청양초등학교,교육부 충청남도교육청 충청남도청양교육지원청 청양초등학교,15,15,0,15,15,0,0,0
교육기관,교육부,합천초등학교,교육부 충청남도교육청 충청남도청양교육지원청 합천초등학교,8,8,0,8,8,0,0,0
교육기관,교육부,화성중학교,교육부 충청남도교육청 충청남도청양교육지원청 화성중학교,8,8,0,8,1,7,0,0
교육기관,교육부,충청남도태안교육지원청,교육부 충청남도교육청 충청남도태안교육지원청,9,9,0,9,0,9,0,0
교육기관,교육부,근흥중학교,교육부 충청남도교육청 충청남도태안교육지원청 근흥중학교,15,15,0,15,5,7,2,1
교육기관,교육부,남면중학교,교육부 충청남도교육청 충청남도태안교육지원청 남면중학교,19,19,0,19,19,0,0,0
교육기관,교육부,대기초등학교,교육부 충청남도교육청 충청남도태안교육지원청 대기초등학교,12,12,0,12,12,0,0,0
교육기관,교육부,만리포중학교,교육부 충청남도교육청 충청남도태안교육지원청 만리포중학교,11,11,0,11,6,5,0,0
교육기관,교육부,모항초등학교,교육부 충청남도교육청 충청남도태안교육지원청 모항초등학교,15,15,0,15,15,0,0,0
교육기관,교육부,방포초등학교,교육부 충청남도교육청 충청남도태안교육지원청 방포초등학교,32,32,0,32,14,13,5,0
교육기관,교육부,백화초등학교,교육부 충청남도교육청 충청남도태안교육지원청 백화초등학교,20,20,0,20,20,0,0,0
교육기관,교육부,삼성초등학교,교육부 충청남도교육청 충청남도태안교육지원청 삼성초등학교,8,8,0,8,8,0,0,0
교육기관,교육부,소원초등학교,교육부 충청남도교육청 충청남도태안교육지원청 소원초등학교,8,8,0,8,0,8,0,0
교육기관,교육부,송암초등학교,교육부 충청남도교육청 충청남도태안교육지원청 송암초등학교,8,8,0,8,6,2,0,0
교육기관,교육부,안면중학교,교육부 충청남도교육청 충청남도태안교육지원청 안면중학교,22,22,0,22,5,17,0,0
교육기관,교육부,안중초등학교,교육부 충청남도교육청 충청남도태안교육지원청 안중초등학교,8,8,0,8,0,8,0,0
교육기관,교육부,안흥초등학교,교육부 충청남도교육청 충청남도태안교육지원청 안흥초등학교,8,8,0,8,8,0,0,0
교육기관,교육부,원북초등학교,교육부 충청남도교육청 충청남도태안교육지원청 원북초등학교,7,7,0,7,5,2,0,0
교육기관,교육부,원이중학교,교육부 충청남도교육청 충청남도태안교육지원청 원이중학교,38,37,1,37,37,0,0,0
교육기관,교육부,이원초등학교,교육부 충청남도교육청 충청남도태안교육지원청 이원초등학교,24,24,0,24,10,14,0,0
교육기관,교육부,창기중학교,교육부 충청남도교육청 충청남도태안교육지원청 창기중학교,4,3,1,3,1,2,0,0
교육기관,교육부,창기초등학교,교육부 충청남도교육청 충청남도태안교육지원청 창기초등학교,6,6,0,6,6,0,0,0
교육기관,교육부,태안도서관,교육부 충청남도교육청 충청남도태안교육지원청 태안도서관,16,16,0,16,0,16,0,0
교육기관,교육부,태안여자중학교,교육부 충청남도교육청 충청남도태안교육지원청 태안여자중학교,23,23,0,23,23,0,0,0
교육기관,교육부,태안중학교,교육부 충청남도교육청 충청남도태안교육지원청 태안중학교,45,16,29,16,2,14,0,0
교육기관,교육부,태안초등학교,교육부 충청남도교육청 충청남도태안교육지원청 태안초등학교,19,19,0,19,19,0,0,0
교육기관,교육부,화동초등학교,교육부 충청남도교육청 충청남도태안교육지원청 화동초등학교,21,21,0,21,14,7,0,0
교육기관,교육부,충청남도홍성교육지원청,교육부 충청남도교육청 충청남도홍성교육지원청,10,10,0,10,1,9,0,0
교육기관,교육부,갈산중학교,교육부 충청남도교육청 충청남도홍성교육지원청 갈산중학교,16,16,0,16,16,0,0,0
교육기관,교육부,갈산초등학교,교육부 충청남도교육청 충청남도홍성교육지원청 갈산초등학교,10,8,2,8,8,0,0,0
교육기관,교육부,결성초등학교,교육부 충청남도교육청 충청남도홍성교육지원청 결성초등학교,8,8,0,8,4,4,0,0
교육기관,교육부,광천중학교,교육부 충청남도교육청 충청남도홍성교육지원청 광천중학교,76,25,51,25,25,0,0,0
교육기관,교육부,광천초등학교,교육부 충청남도교육청 충청남도홍성교육지원청 광천초등학교,27,27,0,27,14,13,0,0
교육기관,교육부,금마초등학교,교육부 충청남도교육청 충청남도홍성교육지원청 금마초등학교,8,8,0,8,0,8,0,0
교육기관,교육부,내포중학교,교육부 충청남도교육청 충청남도홍성교육지원청 내포중학교,42,42,0,42,0,42,0,0
교육기관,교육부,내포초등학교,교육부 충청남도교육청 충청남도홍성교육지원청 내포초등학교,26,26,0,26,26,0,0,0
교육기관,교육부,대정초등학교,교육부 충청남도교육청 충청남도홍성교육지원청 대정초등학교,15,15,0,15,15,0,0,0
교육기관,교육부,서부초등학교,교육부 충청남도교육청 충청남도홍성교육지원청 서부초등학교,11,11,0,11,11,0,0,0
교육기관,교육부,서해삼육중학교,교육부 충청남도교육청 충청남도홍성교육지원청 서해삼육중학교,24,0,24,0,0,0,0,0
교육기관,교육부,서해삼육초등학교,교육부 충청남도교육청 충청남도홍성교육지원청 서해삼육초등학교,19,19,0,19,19,0,0,0
교육기관,교육부,신당초등학교,교육부 충청남도교육청 충청남도홍성교육지원청 신당초등학교,10,10,0,10,5,5,0,0
교육기관,교육부,용봉초등학교,교육부 충청남도교육청 충청남도홍성교육지원청 용봉초등학교,7,7,0,7,7,0,0,0
교육기관,교육부,은하초등학교,교육부 충청남도교육청 충청남도홍성교육지원청 은하초등학교,9,9,0,9,9,0,0,0
교육기관,교육부,장곡초등학교,교육부 충청남도교육청 충청남도홍성교육지원청 장곡초등학교,12,12,0,12,8,4,0,0
교육기관,교육부,한울초등학교,교육부 충청남도교육청 충청남도홍성교육지원청 한울초등학교,33,33,0,33,0,33,0,0
교육기관,교육부,홍남초등학교,교육부 충청남도교육청 충청남도홍성교육지원청 홍남초등학교,27,27,0,27,22,5,0,0
교육기관,교육부,홍동중학교,교육부 충청남도교육청 충청남도홍성교육지원청 홍동중학교,10,10,0,10,5,5,0,0
교육기관,교육부,홍동초등학교,교육부 충청남도교육청 충청남도홍성교육지원청 홍동초등학교,13,13,0,13,6,7,0,0
교육기관,교육부,홍북초등학교,교육부 충청남도교육청 충청남도홍성교육지원청 홍북초등학교,12,12,0,12,12,0,0,0
교육기관,교육부,홍성서부중학교,교육부 충청남도교육청 충청남도홍성교육지원청 홍성서부중학교,14,14,0,14,14,0,0,0
교육기관,교육부,홍성여자중학교,교육부 충청남도교육청 충청남도홍성교육지원청 홍성여자중학교,30,30,0,30,0,30,0,0
교육기관,교육부,홍성중학교,교육부 충청남도교육청 충청남도홍성교육지원청 홍성중학교,31,30,1,30,27,1,1,1
교육기관,교육부,홍성초등학교,교육부 충청남도교육청 충청남도홍성교육지원청 홍성초등학교,34,34,0,34,0,34,0,0
교육기관,교육부,홍주중학교,교육부 충청남도교육청 충청남도홍성교육지원청 홍주중학교,28,28,0,28,0,28,0,0
교육기관,교육부,홍주초등학교,교육부 충청남도교육청 충청남도홍성교육지원청 홍주초등학교,13,13,0,13,9,4,0,0
교육기관,교육부,태안고등학교,교육부 충청남도교육청 태안고등학교,43,43,0,43,4,39,0,0
교육기관,교육부,태안여자고등학교,교육부 충청남도교육청 태안여자고등학교,34,20,14,20,0,20,0,0
교육기관,교육부,풀무농업고등기술학교,교육부 충청남도교육청 풀무농업고등기술학교,36,2,34,2,2,0,0,0
교육기관,교육부,한국K-POP고등학교,교육부 충청남도교육청 한국K-POP고등학교,50,50,0,50,0,50,0,0
교육기관,교육부,한국식품마이스터고등학교,교육부 충청남도교육청 한국식품마이스터고등학교,34,0,34,0,0,0,0,0
교육기관,교육부,한마음고등학교,교육부 충청남도교육청 한마음고등학교,26,26,0,26,10,16,0,0
교육기관,교육부,합덕고등학교,교육부 충청남도교육청 합덕고등학교,29,28,1,28,28,0,0,0
교육기관,교육부,호서고등학교,교육부 충청남도교육청 호서고등학교,38,38,0,38,38,0,0,0
교육기관,교육부,홍성고등학교,교육부 충청남도교육청 홍성고등학교,101,101,0,101,81,20,0,0
교육기관,교육부,홍성공업고등학교,교육부 충청남도교육청 홍성공업고등학교,48,48,0,48,48,0,0,0
교육기관,교육부,홍성여자고등학교,교육부 충청남도교육청 홍성여자고등학교,41,41,0,41,16,25,0,0
교육기관,교육부,홍주고등학교,교육부 충청남도교육청 홍주고등학교,16,16,0,16,0,16,0,0
교육기관,교육부,전라북도교육청,교육부 전라북도교육청,43,43,0,43,0,43,0,0
교육기관,교육부,강호항공고등학교,교육부 전라북도교육청 강호항공고등학교,62,62,0,62,0,62,0,0
교육기관,교육부,고산고등학교,교육부 전라북도교육청 고산고등학교,39,39,0,39,19,20,0,0
교육기관,교육부,고창고등학교,교육부 전라북도교육청 고창고등학교,51,51,0,51,51,0,0,0
교육기관,교육부,고창북고등학교,교육부 전라북도교육청 고창북고등학교,57,57,0,57,57,0,0,0
교육기관,교육부,고창여자고등학교,교육부 전라북도교육청 고창여자고등학교,16,16,0,16,7,9,0,0
교육기관,교육부,군산교육문화회관,교육부 전라북도교육청 군산교육문화회관,56,56,0,56,53,3,0,0
교육기관,교육부,군산기계공업고등학교,교육부 전라북도교육청 군산기계공업고등학교,111,111,0,111,0,111,0,0
교육기관,교육부,군산동고등학교,교육부 전라북도교육청 군산동고등학교,25,25,0,25,0,25,0,0
교육기관,교육부,군산명화학교,교육부 전라북도교육청 군산명화학교,16,16,0,16,0,16,0,0
교육기관,교육부,군산상업고등학교,교육부 전라북도교육청 군산상업고등학교,25,25,0,25,0,25,0,0
교육기관,교육부,군산여자고등학교,교육부 전라북도교육청 군산여자고등학교,41,41,0,41,0,41,0,0
교육기관,교육부,군산여자상업고등학교,교육부 전라북도교육청 군산여자상업고등학교,39,39,0,39,0,39,0,0
교육기관,교육부,군산영광여자고등학교,교육부 전라북도교육청 군산영광여자고등학교,42,42,0,42,42,0,0,0
교육기관,교육부,군산제일고등학교,교육부 전라북도교육청 군산제일고등학교,58,58,0,58,0,58,0,0
교육기관,교육부,군산중앙고등학교,교육부 전라북도교육청 군산중앙고등학교,80,80,0,80,72,8,0,0
교육기관,교육부,군산중앙여자고등학교,교육부 전라북도교육청 군산중앙여자고등학교,39,35,4,35,35,0,0,0
교육기관,교육부,김제고등학교,교육부 전라북도교육청 김제고등학교,10,10,0,10,0,10,0,0
교육기관,교육부,김제교육문화회관,교육부 전라북도교육청 김제교육문화회관,15,15,0,15,0,15,0,0
교육기관,교육부,김제농생명마이스터고등학교,교육부 전라북도교육청 김제농생명마이스터고등학교,65,65,0,65,49,9,4,3
교육기관,교육부,김제서고등학교,교육부 전라북도교육청 김제서고등학교,18,18,0,18,0,18,0,0
교육기관,교육부,김제여자고등학교,교육부 전라북도교육청 김제여자고등학교,45,45,0,45,45,0,0,0
교육기관,교육부,남성고등학교,교육부 전라북도교육청 남성고등학교,168,168,0,168,0,168,0,0
교육기관,교육부,남원고등학교,교육부 전라북도교육청 남원고등학교,28,13,15,13,3,10,0,0
교육기관,교육부,남원교육문화회관,교육부 전라북도교육청 남원교육문화회관,20,20,0,20,11,9,0,0
교육기관,교육부,남원국악예술고등학교,교육부 전라북도교육청 남원국악예술고등학교,15,15,0,15,0,15,0,0
교육기관,교육부,남원서진여자고등학교,교육부 전라북도교육청 남원서진여자고등학교,23,23,0,23,0,23,0,0
교육기관,교육부,남원여자고등학교,교육부 전라북도교육청 남원여자고등학교,18,10,8,10,10,0,0,0
교육기관,교육부,남원제일고등학교,교육부 전라북도교육청 남원제일고등학교,36,18,18,18,0,18,0,0
교육기관,교육부,다솜학교,교육부 전라북도교육청 다솜학교,16,16,0,16,0,16,0,0
교육기관,교육부,대야분관,교육부 전라북도교육청 대야분관,12,12,0,12,2,10,0,0
교육기관,교육부,덕암고등학교,교육부 전라북도교육청 덕암고등학교,17,17,0,17,3,14,0,0
교육기관,교육부,덕암정보고등학교,교육부 전라북도교육청 덕암정보고등학교,31,31,0,31,0,31,0,0
교육기관,교육부,동국대학교사범대학부속금산고등학교,교육부 전라북도교육청 동국대학교사범대학부속금산고등학교,30,30,0,30,0,30,0,0
교육기관,교육부,동암고등학교,교육부 전라북도교육청 동암고등학교,102,102,0,102,0,102,0,0
교육기관,교육부,동암차돌학교,교육부 전라북도교육청 동암차돌학교,19,19,0,19,4,15,0,0
교육기관,교육부,마령고등학교,교육부 전라북도교육청 마령고등학교,8,7,1,7,5,2,0,0
교육기관,교육부,만경고등학교,교육부 전라북도교육청 만경고등학교,26,26,0,26,0,26,0,0
교육기관,교육부,만경여자고등학교,교육부 전라북도교육청 만경여자고등학교,11,11,0,11,0,11,0,0
교육기관,교육부,무주고등학교,교육부 전라북도교육청 무주고등학교,16,16,0,16,16,0,0,0
교육기관,교육부,무풍고등학교,교육부 전라북도교육청 무풍고등학교,13,11,2,11,11,0,0,0
교육기관,교육부,배영고등학교,교육부 전라북도교육청 배영고등학교,7,5,2,5,0,5,0,0
교육기관,교육부,백산고등학교,교육부 전라북도교육청 백산고등학교,21,21,0,21,9,12,0,0
교육기관,교육부,백화여자고등학교,교육부 전라북도교육청 백화여자고등학교,22,22,0,22,18,4,0,0
교육기관,교육부,부안고등학교,교육부 전라북도교육청 부안고등학교,20,20,0,20,0,20,0,0
교육기관,교육부,부안교육문화회관,교육부 전라북도교육청 부안교육문화회관,16,16,0,16,0,16,0,0
교육기관,교육부,부안여자고등학교,교육부 전라북도교육청 부안여자고등학교,18,17,1,17,0,17,0,0
교육기관,교육부,부안제일고등학교,교육부 전라북도교육청 부안제일고등학교,30,30,0,30,14,16,0,0
교육기관,교육부,산서고등학교,교육부 전라북도교육청 산서고등학교,13,13,0,13,13,0,0,0
교육기관,교육부,상산고등학교,교육부 전라북도교육청 상산고등학교,193,193,0,193,0,193,0,0
교육기관,교육부,서림고등학교,교육부 전라북도교육청 서림고등학교,6,6,0,6,6,0,0,0
교육기관,교육부,서영여자고등학교,교육부 전라북도교육청 서영여자고등학교,18,18,0,18,0,18,0,0
교육기관,교육부,설천고등학교,교육부 전라북도교육청 설천고등학교,14,13,1,13,11,2,0,0
교육기관,교육부,성원고등학교,교육부 전라북도교육청 성원고등학교,32,8,24,8,6,2,0,0
교육기관,교육부,성일고등학교,교육부 전라북도교육청 성일고등학교,24,20,4,20,4,16,0,0
교육기관,교육부,세인고등학교,교육부 전라북도교육청 세인고등학교,15,15,0,15,0,15,0,0
교육기관,교육부,순창고등학교,교육부 전라북도교육청 순창고등학교,21,21,0,21,0,21,0,0
교육기관,교육부,순창제일고등학교,교육부 전라북도교육청 순창제일고등학교,35,35,0,35,35,0,0,0
교육기관,교육부,신태인고등학교,교육부 전라북도교육청 신태인고등학교,4,4,0,4,4,0,0,0
교육기관,교육부,안성고등학교,교육부 전라북도교육청 안성고등학교,16,16,0,16,0,16,0,0
교육기관,교육부,안천고등학교,교육부 전라북도교육청 안천고등학교,12,12,0,12,12,0,0,0
교육기관,교육부,양현고등학교,교육부 전라북도교육청 양현고등학교,39,39,0,39,0,39,0,0
교육기관,교육부,여산고등학교,교육부 전라북도교육청 여산고등학교,13,13,0,13,10,3,0,0
교육기관,교육부,영선고등학교,교육부 전라북도교육청 영선고등학교,27,27,0,27,0,27,0,0
교육기관,교육부,오수고등학교,교육부 전라북도교육청 오수고등학교,9,8,1,8,8,0,0,0
교육기관,교육부,완산고등학교,교육부 전라북도교육청 완산고등학교,102,102,0,102,0,102,0,0
교육기관,교육부,완산여자고등학교,교육부 전라북도교육청 완산여자고등학교,17,17,0,17,9,8,0,0
교육기관,교육부,완주고등학교,교육부 전라북도교육청 완주고등학교,19,19,0,19,0,19,0,0
교육기관,교육부,왕신여자고등학교,교육부 전라북도교육청 왕신여자고등학교,10,9,1,9,9,0,0,0
교육기관,교육부,우석고등학교,교육부 전라북도교육청 우석고등학교,100,76,24,76,10,61,5,0
교육기관,교육부,원광고등학교,교육부 전라북도교육청 원광고등학교,69,69,0,69,0,69,0,0
교육기관,교육부,원광여자고등학교,교육부 전라북도교육청 원광여자고등학교,7,2,5,2,2,0,0,0
교육기관,교육부,원광정보예술고등학교,교육부 전라북도교육청 원광정보예술고등학교,40,40,0,40,9,31,0,0
교육기관,교육부,이리고등학교,교육부 전라북도교육청 이리고등학교,70,70,0,70,48,22,0,0
교육기관,교육부,이리공업고등학교,교육부 전라북도교육청 이리공업고등학교,40,40,0,40,40,0,0,0
교육기관,교육부,이리여자고등학교,교육부 전라북도교육청 이리여자고등학교,24,23,1,23,0,23,0,0
교육기관,교육부,이일여자고등학교,교육부 전라북도교육청 이일여자고등학교,38,38,0,38,25,13,0,0
교육기관,교육부,익산고등학교,교육부 전라북도교육청 익산고등학교,70,14,56,14,14,0,0,0
교육기관,교육부,익산교육문화회관,교육부 전라북도교육청 익산교육문화회관,46,44,2,44,0,44,0,0
교육기관,교육부,인상고등학교,교육부 전라북도교육청 인상고등학교,20,20,0,20,0,20,0,0
교육기관,교육부,인월고등학교,교육부 전라북도교육청 인월고등학교,12,12,0,12,6,6,0,0
교육기관,교육부,임실고등학교,교육부 전라북도교육청 임실고등학교,32,32,0,32,32,0,0,0
교육기관,교육부,장수고등학교,교육부 전라북도교육청 장수고등학교,30,28,2,28,25,3,0,0
교육기관,교육부,전라고등학교,교육부 전라북도교육청 전라고등학교,39,39,0,39,0,39,0,0
교육기관,교육부,전라북도고창교육지원청,교육부 전라북도교육청 전라북도고창교육지원청,9,9,0,9,0,9,0,0
교육기관,교육부,가평초등학교,교육부 전라북도교육청 전라북도고창교육지원청 가평초등학교,9,9,0,9,4,5,0,0
교육기관,교육부,고수초등학교,교육부 전라북도교육청 전라북도고창교육지원청 고수초등학교,7,7,0,7,5,2,0,0
교육기관,교육부,고창꿈푸른유치원,교육부 전라북도교육청 전라북도고창교육지원청 고창꿈푸른유치원,7,7,0,7,7,0,0,0
교육기관,교육부,고창남중학교,교육부 전라북도교육청 전라북도고창교육지원청 고창남중학교,5,5,0,5,5,0,0,0
교육기관,교육부,고창남초등학교,교육부 전라북도교육청 전라북도고창교육지원청 고창남초등학교,16,16,0,16,16,0,0,0
교육기관,교육부,고창북중학교,교육부 전라북도교육청 전라북도고창교육지원청 고창북중학교,16,16,0,16,2,14,0,0
교육기관,교육부,고창중학교,교육부 전라북도교육청 전라북도고창교육지원청 고창중학교,22,22,0,22,0,22,0,0
교육기관,교육부,고창초등학교,교육부 전라북도교육청 전라북도고창교육지원청 고창초등학교,34,34,0,34,0,34,0,0
교육기관,교육부,공음중학교,교육부 전라북도교육청 전라북도고창교육지원청 공음중학교,8,8,0,8,2,6,0,0
교육기관,교육부,공음초등학교,교육부 전라북도교육청 전라북도고창교육지원청 공음초등학교,13,13,0,13,0,13,0,0
교육기관,교육부,대산초등학교,교육부 전라북도교육청 전라북도고창교육지원청 대산초등학교,4,4,0,4,2,2,0,0
교육기관,교육부,대성중학교,교육부 전라북도교육청 전라북도고창교육지원청 대성중학교,16,16,0,16,5,11,0,0
교육기관,교육부,대아초등학교,교육부 전라북도교육청 전라북도고창교육지원청 대아초등학교,4,4,0,4,4,0,0,0
교육기관,교육부,동호초등학교,교육부 전라북도교육청 전라북도고창교육지원청 동호초등학교,12,12,0,12,12,0,0,0
교육기관,교육부,매산초등학교,교육부 전라북도교육청 전라북도고창교육지원청 매산초등학교,6,6,0,6,0,6,0,0
교육기관,교육부,무장초등학교,교육부 전라북도교육청 전라북도고창교육지원청 무장초등학교,8,8,0,8,8,0,0,0
교육기관,교육부,봉암초등학교,교육부 전라북도교육청 전라북도고창교육지원청 봉암초등학교,8,8,0,8,0,8,0,0
교육기관,교육부,부안초등학교,교육부 전라북도교육청 전라북도고창교육지원청 부안초등학교,8,8,0,8,0,8,0,0
교육기관,교육부,상하중학교,교육부 전라북도교육청 전라북도고창교육지원청 상하중학교,6,6,0,6,4,2,0,0
교육기관,교육부,상하초등학교,교육부 전라북도교육청 전라북도고창교육지원청 상하초등학교,16,16,0,16,0,16,0,0
교육기관,교육부,선동초등학교,교육부 전라북도교육청 전라북도고창교육지원청 선동초등학교,4,4,0,4,2,2,0,0
교육기관,교육부,성내중학교,교육부 전라북도교육청 전라북도고창교육지원청 성내중학교,1,0,1,0,0,0,0,0
교육기관,교육부,성내초등학교,교육부 전라북도교육청 전라북도고창교육지원청 성내초등학교,6,6,0,6,3,3,0,0
교육기관,교육부,성송초등학교,교육부 전라북도교육청 전라북도고창교육지원청 성송초등학교,10,10,0,10,10,0,0,0
교육기관,교육부,신림중학교,교육부 전라북도교육청 전라북도고창교육지원청 신림중학교,7,7,0,7,4,3,0,0
교육기관,교육부,신림초등학교,교육부 전라북도교육청 전라북도고창교육지원청 신림초등학교,8,8,0,8,0,8,0,0
교육기관,교육부,심원중학교,교육부 전라북도교육청 전라북도고창교육지원청 심원중학교,8,8,0,8,8,0,0,0
교육기관,교육부,심원초등학교,교육부 전라북도교육청 전라북도고창교육지원청 심원초등학교,15,15,0,15,0,15,0,0
교육기관,교육부,아산중학교,교육부 전라북도교육청 전라북도고창교육지원청 아산중학교,7,7,0,7,7,0,0,0
교육기관,교육부,아산초등학교,교육부 전라북도교육청 전라북도고창교육지원청 아산초등학교,10,10,0,10,0,10,0,0
교육기관,교육부,영선중학교,교육부 전라북도교육청 전라북도고창교육지원청 영선중학교,38,38,0,38,0,38,0,0
교육기관,교육부,자유중학교,교육부 전라북도교육청 전라북도고창교육지원청 자유중학교,32,32,0,32,11,21,0,0
교육기관,교육부,전라북도교육청고창도서관,교육부 전라북도교육청 전라북도고창교육지원청 전라북도교육청고창도서관,0,0,0,0,0,0,0,0
교육기관,교육부,중앙유치원,교육부 전라북도교육청 전라북도고창교육지원청 중앙유치원,16,16,0,16,2,14,0,0
교육기관,교육부,해리중학교,교육부 전라북도교육청 전라북도고창교육지원청 해리중학교,6,6,0,6,2,4,0,0
교육기관,교육부,해리초등학교,교육부 전라북도교육청 전라북도고창교육지원청 해리초등학교,12,12,0,12,6,6,0,0
교육기관,교육부,흥덕중학교,교육부 전라북도교육청 전라북도고창교육지원청 흥덕중학교,17,17,0,17,6,11,0,0
교육기관,교육부,흥덕초등학교,교육부 전라북도교육청 전라북도고창교육지원청 흥덕초등학교,14,14,0,14,14,0,0,0
교육기관,교육부,전라북도교육청과학교육원,교육부 전라북도교육청 전라북도교육청과학교육원,49,49,0,49,49,0,0,0
교육기관,교육부,전라북도교육청교직원수련원,교육부 전라북도교육청 전라북도교육청교직원수련원,55,55,0,55,0,55,0,0
교육기관,교육부,전라북도교육청미래교육연구원,교육부 전라북도교육청 전라북도교육청미래교육연구원,30,12,18,12,0,12,0,0
교육기관,교육부,전라북도교육청유아교육진흥원,교육부 전라북도교육청 전라북도교육청유아교육진흥원,28,28,0,28,12,16,0,0
교육기관,교육부,전라북도교육청학생수련원,교육부 전라북도교육청 전라북도교육청학생수련원,9,9,0,9,0,9,0,0
교육기관,교육부,전라북도교육청학생해양수련원,교육부 전라북도교육청 전라북도교육청학생해양수련원,14,14,0,14,0,14,0,0
교육기관,교육부,개야도초등학교,교육부 전라북도교육청 전라북도군산교육지원청 개야도초등학교,7,7,0,7,2,5,0,0
교육기관,교육부,개정초등학교,교육부 전라북도교육청 전라북도군산교육지원청 개정초등학교,12,12,0,12,6,6,0,0
교육기관,교육부,군산가람유치원,교육부 전라북도교육청 전라북도군산교육지원청 군산가람유치원,32,16,16,16,8,8,0,0
교육기관,교육부,군산경포초등학교,교육부 전라북도교육청 전라북도군산교육지원청 군산경포초등학교,38,38,0,38,38,0,0,0
교육기관,교육부,군산구암초등학교,교육부 전라북도교육청 전라북도군산교육지원청 군산구암초등학교,19,19,0,19,19,0,0,0
교육기관,교육부,군산금강중학교,교육부 전라북도교육청 전라북도군산교육지원청 군산금강중학교,44,44,0,44,16,28,0,0
교육기관,교육부,군산금광초등학교,교육부 전라북도교육청 전라북도군산교육지원청 군산금광초등학교,18,18,0,18,8,10,0,0
교육기관,교육부,군산금빛초등학교,교육부 전라북도교육청 전라북도군산교육지원청 군산금빛초등학교,24,24,0,24,0,24,0,0
교육기관,교육부,군산남중학교,교육부 전라북도교육청 전라북도군산교육지원청 군산남중학교,7,7,0,7,2,5,0,0
교육기관,교육부,군산남초등학교,교육부 전라북도교육청 전라북도군산교육지원청 군산남초등학교,16,16,0,16,8,8,0,0
교육기관,교육부,군산내흥초등학교,교육부 전라북도교육청 전라북도군산교육지원청 군산내흥초등학교,9,9,0,9,4,5,0,0
교육기관,교육부,군산대성중학교,교육부 전라북도교육청 전라북도군산교육지원청 군산대성중학교,16,16,0,16,0,16,0,0
교육기관,교육부,군산도담유치원,교육부 전라북도교육청 전라북도군산교육지원청 군산도담유치원,12,2,10,2,0,2,0,0
교육기관,교육부,군산동산중학교,교육부 전라북도교육청 전라북도군산교육지원청 군산동산중학교,32,32,0,32,32,0,0,0
교육기관,교육부,군산동원중학교,교육부 전라북도교육청 전라북도군산교육지원청 군산동원중학교,54,54,0,54,40,14,0,0
교육기관,교육부,군산동초등학교,교육부 전라북도교육청 전라북도군산교육지원청 군산동초등학교,8,8,0,8,8,0,0,0
교육기관,교육부,군산문화초등학교,교육부 전라북도교육청 전라북도군산교육지원청 군산문화초등학교,8,8,0,8,8,0,0,0
교육기관,교육부,군산미성초등학교,교육부 전라북도교육청 전라북도군산교육지원청 군산미성초등학교,10,10,0,10,0,0,0,10
교육기관,교육부,군산미장초등학교,교육부 전라북도교육청 전라북도군산교육지원청 군산미장초등학교,16,16,0,16,16,0,0,0
교육기관,교육부,군산바다유치원,교육부 전라북도교육청 전라북도군산교육지원청 군산바다유치원,8,8,0,8,6,2,0,0
교육기관,교육부,군산산북중학교,교육부 전라북도교육청 전라북도군산교육지원청 군산산북중학교,18,18,0,18,18,0,0,0
교육기관,교육부,군산산북초등학교,교육부 전라북도교육청 전라북도군산교육지원청 군산산북초등학교,12,12,0,12,8,2,1,1
교육기관,교육부,군산서초등학교,교육부 전라북도교육청 전라북도군산교육지원청 군산서초등학교,10,10,0,10,5,5,0,0
교육기관,교육부,군산서해초등학교,교육부 전라북도교육청 전라북도군산교육지원청 군산서해초등학교,21,21,0,21,21,0,0,0
교육기관,교육부,군산서흥중학교,교육부 전라북도교육청 전라북도군산교육지원청 군산서흥중학교,35,35,0,35,19,14,0,2
교육기관,교육부,군산수송초등학교,교육부 전라북도교육청 전라북도군산교육지원청 군산수송초등학교,11,11,0,11,11,0,0,0
교육기관,교육부,군산신풍초등학교,교육부 전라북도교육청 전라북도군산교육지원청 군산신풍초등학교,19,19,0,19,0,19,0,0
교육기관,교육부,군산신흥초등학교,교육부 전라북도교육청 전라북도군산교육지원청 군산신흥초등학교,26,26,0,26,0,26,0,0
교육기관,교육부,군산아리울초등학교,교육부 전라북도교육청 전라북도군산교육지원청 군산아리울초등학교,18,18,0,18,0,18,0,0
교육기관,교육부,군산영어체험학습센터,교육부 전라북도교육청 전라북도군산교육지원청 군산영어체험학습센터,18,18,0,18,5,13,0,0
교육기관,교육부,군산용문초등학교,교육부 전라북도교육청 전라북도군산교육지원청 군산용문초등학교,16,16,0,16,5,11,0,0
교육기관,교육부,군산우리별유치원,교육부 전라북도교육청 전라북도군산교육지원청 군산우리별유치원,9,9,0,9,8,1,0,0
교육기관,교육부,군산월명중학교,교육부 전라북도교육청 전라북도군산교육지원청 군산월명중학교,24,24,0,24,16,8,0,0
교육기관,교육부,군산월명초등학교,교육부 전라북도교육청 전라북도군산교육지원청 군산월명초등학교,26,26,0,26,0,26,0,0
교육기관,교육부,군산자양중학교,교육부 전라북도교육청 전라북도군산교육지원청 군산자양중학교,8,8,0,8,0,8,0,0
교육기관,교육부,군산제일중학교,교육부 전라북도교육청 전라북도군산교육지원청 군산제일중학교,21,21,0,21,21,0,0,0
교육기관,교육부,군산중앙유치원,교육부 전라북도교육청 전라북도군산교육지원청 군산중앙유치원,8,8,0,8,0,8,0,0
교육기관,교육부,군산중앙중학교,교육부 전라북도교육청 전라북도군산교육지원청 군산중앙중학교,56,56,0,56,4,52,0,0
교육기관,교육부,군산중앙초등학교,교육부 전라북도교육청 전라북도군산교육지원청 군산중앙초등학교,8,8,0,8,4,2,0,2
교육기관,교육부,군산지곡초등학교,교육부 전라북도교육청 전라북도군산교육지원청 군산지곡초등학교,9,9,0,9,0,9,0,0
교육기관,교육부,군산진포중학교,교육부 전라북도교육청 전라북도군산교육지원청 군산진포중학교,30,30,0,30,0,30,0,0
교육기관,교육부,군산진포초등학교,교육부 전라북도교육청 전라북도군산교육지원청 군산진포초등학교,15,15,0,15,13,2,0,0
교육기관,교육부,군산초등학교,교육부 전라북도교육청 전라북도군산교육지원청 군산초등학교,22,22,0,22,22,0,0,0
교육기관,교육부,군산푸른솔초등학교,교육부 전라북도교육청 전라북도군산교육지원청 군산푸른솔초등학교,9,9,0,9,9,0,0,0
교육기관,교육부,군산풍문초등학교,교육부 전라북도교육청 전라북도군산교육지원청 군산풍문초등학교,8,8,0,8,0,8,0,0
교육기관,교육부,군산해성초등학교,교육부 전라북도교육청 전라북도군산교육지원청 군산해성초등학교,7,7,0,7,0,7,0,0
교육기관,교육부,군산흥남초등학교,교육부 전라북도교육청 전라북도군산교육지원청 군산흥남초등학교,16,16,0,16,0,16,0,0
교육기관,교육부,금암초등학교,교육부 전라북도교육청 전라북도군산교육지원청 금암초등학교,11,10,1,10,0,10,0,0
교육기관,교육부,나포중학교,교육부 전라북도교육청 전라북도군산교육지원청 나포중학교,0,0,0,0,0,0,0,0
교육기관,교육부,나포초등학교,교육부 전라북도교육청 전라북도군산교육지원청 나포초등학교,8,8,0,8,8,0,0,0
교육기관,교육부,당북초등학교,교육부 전라북도교육청 전라북도군산교육지원청 당북초등학교,16,16,0,16,0,16,0,0
교육기관,교육부,대야남초등학교,교육부 전라북도교육청 전라북도군산교육지원청 대야남초등학교,6,6,0,6,0,6,0,0
교육기관,교육부,대야초등학교,교육부 전라북도교육청 전라북도군산교육지원청 대야초등학교,9,9,0,9,2,7,0,0
교육기관,교육부,마룡초등학교,교육부 전라북도교육청 전라북도군산교육지원청 마룡초등학교,10,10,0,10,10,0,0,0
교육기관,교육부,무녀도초등학교,교육부 전라북도교육청 전라북도군산교육지원청 무녀도초등학교,8,8,0,8,8,0,0,0
교육기관,교육부,문창초등학교,교육부 전라북도교육청 전라북도군산교육지원청 문창초등학교,12,12,0,12,0,12,0,0
교육기관,교육부,미룡초등학교,교육부 전라북도교육청 전라북도군산교육지원청 미룡초등학교,7,7,0,7,5,2,0,0
교육기관,교육부,새만금초등학교,교육부 전라북도교육청 전라북도군산교육지원청 새만금초등학교,10,10,0,10,0,10,0,0
교육기관,교육부,서수초등학교,교육부 전라북도교육청 전라북도군산교육지원청 서수초등학교,8,8,0,8,8,0,0,0
교육기관,교육부,선유도초등학교,교육부 전라북도교육청 전라북도군산교육지원청 선유도초등학교,11,11,0,11,11,0,0,0
교육기관,교육부,성산초등학교,교육부 전라북도교육청 전라북도군산교육지원청 성산초등학교,7,7,0,7,5,2,0,0
교육기관,교육부,소룡초등학교,교육부 전라북도교육청 전라북도군산교육지원청 소룡초등학교,15,15,0,15,8,7,0,0
교육기관,교육부,술산초등학교,교육부 전라북도교육청 전라북도군산교육지원청 술산초등학교,10,10,0,10,10,0,0,0
교육기관,교육부,신시도초등학교,교육부 전라북도교육청 전라북도군산교육지원청 신시도초등학교,6,6,0,6,2,4,0,0
교육기관,교육부,오봉초등학교,교육부 전라북도교육청 전라북도군산교육지원청 오봉초등학교,8,8,0,8,7,1,0,0
교육기관,교육부,옥구중학교,교육부 전라북도교육청 전라북도군산교육지원청 옥구중학교,4,4,0,4,4,0,0,0
교육기관,교육부,옥구초등학교,교육부 전라북도교육청 전라북도군산교육지원청 옥구초등학교,12,12,0,12,6,6,0,0
교육기관,교육부,옥봉초등학교,교육부 전라북도교육청 전라북도군산교육지원청 옥봉초등학교,8,8,0,8,0,8,0,0
교육기관,교육부,옥산초등학교,교육부 전라북도교육청 전라북도군산교육지원청 옥산초등학교,13,13,0,13,0,13,0,0
교육기관,교육부,임피중학교,교육부 전라북도교육청 전라북도군산교육지원청 임피중학교,11,11,0,11,11,0,0,0
교육기관,교육부,임피초등학교,교육부 전라북도교육청 전라북도군산교육지원청 임피초등학교,9,9,0,9,9,0,0,0
교육기관,교육부,창오초등학교,교육부 전라북도교육청 전라북도군산교육지원청 창오초등학교,12,12,0,12,12,0,0,0
교육기관,교육부,회현중학교,교육부 전라북도교육청 전라북도군산교육지원청 회현중학교,8,8,0,8,0,8,0,0
교육기관,교육부,회현초등학교,교육부 전라북도교육청 전라북도군산교육지원청 회현초등학교,8,8,0,8,0,8,0,0
교육기관,교육부,전라북도김제교육지원청,교육부 전라북도교육청 전라북도김제교육지원청,9,9,0,9,0,9,0,0
교육기관,교육부,공덕초등학교,교육부 전라북도교육청 전라북도김제교육지원청 공덕초등학교,8,8,0,8,6,2,0,0
교육기관,교육부,광활초등학교,교육부 전라북도교육청 전라북도김제교육지원청 광활초등학교,3,3,0,3,2,1,0,0
교육기관,교육부,금구중학교,교육부 전라북도교육청 전라북도김제교육지원청 금구중학교,19,19,0,19,0,19,0,0
교육기관,교육부,금남초등학교,교육부 전라북도교육청 전라북도김제교육지원청 금남초등학교,8,8,0,8,4,4,0,0
교육기관,교육부,금산초등학교,교육부 전라북도교육청 전라북도김제교육지원청 금산초등학교,8,8,0,8,8,0,0,0
교육기관,교육부,금성중학교,교육부 전라북도교육청 전라북도김제교육지원청 금성중학교,41,41,0,41,0,41,0,0
교육기관,교육부,김제검산초등학교,교육부 전라북도교육청 전라북도김제교육지원청 김제검산초등학교,16,16,0,16,0,16,0,0
교육기관,교육부,김제동초등학교,교육부 전라북도교육청 전라북도김제교육지원청 김제동초등학교,13,13,0,13,13,0,0,0
교육기관,교육부,김제북초등학교,교육부 전라북도교육청 전라북도김제교육지원청 김제북초등학교,13,13,0,13,0,13,0,0
교육기관,교육부,김제제일유치원,교육부 전라북도교육청 전라북도김제교육지원청 김제제일유치원,4,4,0,4,4,0,0,0
교육기관,교육부,김제중앙중학교,교육부 전라북도교육청 전라북도김제교육지원청 김제중앙중학교,16,16,0,16,12,4,0,0
교육기관,교육부,김제중앙초등학교,교육부 전라북도교육청 전라북도김제교육지원청 김제중앙초등학교,14,14,0,14,14,0,0,0
교육기관,교육부,김제중학교,교육부 전라북도교육청 전라북도김제교육지원청 김제중학교,12,12,0,12,12,0,0,0
교육기관,교육부,김제초등학교,교육부 전라북도교육청 전라북도김제교육지원청 김제초등학교,16,16,0,16,0,16,0,0
교육기관,교육부,난산초등학교,교육부 전라북도교육청 전라북도김제교육지원청 난산초등학교,8,8,0,8,4,4,0,0
교육기관,교육부,남양초등학교,교육부 전라북도교육청 전라북도김제교육지원청 남양초등학교,12,12,0,12,12,0,0,0
교육기관,교육부,덕암중학교,교육부 전라북도교육청 전라북도김제교육지원청 덕암중학교,23,23,0,23,10,13,0,0
교육기관,교육부,동국대학교사범대학부속금산중학교,교육부 전라북도교육청 전라북도김제교육지원청 동국대학교사범대학부속금산중학교,17,17,0,17,0,17,0,0
교육기관,교육부,만경여자중학교,교육부 전라북도교육청 전라북도김제교육지원청 만경여자중학교,7,7,0,7,0,7,0,0
교육기관,교육부,만경중학교,교육부 전라북도교육청 전라북도김제교육지원청 만경중학교,8,8,0,8,0,8,0,0
교육기관,교육부,만경초등학교,교육부 전라북도교육청 전라북도김제교육지원청 만경초등학교,12,12,0,12,12,0,0,0
교육기관,교육부,백구초등학교,교육부 전라북도교육청 전라북도김제교육지원청 백구초등학교,10,10,0,10,10,0,0,0
교육기관,교육부,백석초등학교,교육부 전라북도교육청 전라북도김제교육지원청 백석초등학교,11,11,0,11,5,6,0,0
교육기관,교육부,벽량초등학교,교육부 전라북도교육청 전라북도김제교육지원청 벽량초등학교,8,8,0,8,4,4,0,0
교육기관,교육부,봉남중학교,교육부 전라북도교육청 전라북도김제교육지원청 봉남중학교,6,6,0,6,3,3,0,0
교육기관,교육부,봉남초등학교,교육부 전라북도교육청 전라북도김제교육지원청 봉남초등학교,10,10,0,10,10,0,0,0
교육기관,교육부,부용초등학교,교육부 전라북도교육청 전라북도김제교육지원청 부용초등학교,10,10,0,10,10,0,0,0
교육기관,교육부,비룡초등학교,교육부 전라북도교육청 전라북도김제교육지원청 비룡초등학교,5,5,0,5,2,3,0,0
교육기관,교육부,성덕초등학교,교육부 전라북도교육청 전라북도김제교육지원청 성덕초등학교,3,3,0,3,3,0,0,0
교육기관,교육부,심창초등학교,교육부 전라북도교육청 전라북도김제교육지원청 심창초등학교,10,10,0,10,0,10,0,0
교육기관,교육부,용동초등학교,교육부 전라북도교육청 전라북도김제교육지원청 용동초등학교,5,5,0,5,5,0,0,0
교육기관,교육부,용지중학교,교육부 전라북도교육청 전라북도김제교육지원청 용지중학교,6,6,0,6,2,2,1,1
교육기관,교육부,용지초등학교,교육부 전라북도교육청 전라북도김제교육지원청 용지초등학교,12,12,0,12,12,0,0,0
교육기관,교육부,원평초등학교,교육부 전라북도교육청 전라북도김제교육지원청 원평초등학교,8,8,0,8,3,5,0,0
교육기관,교육부,월성초등학교,교육부 전라북도교육청 전라북도김제교육지원청 월성초등학교,16,16,0,16,0,16,0,0
교육기관,교육부,월촌초등학교,교육부 전라북도교육청 전라북도김제교육지원청 월촌초등학교,4,4,0,4,4,0,0,0
교육기관,교육부,종정초등학교,교육부 전라북도교육청 전라북도김제교육지원청 종정초등학교,8,8,0,8,5,3,0,0
교육기관,교육부,죽산초등학교,교육부 전라북도교육청 전라북도김제교육지원청 죽산초등학교,9,9,0,9,8,1,0,0
교육기관,교육부,지평선중학교,교육부 전라북도교육청 전라북도김제교육지원청 지평선중학교,16,16,0,16,0,16,0,0
교육기관,교육부,진봉초등학교,교육부 전라북도교육청 전라북도김제교육지원청 진봉초등학교,8,8,0,8,4,4,0,0
교육기관,교육부,청운초등학교,교육부 전라북도교육청 전라북도김제교육지원청 청운초등학교,5,5,0,5,5,0,0,0
교육기관,교육부,청하중학교,교육부 전라북도교육청 전라북도김제교육지원청 청하중학교,6,6,0,6,4,2,0,0
교육기관,교육부,청하초등학교,교육부 전라북도교육청 전라북도김제교육지원청 청하초등학교,16,16,0,16,0,16,0,0
교육기관,교육부,초처초등학교,교육부 전라북도교육청 전라북도김제교육지원청 초처초등학교,11,11,0,11,11,0,0,0
교육기관,교육부,치문초등학교,교육부 전라북도교육청 전라북도김제교육지원청 치문초등학교,9,9,0,9,9,0,0,0
교육기관,교육부,한들중학교,교육부 전라북도교육청 전라북도김제교육지원청 한들중학교,8,6,2,6,6,0,0,0
교육기관,교육부,화율초등학교,교육부 전라북도교육청 전라북도김제교육지원청 화율초등학교,4,4,0,4,0,4,0,0
교육기관,교육부,황강초등학교,교육부 전라북도교육청 전라북도김제교육지원청 황강초등학교,7,7,0,7,7,0,0,0
교육기관,교육부,황산초등학교,교육부 전라북도교육청 전라북도김제교육지원청 황산초등학교,8,8,0,8,0,8,0,0
교육기관,교육부,전라북도남원교육지원청,교육부 전라북도교육청 전라북도남원교육지원청,12,12,0,12,12,0,0,0
교육기관,교육부,금지동초등학교,교육부 전라북도교육청 전라북도남원교육지원청 금지동초등학교,11,11,0,11,0,11,0,0
교육기관,교육부,금지중학교,교육부 전라북도교육청 전라북도남원교육지원청 금지중학교,3,3,0,3,0,3,0,0
교육기관,교육부,금지초등학교,교육부 전라북도교육청 전라북도남원교육지원청 금지초등학교,11,11,0,11,0,11,0,0
교육기관,교육부,남원교룡초등학교,교육부 전라북도교육청 전라북도남원교육지원청 남원교룡초등학교,18,18,0,18,10,8,0,0
교육기관,교육부,남원노암초등학교,교육부 전라북도교육청 전라북도남원교육지원청 남원노암초등학교,16,16,0,16,0,16,0,0
교육기관,교육부,남원대산초등학교,교육부 전라북도교육청 전라북도남원교육지원청 남원대산초등학교,14,14,0,14,14,0,0,0
교육기관,교육부,남원도통초등학교,교육부 전라북도교육청 전라북도남원교육지원청 남원도통초등학교,15,15,0,15,15,0,0,0
교육기관,교육부,남원산내초등학교,교육부 전라북도교육청 전라북도남원교육지원청 남원산내초등학교,24,24,0,24,24,0,0,0
교육기관,교육부,남원서원초등학교,교육부 전라북도교육청 전라북도남원교육지원청 남원서원초등학교,9,9,0,9,0,9,0,0
교육기관,교육부,남원영어체험학습센터,교육부 전라북도교육청 전라북도남원교육지원청 남원영어체험학습센터,14,14,0,14,0,14,0,0
교육기관,교육부,남원왕치초등학교,교육부 전라북도교육청 전라북도남원교육지원청 남원왕치초등학교,5,5,0,5,3,2,0,0
교육기관,교육부,남원용성중학교,교육부 전라북도교육청 전라북도남원교육지원청 남원용성중학교,30,30,0,30,18,12,0,0
교육기관,교육부,남원용성초등학교,교육부 전라북도교육청 전라북도남원교육지원청 남원용성초등학교,16,16,0,16,16,0,0,0
교육기관,교육부,남원월락초등학교,교육부 전라북도교육청 전라북도남원교육지원청 남원월락초등학교,13,13,0,13,13,0,0,0
교육기관,교육부,남원중앙초등학교,교육부 전라북도교육청 전라북도남원교육지원청 남원중앙초등학교,16,16,0,16,16,0,0,0
교육기관,교육부,남원중학교,교육부 전라북도교육청 전라북도남원교육지원청 남원중학교,32,32,0,32,32,0,0,0
교육기관,교육부,남원참사랑유치원,교육부 전라북도교육청 전라북도남원교육지원청 남원참사랑유치원,8,8,0,8,8,0,0,0
교육기관,교육부,남원초등학교,교육부 전라북도교육청 전라북도남원교육지원청 남원초등학교,20,20,0,20,20,0,0,0
교육기관,교육부,남원하늘중학교,교육부 전라북도교육청 전라북도남원교육지원청 남원하늘중학교,25,25,0,25,15,10,0,0
교육기관,교육부,남원한빛중학교,교육부 전라북도교육청 전라북도남원교육지원청 남원한빛중학교,18,18,0,18,10,8,0,0
교육기관,교육부,대강중학교,교육부 전라북도교육청 전라북도남원교육지원청 대강중학교,10,10,0,10,0,10,0,0
교육기관,교육부,대강초등학교,교육부 전라북도교육청 전라북도남원교육지원청 대강초등학교,16,16,0,16,16,0,0,0
교육기관,교육부,덕과초등학교,교육부 전라북도교육청 전라북도남원교육지원청 덕과초등학교,16,16,0,16,16,0,0,0
교육기관,교육부,보절중학교,교육부 전라북도교육청 전라북도남원교육지원청 보절중학교,6,6,0,6,6,0,0,0
교육기관,교육부,보절초등학교,교육부 전라북도교육청 전라북도남원교육지원청 보절초등학교,13,13,0,13,0,13,0,0
교육기관,교육부,사매초등학교,교육부 전라북도교육청 전라북도남원교육지원청 사매초등학교,9,9,0,9,0,9,0,0
교육기관,교육부,산내중학교,교육부 전라북도교육청 전라북도남원교육지원청 산내중학교,8,4,4,4,0,4,0,0
교육기관,교육부,산동초등학교,교육부 전라북도교육청 전라북도남원교육지원청 산동초등학교,10,10,0,10,4,6,0,0
교육기관,교육부,송동중학교,교육부 전라북도교육청 전라북도남원교육지원청 송동중학교,4,4,0,4,4,0,0,0
교육기관,교육부,송동초등학교,교육부 전라북도교육청 전라북도남원교육지원청 송동초등학교,8,8,0,8,8,0,0,0
교육기관,교육부,수지중학교,교육부 전라북도교육청 전라북도남원교육지원청 수지중학교,6,6,0,6,3,3,0,0
교육기관,교육부,수지초등학교,교육부 전라북도교육청 전라북도남원교육지원청 수지초등학교,13,13,0,13,13,0,0,0
교육기관,교육부,아영중학교,교육부 전라북도교육청 전라북도남원교육지원청 아영중학교,7,7,0,7,0,7,0,0
교육기관,교육부,아영초등학교,교육부 전라북도교육청 전라북도남원교육지원청 아영초등학교,8,8,0,8,2,6,0,0
교육기관,교육부,오동초등학교,교육부 전라북도교육청 전라북도남원교육지원청 오동초등학교,13,13,0,13,7,6,0,0
교육기관,교육부,용북중학교,교육부 전라북도교육청 전라북도남원교육지원청 용북중학교,38,38,0,38,14,24,0,0
교육기관,교육부,운봉중학교,교육부 전라북도교육청 전라북도남원교육지원청 운봉중학교,18,18,0,18,18,0,0,0
교육기관,교육부,운봉초등학교,교육부 전라북도교육청 전라북도남원교육지원청 운봉초등학교,8,8,0,8,0,8,0,0
교육기관,교육부,원천초등학교,교육부 전라북도교육청 전라북도남원교육지원청 원천초등학교,7,7,0,7,6,0,1,0
교육기관,교육부,이백초등학교,교육부 전라북도교육청 전라북도남원교육지원청 이백초등학교,12,12,0,12,2,10,0,0
교육기관,교육부,인월초등학교,교육부 전라북도교육청 전라북도남원교육지원청 인월초등학교,14,14,0,14,14,0,0,0
교육기관,교육부,주생초등학교,교육부 전라북도교육청 전라북도남원교육지원청 주생초등학교,17,17,0,17,17,0,0,0
교육기관,교육부,전라북도무주교육지원청,교육부 전라북도교육청 전라북도무주교육지원청,12,12,0,12,0,12,0,0
교육기관,교육부,괴목초등학교,교육부 전라북도교육청 전라북도무주교육지원청 괴목초등학교,12,12,0,12,9,3,0,0
교육기관,교육부,구천초등학교,교육부 전라북도교육청 전라북도무주교육지원청 구천초등학교,13,13,0,13,13,0,0,0
교육기관,교육부,무주공공도서관,교육부 전라북도교육청 전라북도무주교육지원청 무주공공도서관,16,16,0,16,0,16,0,0
교육기관,교육부,무주반디유치원,교육부 전라북도교육청 전라북도무주교육지원청 무주반디유치원,11,11,0,11,0,11,0,0
교육기관,교육부,무주중앙초등학교,교육부 전라북도교육청 전라북도무주교육지원청 무주중앙초등학교,24,24,0,24,24,0,0,0
교육기관,교육부,무주중학교,교육부 전라북도교육청 전라북도무주교육지원청 무주중학교,15,15,0,15,0,15,0,0
교육기관,교육부,무주초등학교,교육부 전라북도교육청 전라북도무주교육지원청 무주초등학교,13,13,0,13,13,0,0,0
교육기관,교육부,무풍초등학교,교육부 전라북도교육청 전라북도무주교육지원청 무풍초등학교,8,8,0,8,0,8,0,0
교육기관,교육부,부남중학교,교육부 전라북도교육청 전라북도무주교육지원청 부남중학교,3,3,0,3,0,3,0,0
교육기관,교육부,부남초등학교,교육부 전라북도교육청 전라북도무주교육지원청 부남초등학교,8,8,0,8,0,8,0,0
교육기관,교육부,부당초등학교,교육부 전라북도교육청 전라북도무주교육지원청 부당초등학교,8,8,0,8,4,4,0,0
교육기관,교육부,설천중학교,교육부 전라북도교육청 전라북도무주교육지원청 설천중학교,14,13,1,13,11,2,0,0
교육기관,교육부,설천초등학교,교육부 전라북도교육청 전라북도무주교육지원청 설천초등학교,16,16,0,16,16,0,0,0
교육기관,교육부,안성중학교,교육부 전라북도교육청 전라북도무주교육지원청 안성중학교,8,8,0,8,0,8,0,0
교육기관,교육부,안성초등학교,교육부 전라북도교육청 전라북도무주교육지원청 안성초등학교,11,11,0,11,11,0,0,0
교육기관,교육부,적상중학교,교육부 전라북도교육청 전라북도무주교육지원청 적상중학교,6,6,0,6,6,0,0,0
교육기관,교육부,적상초등학교,교육부 전라북도교육청 전라북도무주교육지원청 적상초등학교,16,16,0,16,16,0,0,0
교육기관,교육부,전라북도부안교육지원청,교육부 전라북도교육청 전라북도부안교육지원청,4,4,0,4,0,4,0,0
교육기관,교육부,격포초등학교,교육부 전라북도교육청 전라북도부안교육지원청 격포초등학교,7,7,0,7,0,7,0,0
교육기관,교육부,계화중학교,교육부 전라북도교육청 전라북도부안교육지원청 계화중학교,4,4,0,4,2,2,0,0
교육기관,교육부,계화초등학교,교육부 전라북도교육청 전라북도부안교육지원청 계화초등학교,5,5,0,5,3,2,0,0
교육기관,교육부,곰소초등학교,교육부 전라북도교육청 전라북도부안교육지원청 곰소초등학교,4,4,0,4,2,2,0,0
교육기관,교육부,낭주중학교,교육부 전라북도교육청 전라북도부안교육지원청 낭주중학교,13,12,1,12,0,12,0,0
교육기관,교육부,동북초등학교,교육부 전라북도교육청 전라북도부안교육지원청 동북초등학교,4,4,0,4,3,1,0,0
교육기관,교육부,동진초등학교,교육부 전라북도교육청 전라북도부안교육지원청 동진초등학교,12,12,0,12,0,12,0,0
교육기관,교육부,백련초등학교,교육부 전라북도교육청 전라북도부안교육지원청 백련초등학교,9,9,0,9,0,9,0,0
교육기관,교육부,백룡초등학교,교육부 전라북도교육청 전라북도부안교육지원청 백룡초등학교,10,10,0,10,4,4,0,2
교육기관,교육부,백산중학교,교육부 전라북도교육청 전라북도부안교육지원청 백산중학교,18,18,0,18,15,3,0,0
교육기관,교육부,백산초등학교,교육부 전라북도교육청 전라북도부안교육지원청 백산초등학교,8,8,0,8,4,4,0,0
교육기관,교육부,변산서중학교,교육부 전라북도교육청 전라북도부안교육지원청 변산서중학교,3,3,0,3,0,3,0,0
교육기관,교육부,변산중학교,교육부 전라북도교육청 전라북도부안교육지원청 변산중학교,7,7,0,7,0,7,0,0
교육기관,교육부,변산초등학교,교육부 전라북도교육청 전라북도부안교육지원청 변산초등학교,7,7,0,7,3,4,0,0
교육기관,교육부,보안중학교,교육부 전라북도교육청 전라북도부안교육지원청 보안중학교,9,9,0,9,5,4,0,0
교육기관,교육부,부안남초등학교,교육부 전라북도교육청 전라북도부안교육지원청 부안남초등학교,8,8,0,8,8,0,0,0
교육기관,교육부,부안동초등학교,교육부 전라북도교육청 전라북도부안교육지원청 부안동초등학교,16,16,0,16,10,6,0,0
교육기관,교육부,부안중학교,교육부 전라북도교육청 전라북도부안교육지원청 부안중학교,12,12,0,12,0,12,0,0
교육기관,교육부,부안초등학교,교육부 전라북도교육청 전라북도부안교육지원청 부안초등학교,20,20,0,20,0,20,0,0
교육기관,교육부,부안해오름유치원,교육부 전라북도교육청 전라북도부안교육지원청 부안해오름유치원,6,6,0,6,0,6,0,0
교육기관,교육부,삼남중학교,교육부 전라북도교육청 전라북도부안교육지원청 삼남중학교,34,33,1,33,0,33,0,0
교육기관,교육부,상서중학교,교육부 전라북도교육청 전라북도부안교육지원청 상서중학교,8,7,1,7,6,1,0,0
교육기관,교육부,상서초등학교,교육부 전라북도교육청 전라북도부안교육지원청 상서초등학교,4,4,0,4,0,4,0,0
교육기관,교육부,영전초등학교,교육부 전라북도교육청 전라북도부안교육지원청 영전초등학교,7,7,0,7,6,1,0,0
교육기관,교육부,우덕초등학교,교육부 전라북도교육청 전라북도부안교육지원청 우덕초등학교,4,4,0,4,0,4,0,0
교육기관,교육부,위도중학교,교육부 전라북도교육청 전라북도부안교육지원청 위도중학교,8,8,0,8,8,0,0,0
교육기관,교육부,위도초등학교,교육부 전라북도교육청 전라북도부안교육지원청 위도초등학교,4,4,0,4,4,0,0,0
교육기관,교육부,주산중학교,교육부 전라북도교육청 전라북도부안교육지원청 주산중학교,4,4,0,4,1,3,0,0
교육기관,교육부,주산초등학교,교육부 전라북도교육청 전라북도부안교육지원청 주산초등학교,7,7,0,7,7,0,0,0
교육기관,교육부,줄포중학교,교육부 전라북도교육청 전라북도부안교육지원청 줄포중학교,8,8,0,8,0,8,0,0
교육기관,교육부,줄포초등학교,교육부 전라북도교육청 전라북도부안교육지원청 줄포초등학교,14,14,0,14,14,0,0,0
교육기관,교육부,창북초등학교,교육부 전라북도교육청 전라북도부안교육지원청 창북초등학교,8,8,0,8,8,0,0,0
교육기관,교육부,하서초등학교,교육부 전라북도교육청 전라북도부안교육지원청 하서초등학교,4,4,0,4,4,0,0,0
교육기관,교육부,행안초등학교,교육부 전라북도교육청 전라북도부안교육지원청 행안초등학교,4,4,0,4,4,0,0,0
교육기관,교육부,전라북도순창교육지원청,교육부 전라북도교육청 전라북도순창교육지원청,8,8,0,8,0,8,0,0
교육기관,교육부,구림중학교,교육부 전라북도교육청 전라북도순창교육지원청 구림중학교,12,12,0,12,12,0,0,0
교육기관,교육부,금과초등학교,교육부 전라북도교육청 전라북도순창교육지원청 금과초등학교,7,7,0,7,7,0,0,0
교육기관,교육부,동계중학교,교육부 전라북도교육청 전라북도순창교육지원청 동계중학교,14,14,0,14,14,0,0,0
교육기관,교육부,동계초등학교,교육부 전라북도교육청 전라북도순창교육지원청 동계초등학교,15,15,0,15,0,15,0,0
교육기관,교육부,동산초등학교,교육부 전라북도교육청 전라북도순창교육지원청 동산초등학교,10,10,0,10,5,5,0,0
교육기관,교육부,복흥중학교,교육부 전라북도교육청 전라북도순창교육지원청 복흥중학교,6,6,0,6,3,3,0,0
교육기관,교육부,복흥초등학교,교육부 전라북도교육청 전라북도순창교육지원청 복흥초등학교,10,10,0,10,6,4,0,0
교육기관,교육부,순창북중학교,교육부 전라북도교육청 전라북도순창교육지원청 순창북중학교,10,10,0,10,6,3,0,1
교육기관,교육부,순창여자중학교,교육부 전라북도교육청 전라북도순창교육지원청 순창여자중학교,16,16,0,16,0,16,0,0
교육기관,교육부,순창옥천유치원,교육부 전라북도교육청 전라북도순창교육지원청 순창옥천유치원,13,13,0,13,13,0,0,0
교육기관,교육부,순창중앙초등학교,교육부 전라북도교육청 전라북도순창교육지원청 순창중앙초등학교,22,22,0,22,20,2,0,0
교육기관,교육부,순창중학교,교육부 전라북도교육청 전라북도순창교육지원청 순창중학교,16,16,0,16,0,16,0,0
교육기관,교육부,순창초등학교,교육부 전라북도교육청 전라북도순창교육지원청 순창초등학교,19,19,0,19,19,0,0,0
교육기관,교육부,시산초등학교,교육부 전라북도교육청 전라북도순창교육지원청 시산초등학교,11,11,0,11,11,0,0,0
교육기관,교육부,쌍치중학교,교육부 전라북도교육청 전라북도순창교육지원청 쌍치중학교,13,13,0,13,13,0,0,0
교육기관,교육부,쌍치초등학교,교육부 전라북도교육청 전라북도순창교육지원청 쌍치초등학교,12,12,0,12,6,6,0,0
교육기관,교육부,옥천초등학교,교육부 전라북도교육청 전라북도순창교육지원청 옥천초등학교,16,16,0,16,8,8,0,0
교육기관,교육부,유등초등학교,교육부 전라북도교육청 전라북도순창교육지원청 유등초등학교,8,8,0,8,7,1,0,0
교육기관,교육부,인계초등학교,교육부 전라북도교육청 전라북도순창교육지원청 인계초등학교,5,5,0,5,5,0,0,0
교육기관,교육부,적성초등학교,교육부 전라북도교육청 전라북도순창교육지원청 적성초등학교,8,8,0,8,0,8,0,0
교육기관,교육부,전라북도교육청순창도서관,교육부 전라북도교육청 전라북도순창교육지원청 전라북도교육청순창도서관,0,0,0,0,0,0,0,0
교육기관,교육부,팔덕초등학교,교육부 전라북도교육청 전라북도순창교육지원청 팔덕초등학교,11,11,0,11,0,11,0,0
교육기관,교육부,풍산초등학교,교육부 전라북도교육청 전라북도순창교육지원청 풍산초등학교,10,10,0,10,4,6,0,0
교육기관,교육부,전라북도완주교육지원청,교육부 전라북도교육청 전라북도완주교육지원청,39,39,0,39,0,39,0,0
교육기관,교육부,가천초등학교,교육부 전라북도교육청 전라북도완주교육지원청 가천초등학교,8,8,0,8,0,8,0,0
교육기관,교육부,간중초등학교,교육부 전라북도교육청 전라북도완주교육지원청 간중초등학교,6,6,0,6,0,6,0,0
교육기관,교육부,고산중학교,교육부 전라북도교육청 전라북도완주교육지원청 고산중학교,8,8,0,8,0,8,0,0
교육기관,교육부,고산초등학교,교육부 전라북도교육청 전라북도완주교육지원청 고산초등학교,14,14,0,14,8,4,2,0
교육기관,교육부,구이초등학교,교육부 전라북도교육청 전라북도완주교육지원청 구이초등학교,16,16,0,16,16,0,0,0
교육기관,교육부,남관초등학교,교육부 전라북도교육청 전라북도완주교육지원청 남관초등학교,16,16,0,16,8,8,0,0
교육기관,교육부,대덕초등학교,교육부 전라북도교육청 전라북도완주교육지원청 대덕초등학교,13,13,0,13,13,0,0,0
교육기관,교육부,동상초등학교,교육부 전라북도교육청 전라북도완주교육지원청 동상초등학교,12,12,0,12,6,6,0,0
교육기관,교육부,동양초등학교,교육부 전라북도교육청 전라북도완주교육지원청 동양초등학교,9,9,0,9,0,9,0,0
교육기관,교육부,봉동유치원,교육부 전라북도교육청 전라북도완주교육지원청 봉동유치원,7,7,0,7,0,7,0,0
교육기관,교육부,봉동초등학교,교육부 전라북도교육청 전라북도완주교육지원청 봉동초등학교,14,14,0,14,7,7,0,0
교육기관,교육부,봉동초등학교양화분교장,교육부 전라북도교육청 전라북도완주교육지원청 봉동초등학교양화분교장,10,10,0,10,10,0,0,0
교육기관,교육부,봉서유치원,교육부 전라북도교육청 전라북도완주교육지원청 봉서유치원,4,4,0,4,2,2,0,0
교육기관,교육부,봉서중학교,교육부 전라북도교육청 전라북도완주교육지원청 봉서중학교,21,21,0,21,4,17,0,0
교육기관,교육부,봉서초등학교,교육부 전라북도교육청 전라북도완주교육지원청 봉서초등학교,22,22,0,22,22,0,0,0
교육기관,교육부,봉성초등학교,교육부 전라북도교육청 전라북도완주교육지원청 봉성초등학교,11,11,0,11,7,4,0,0
교육기관,교육부,비봉초등학교,교육부 전라북도교육청 전라북도완주교육지원청 비봉초등학교,10,10,0,10,10,0,0,0
교육기관,교육부,삼례동초등학교,교육부 전라북도교육청 전라북도완주교육지원청 삼례동초등학교,15,15,0,15,15,0,0,0
교육기관,교육부,삼례중앙초등학교,교육부 전라북도교육청 전라북도완주교육지원청 삼례중앙초등학교,23,23,0,23,0,23,0,0
교육기관,교육부,삼례중학교,교육부 전라북도교육청 전라북도완주교육지원청 삼례중학교,37,15,22,15,6,6,2,1
교육기관,교육부,삼례초등학교,교육부 전라북도교육청 전라북도완주교육지원청 삼례초등학교,13,13,0,13,13,0,0,0
교육기관,교육부,삼우중학교,교육부 전라북도교육청 전라북도완주교육지원청 삼우중학교,12,12,0,12,8,4,0,0
교육기관,교육부,삼우초등학교,교육부 전라북도교육청 전라북도완주교육지원청 삼우초등학교,16,16,0,16,16,0,0,0
교육기관,교육부,상관중학교,교육부 전라북도교육청 전라북도완주교육지원청 상관중학교,6,6,0,6,6,0,0,0
교육기관,교육부,상관초등학교,교육부 전라북도교육청 전라북도완주교육지원청 상관초등학교,8,8,0,8,0,8,0,0
교육기관,교육부,소양서초등학교,교육부 전라북도교육청 전라북도완주교육지원청 소양서초등학교,8,8,0,8,6,2,0,0
교육기관,교육부,소양중학교,교육부 전라북도교육청 전라북도완주교육지원청 소양중학교,22,22,0,22,14,8,0,0
교육기관,교육부,소양초등학교,교육부 전라북도교육청 전라북도완주교육지원청 소양초등학교,13,13,0,13,0,13,0,0
교육기관,교육부,완주중학교,교육부 전라북도교육청 전라북도완주교육지원청 완주중학교,10,10,0,10,10,0,0,0
교육기관,교육부,용진중학교,교육부 전라북도교육청 전라북도완주교육지원청 용진중학교,16,16,0,16,10,5,1,0
교육기관,교육부,용진초등학교,교육부 전라북도교육청 전라북도완주교육지원청 용진초등학교,13,13,0,13,13,0,0,0
교육기관,교육부,운주중학교,교육부 전라북도교육청 전라북도완주교육지원청 운주중학교,8,8,0,8,4,4,0,0
교육기관,교육부,운주초등학교,교육부 전라북도교육청 전라북도완주교육지원청 운주초등학교,13,13,0,13,8,5,0,0
교육기관,교육부,이서초등학교,교육부 전라북도교육청 전라북도완주교육지원청 이서초등학교,32,32,0,32,16,16,0,0
교육기관,교육부,전주예술중학교,교육부 전라북도교육청 전라북도완주교육지원청 전주예술중학교,9,9,0,9,9,0,0,0
교육기관,교육부,청명초등학교,교육부 전라북도교육청 전라북도완주교육지원청 청명초등학교,12,12,0,12,12,0,0,0
교육기관,교육부,청완초등학교,교육부 전라북도교육청 전라북도완주교육지원청 청완초등학교,22,19,3,19,19,0,0,0
교육기관,교육부,태봉초등학교,교육부 전라북도교육청 전라북도완주교육지원청 태봉초등학교,12,12,0,12,12,0,0,0
교육기관,교육부,화산중학교,교육부 전라북도교육청 전라북도완주교육지원청 화산중학교,36,36,0,36,12,24,0,0
교육기관,교육부,화산초등학교,교육부 전라북도교육청 전라북도완주교육지원청 화산초등학교,12,12,0,12,0,12,0,0
교육기관,교육부,석교유아종합학습분원,교육부 전라북도교육청 전라북도유아교육진흥원 석교유아종합학습분원,35,35,0,35,0,35,0,0
교육기관,교육부,전라북도익산교육지원청,교육부 전라북도교육청 전라북도익산교육지원청,8,8,0,8,2,6,0,0
교육기관,교육부,금마초등학교,교육부 전라북도교육청 전라북도익산교육지원청 금마초등학교,19,19,0,19,19,0,0,0
교육기관,교육부,남성여자중학교,교육부 전라북도교육청 전라북도익산교육지원청 남성여자중학교,48,48,0,48,0,48,0,0
교육기관,교육부,남성중학교,교육부 전라북도교육청 전라북도익산교육지원청 남성중학교,43,16,27,16,0,16,0,0
교육기관,교육부,낭산초등학교,교육부 전라북도교육청 전라북도익산교육지원청 낭산초등학교,11,11,0,11,5,6,0,0
교육기관,교육부,다송초등학교,교육부 전라북도교육청 전라북도익산교육지원청 다송초등학교,6,6,0,6,2,4,0,0
교육기관,교육부,망성초등학교,교육부 전라북도교육청 전라북도익산교육지원청 망성초등학교,22,22,0,22,18,4,0,0
교육기관,교육부,미륵초등학교,교육부 전라북도교육청 전라북도익산교육지원청 미륵초등학교,8,8,0,8,4,4,0,0
교육기관,교육부,삼기중학교,교육부 전라북도교육청 전라북도익산교육지원청 삼기중학교,6,6,0,6,2,2,1,1
교육기관,교육부,삼기초등학교,교육부 전라북도교육청 전라북도익산교육지원청 삼기초등학교,16,16,0,16,16,0,0,0
교육기관,교육부,석불초등학교,교육부 전라북도교육청 전라북도익산교육지원청 석불초등학교,8,8,0,8,0,8,0,0
교육기관,교육부,성당중학교,교육부 전라북도교육청 전라북도익산교육지원청 성당중학교,8,8,0,8,0,8,0,0
교육기관,교육부,성당초등학교,교육부 전라북도교육청 전라북도익산교육지원청 성당초등학교,9,9,0,9,0,9,0,0
교육기관,교육부,성북초등학교,교육부 전라북도교육청 전라북도익산교육지원청 성북초등학교,8,8,0,8,4,4,0,0
교육기관,교육부,여산중학교,교육부 전라북도교육청 전라북도익산교육지원청 여산중학교,8,8,0,8,0,8,0,0
교육기관,교육부,여산초등학교,교육부 전라북도교육청 전라북도익산교육지원청 여산초등학교,14,14,0,14,6,8,0,0
교육기관,교육부,영등중학교,교육부 전라북도교육청 전라북도익산교육지원청 영등중학교,28,28,0,28,28,0,0,0
교육기관,교육부,영만초등학교,교육부 전라북도교육청 전라북도익산교육지원청 영만초등학교,12,12,0,12,12,0,0,0
교육기관,교육부,오산남초등학교,교육부 전라북도교육청 전라북도익산교육지원청 오산남초등학교,5,5,0,5,5,0,0,0
교육기관,교육부,오산초등학교,교육부 전라북도교육청 전라북도익산교육지원청 오산초등학교,18,18,0,18,0,18,0,0
교육기관,교육부,왕궁남초등학교,교육부 전라북도교육청 전라북도익산교육지원청 왕궁남초등학교,10,10,0,10,0,8,1,1
교육기관,교육부,왕궁중학교,교육부 전라북도교육청 전라북도익산교육지원청 왕궁중학교,6,6,0,6,6,0,0,0
교육기관,교육부,왕궁초등학교,교육부 전라북도교육청 전라북도익산교육지원청 왕궁초등학교,16,16,0,16,16,0,0,0
교육기관,교육부,왕북초등학교,교육부 전라북도교육청 전라북도익산교육지원청 왕북초등학교,4,4,0,4,4,0,0,0
교육기관,교육부,용남초등학교,교육부 전라북도교육청 전라북도익산교육지원청 용남초등학교,4,4,0,4,4,0,0,0
교육기관,교육부,용산초등학교,교육부 전라북도교육청 전라북도익산교육지원청 용산초등학교,12,12,0,12,12,0,0,0
교육기관,교육부,용성초등학교,교육부 전라북도교육청 전라북도익산교육지원청 용성초등학교,15,15,0,15,15,0,0,0
교육기관,교육부,용안초등학교,교육부 전라북도교육청 전라북도익산교육지원청 용안초등학교,6,6,0,6,6,0,0,0
교육기관,교육부,웅포중학교,교육부 전라북도교육청 전라북도익산교육지원청 웅포중학교,7,7,0,7,7,0,0,0
교육기관,교육부,웅포초등학교,교육부 전라북도교육청 전라북도익산교육지원청 웅포초등학교,13,13,0,13,0,13,0,0
교육기관,교육부,원광여자중학교,교육부 전라북도교육청 전라북도익산교육지원청 원광여자중학교,14,14,0,14,0,14,0,0
교육기관,교육부,원광중학교,교육부 전라북도교육청 전라북도익산교육지원청 원광중학교,32,32,0,32,0,32,0,0
교육기관,교육부,이리계문초등학교,교육부 전라북도교육청 전라북도익산교육지원청 이리계문초등학교,4,4,0,4,4,0,0,0
교육기관,교육부,이리고현초등학교,교육부 전라북도교육청 전라북도익산교육지원청 이리고현초등학교,16,16,0,16,0,16,0,0
교육기관,교육부,이리남중학교,교육부 전라북도교육청 전라북도익산교육지원청 이리남중학교,18,18,0,18,6,12,0,0
교육기관,교육부,이리남창초등학교,교육부 전라북도교육청 전라북도익산교육지원청 이리남창초등학교,8,8,0,8,8,0,0,0
교육기관,교육부,이리남초등학교,교육부 전라북도교육청 전라북도익산교육지원청 이리남초등학교,13,13,0,13,5,8,0,0
교육기관,교육부,이리동남초등학교,교육부 전라북도교육청 전라북도익산교육지원청 이리동남초등학교,12,12,0,12,6,6,0,0
교육기관,교육부,이리동북초등학교,교육부 전라북도교육청 전라북도익산교육지원청 이리동북초등학교,14,14,0,14,14,0,0,0
교육기관,교육부,이리동산초등학교,교육부 전라북도교육청 전라북도익산교육지원청 이리동산초등학교,22,22,0,22,22,0,0,0
교육기관,교육부,이리동중학교,교육부 전라북도교육청 전라북도익산교육지원청 이리동중학교,16,16,0,16,16,0,0,0
교육기관,교육부,이리동초등학교,교육부 전라북도교육청 전라북도익산교육지원청 이리동초등학교,22,22,0,22,0,22,0,0
교육기관,교육부,이리마한초등학교,교육부 전라북도교육청 전라북도익산교육지원청 이리마한초등학교,11,11,0,11,10,1,0,0
교육기관,교육부,이리모현초등학교,교육부 전라북도교육청 전라북도익산교육지원청 이리모현초등학교,14,14,0,14,4,10,0,0
교육기관,교육부,이리백제초등학교,교육부 전라북도교육청 전라북도익산교육지원청 이리백제초등학교,24,24,0,24,0,24,0,0
교육기관,교육부,이리부송초등학교,교육부 전라북도교육청 전라북도익산교육지원청 이리부송초등학교,13,13,0,13,0,13,0,0
교육기관,교육부,이리부천초등학교,교육부 전라북도교육청 전라북도익산교육지원청 이리부천초등학교,18,18,0,18,0,18,0,0
교육기관,교육부,이리북일초등학교,교육부 전라북도교육청 전라북도익산교육지원청 이리북일초등학교,14,14,0,14,14,0,0,0
교육기관,교육부,이리북중학교,교육부 전라북도교육청 전라북도익산교육지원청 이리북중학교,16,16,0,16,13,3,0,0
교육기관,교육부,이리북초등학교,교육부 전라북도교육청 전라북도익산교육지원청 이리북초등학교,16,16,0,16,8,8,0,0
교육기관,교육부,이리삼성초등학교,교육부 전라북도교육청 전라북도익산교육지원청 이리삼성초등학교,16,16,0,16,16,0,0,0
교육기관,교육부,이리서초등학교,교육부 전라북도교육청 전라북도익산교육지원청 이리서초등학교,13,13,0,13,0,13,0,0
교육기관,교육부,이리석암초등학교,교육부 전라북도교육청 전라북도익산교육지원청 이리석암초등학교,7,7,0,7,0,7,0,0
교육기관,교육부,이리송학초등학교,교육부 전라북도교육청 전라북도익산교육지원청 이리송학초등학교,12,12,0,12,0,12,0,0
교육기관,교육부,이리신동초등학교,교육부 전라북도교육청 전라북도익산교육지원청 이리신동초등학교,14,14,0,14,7,7,0,0
교육기관,교육부,이리신흥초등학교,교육부 전라북도교육청 전라북도익산교육지원청 이리신흥초등학교,11,11,0,11,0,11,0,0
교육기관,교육부,이리영등초등학교,교육부 전라북도교육청 전라북도익산교육지원청 이리영등초등학교,15,15,0,15,15,0,0,0
교육기관,교육부,이리유치원,교육부 전라북도교육청 전라북도익산교육지원청 이리유치원,12,12,0,12,0,12,0,0
교육기관,교육부,이리중앙초등학교,교육부 전라북도교육청 전라북도익산교육지원청 이리중앙초등학교,9,9,0,9,9,0,0,0
교육기관,교육부,이리중학교,교육부 전라북도교육청 전라북도익산교육지원청 이리중학교,45,42,3,42,42,0,0,0
교육기관,교육부,이리초등학교,교육부 전라북도교육청 전라북도익산교육지원청 이리초등학교,16,16,0,16,0,16,0,0
교육기관,교육부,이리팔봉초등학교,교육부 전라북도교육청 전라북도익산교육지원청 이리팔봉초등학교,8,8,0,8,0,8,0,0
교육기관,교육부,이일여자중학교,교육부 전라북도교육청 전라북도익산교육지원청 이일여자중학교,8,8,0,8,5,3,0,0
교육기관,교육부,익산가온초등학교,교육부 전라북도교육청 전라북도익산교육지원청 익산가온초등학교,15,15,0,15,13,2,0,0
교육기관,교육부,익산궁동초등학교,교육부 전라북도교육청 전라북도익산교육지원청 익산궁동초등학교,20,19,1,19,19,0,0,0
교육기관,교육부,익산맑은샘유치원,교육부 전라북도교육청 전라북도익산교육지원청 익산맑은샘유치원,16,16,0,16,8,8,0,0
교육기관,교육부,익산부송유치원,교육부 전라북도교육청 전라북도익산교육지원청 익산부송유치원,16,9,7,9,9,0,0,0
교육기관,교육부,익산부송중학교,교육부 전라북도교육청 전라북도익산교육지원청 익산부송중학교,45,45,0,45,29,16,0,0
교육기관,교육부,익산부천중학교,교육부 전라북도교육청 전라북도익산교육지원청 익산부천중학교,25,25,0,25,13,12,0,0
교육기관,교육부,익산솜리유치원,교육부 전라북도교육청 전라북도익산교육지원청 익산솜리유치원,16,16,0,16,9,5,1,1
교육기관,교육부,익산어양초등학교,교육부 전라북도교육청 전라북도익산교육지원청 익산어양초등학교,18,18,0,18,0,18,0,0
교육기관,교육부,익산옥야초등학교,교육부 전라북도교육청 전라북도익산교육지원청 익산옥야초등학교,8,8,0,8,0,8,0,0
교육기관,교육부,익산외국어교육센터,교육부 전라북도교육청 전라북도익산교육지원청 익산외국어교육센터,13,13,0,13,6,7,0,0
교육기관,교육부,익산중학교,교육부 전라북도교육청 전라북도익산교육지원청 익산중학교,18,18,0,18,0,18,0,0
교육기관,교육부,익산지원중학교,교육부 전라북도교육청 전라북도익산교육지원청 익산지원중학교,32,16,16,16,0,16,0,0
교육기관,교육부,익산초등학교,교육부 전라북도교육청 전라북도익산교육지원청 익산초등학교,14,14,0,14,7,7,0,0
교육기관,교육부,익산한벌초등학교,교육부 전라북도교육청 전라북도익산교육지원청 익산한벌초등학교,17,17,0,17,0,17,0,0
교육기관,교육부,진경여자중학교,교육부 전라북도교육청 전라북도익산교육지원청 진경여자중학교,12,12,0,12,4,8,0,0
교육기관,교육부,천서초등학교,교육부 전라북도교육청 전라북도익산교육지원청 천서초등학교,9,9,0,9,5,4,0,0
교육기관,교육부,춘포초등학교,교육부 전라북도교육청 전라북도익산교육지원청 춘포초등학교,13,13,0,13,0,13,0,0
교육기관,교육부,함라초등학교,교육부 전라북도교육청 전라북도익산교육지원청 함라초등학교,10,10,0,10,6,4,0,0
교육기관,교육부,함열여자중학교,교육부 전라북도교육청 전라북도익산교육지원청 함열여자중학교,16,16,0,16,16,0,0,0
교육기관,교육부,함열중학교,교육부 전라북도교육청 전라북도익산교육지원청 함열중학교,8,8,0,8,8,0,0,0
교육기관,교육부,함열초등학교,교육부 전라북도교육청 전라북도익산교육지원청 함열초등학교,13,13,0,13,13,0,0,0
교육기관,교육부,황등남초등학교,교육부 전라북도교육청 전라북도익산교육지원청 황등남초등학교,12,12,0,12,7,5,0,0
교육기관,교육부,황등중학교,교육부 전라북도교육청 전라북도익산교육지원청 황등중학교,18,18,0,18,18,0,0,0
교육기관,교육부,황등초등학교,교육부 전라북도교육청 전라북도익산교육지원청 황등초등학교,19,19,0,19,0,19,0,0
교육기관,교육부,흥왕초등학교,교육부 전라북도교육청 전라북도익산교육지원청 흥왕초등학교,16,16,0,16,16,0,0,0
교육기관,교육부,전라북도임실교육지원청,교육부 전라북도교육청 전라북도임실교육지원청,7,7,0,7,0,7,0,0
교육기관,교육부,갈담초등학교,교육부 전라북도교육청 전라북도임실교육지원청 갈담초등학교,9,9,0,9,0,9,0,0
교육기관,교육부,관촌중학교,교육부 전라북도교육청 전라북도임실교육지원청 관촌중학교,13,13,0,13,0,13,0,0
교육기관,교육부,관촌초등학교,교육부 전라북도교육청 전라북도임실교육지원청 관촌초등학교,16,16,0,16,16,0,0,0
교육기관,교육부,대리초등학교,교육부 전라북도교육청 전라북도임실교육지원청 대리초등학교,12,12,0,12,12,0,0,0
교육기관,교육부,덕치초등학교,교육부 전라북도교육청 전라북도임실교육지원청 덕치초등학교,4,4,0,4,2,2,0,0
교육기관,교육부,마암초등학교,교육부 전라북도교육청 전라북도임실교육지원청 마암초등학교,5,5,0,5,0,5,0,0
교육기관,교육부,삼계중학교,교육부 전라북도교육청 전라북도임실교육지원청 삼계중학교,8,8,0,8,8,0,0,0
교육기관,교육부,섬진중학교,교육부 전라북도교육청 전라북도임실교육지원청 섬진중학교,4,4,0,4,2,2,0,0
교육기관,교육부,성수중학교,교육부 전라북도교육청 전라북도임실교육지원청 성수중학교,12,12,0,12,12,0,0,0
교육기관,교육부,성수초등학교,교육부 전라북도교육청 전라북도임실교육지원청 성수초등학교,12,12,0,12,12,0,0,0
교육기관,교육부,신평초등학교,교육부 전라북도교육청 전라북도임실교육지원청 신평초등학교,9,9,0,9,9,0,0,0
교육기관,교육부,오수중학교,교육부 전라북도교육청 전라북도임실교육지원청 오수중학교,13,13,0,13,10,3,0,0
교육기관,교육부,오수초등학교,교육부 전라북도교육청 전라북도임실교육지원청 오수초등학교,14,14,0,14,14,0,0,0
교육기관,교육부,운암중학교,교육부 전라북도교육청 전라북도임실교육지원청 운암중학교,8,8,0,8,3,3,1,1
교육기관,교육부,운암초등학교,교육부 전라북도교육청 전라북도임실교육지원청 운암초등학교,8,8,0,8,3,3,1,1
교육기관,교육부,임실기림초등학교,교육부 전라북도교육청 전라북도임실교육지원청 임실기림초등학교,8,8,0,8,4,4,0,0
교육기관,교육부,임실동중학교,교육부 전라북도교육청 전라북도임실교육지원청 임실동중학교,12,12,0,12,12,0,0,0
교육기관,교육부,임실둥지유치원,교육부 전라북도교육청 전라북도임실교육지원청 임실둥지유치원,13,4,9,4,4,0,0,0
교육기관,교육부,임실영어체험학습센터,교육부 전라북도교육청 전라북도임실교육지원청 임실영어체험학습센터,12,12,0,12,12,0,0,0
교육기관,교육부,임실초등학교,교육부 전라북도교육청 전라북도임실교육지원청 임실초등학교,27,27,0,27,17,10,0,0
교육기관,교육부,전라북도교육청임실도서관,교육부 전라북도교육청 전라북도임실교육지원청 전라북도교육청임실도서관,8,8,0,8,4,4,0,0
교육기관,교육부,지사중학교,교육부 전라북도교육청 전라북도임실교육지원청 지사중학교,9,9,0,9,4,5,0,0
교육기관,교육부,지사초등학교,교육부 전라북도교육청 전라북도임실교육지원청 지사초등학교,8,8,0,8,4,4,0,0
교육기관,교육부,청웅중학교,교육부 전라북도교육청 전라북도임실교육지원청 청웅중학교,8,8,0,8,4,4,0,0
교육기관,교육부,청웅초등학교,교육부 전라북도교육청 전라북도임실교육지원청 청웅초등학교,8,8,0,8,8,0,0,0
교육기관,교육부,전라북도장수교육지원청,교육부 전라북도교육청 전라북도장수교육지원청,14,13,1,13,0,13,0,0
교육기관,교육부,계남중학교,교육부 전라북도교육청 전라북도장수교육지원청 계남중학교,8,8,0,8,8,0,0,0
교육기관,교육부,계남초등학교,교육부 전라북도교육청 전라북도장수교육지원청 계남초등학교,12,12,0,12,12,0,0,0
교육기관,교육부,계북중학교,교육부 전라북도교육청 전라북도장수교육지원청 계북중학교,6,6,0,6,0,6,0,0
교육기관,교육부,계북초등학교,교육부 전라북도교육청 전라북도장수교육지원청 계북초등학교,8,8,0,8,8,0,0,0
교육기관,교육부,번암중학교,교육부 전라북도교육청 전라북도장수교육지원청 번암중학교,9,9,0,9,0,9,0,0
교육기관,교육부,번암초등학교,교육부 전라북도교육청 전라북도장수교육지원청 번암초등학교,10,10,0,10,10,0,0,0
교육기관,교육부,번암초등학교동화분교장,교육부 전라북도교육청 전라북도장수교육지원청 번암초등학교동화분교장,4,4,0,4,4,0,0,0
교육기관,교육부,산서중학교,교육부 전라북도교육청 전라북도장수교육지원청 산서중학교,13,13,0,13,13,0,0,0
교육기관,교육부,산서초등학교,교육부 전라북도교육청 전라북도장수교육지원청 산서초등학교,12,12,0,12,5,7,0,0
교육기관,교육부,수남초등학교,교육부 전라북도교육청 전라북도장수교육지원청 수남초등학교,6,6,0,6,2,3,1,0
교육기관,교육부,장계중학교,교육부 전라북도교육청 전라북도장수교육지원청 장계중학교,10,9,1,9,2,7,0,0
교육기관,교육부,장수중학교,교육부 전라북도교육청 전라북도장수교육지원청 장수중학교,10,10,0,10,5,5,0,0
교육기관,교육부,장수초등학교,교육부 전라북도교육청 전라북도장수교육지원청 장수초등학교,8,8,0,8,0,8,0,0
교육기관,교육부,장수한사랑유치원,교육부 전라북도교육청 전라북도장수교육지원청 장수한사랑유치원,12,12,0,12,12,0,0,0
교육기관,교육부,전라북도교육청장수도서관,교육부 전라북도교육청 전라북도장수교육지원청 전라북도교육청장수도서관,16,16,0,16,16,0,0,0
교육기관,교육부,천천중학교,교육부 전라북도교육청 전라북도장수교육지원청 천천중학교,5,5,0,5,5,0,0,0
교육기관,교육부,천천초등학교,교육부 전라북도교육청 전라북도장수교육지원청 천천초등학교,17,17,0,17,17,0,0,0
교육기관,교육부,서전주중학교,교육부 전라북도교육청 전라북도전주교육지원청 서전주중학교,24,24,0,24,16,8,0,0
교육기관,교육부,용흥중학교,교육부 전라북도교육청 전라북도전주교육지원청 용흥중학교,37,37,0,37,37,0,0,0
교육기관,교육부,우전중학교,교육부 전라북도교육청 전라북도전주교육지원청 우전중학교,27,27,0,27,27,0,0,0
교육기관,교육부,전라중학교,교육부 전라북도교육청 전라북도전주교육지원청 전라중학교,15,15,0,15,3,9,0,3
교육기관,교육부,전북중학교,교육부 전라북도교육청 전라북도전주교육지원청 전북중학교,26,26,0,26,6,19,1,0
교육기관,교육부,전일중학교,교육부 전라북도교육청 전라북도전주교육지원청 전일중학교,8,8,0,8,8,0,0,0
교육기관,교육부,전주근영중학교,교육부 전라북도교육청 전라북도전주교육지원청 전주근영중학교,28,28,0,28,0,28,0,0
교육기관,교육부,전주금암초등학교,교육부 전라북도교육청 전라북도전주교육지원청 전주금암초등학교,20,20,0,20,0,20,0,0
교육기관,교육부,전주금평초등학교,교육부 전라북도교육청 전라북도전주교육지원청 전주금평초등학교,12,12,0,12,12,0,0,0
교육기관,교육부,전주기린중학교,교육부 전라북도교육청 전라북도전주교육지원청 전주기린중학교,16,16,0,16,16,0,0,0
교육기관,교육부,전주기린초등학교,교육부 전라북도교육청 전라북도전주교육지원청 전주기린초등학교,22,22,0,22,0,22,0,0
교육기관,교육부,전주기전중학교,교육부 전라북도교육청 전라북도전주교육지원청 전주기전중학교,46,46,0,46,16,30,0,0
교육기관,교육부,전주남중학교,교육부 전라북도교육청 전라북도전주교육지원청 전주남중학교,16,16,0,16,12,4,0,0
교육기관,교육부,전주남초등학교,교육부 전라북도교육청 전라북도전주교육지원청 전주남초등학교,23,23,0,23,23,0,0,0
교육기관,교육부,전주대성초등학교,교육부 전라북도교육청 전라북도전주교육지원청 전주대성초등학교,7,7,0,7,1,6,0,0
교육기관,교육부,전주대정초등학교,교육부 전라북도교육청 전라북도전주교육지원청 전주대정초등학교,21,21,0,21,19,2,0,0
교육기관,교육부,전주덕일중학교,교육부 전라북도교육청 전라북도전주교육지원청 전주덕일중학교,9,9,0,9,9,0,0,0
교육기관,교육부,전주덕일초등학교,교육부 전라북도교육청 전라북도전주교육지원청 전주덕일초등학교,17,17,0,17,0,17,0,0
교육기관,교육부,전주덕진중학교,교육부 전라북도교육청 전라북도전주교육지원청 전주덕진중학교,26,10,16,10,10,0,0,0
교육기관,교육부,전주덕진초등학교,교육부 전라북도교육청 전라북도전주교육지원청 전주덕진초등학교,16,16,0,16,2,14,0,0
교육기관,교육부,전주동북초등학교,교육부 전라북도교육청 전라북도전주교육지원청 전주동북초등학교,18,18,0,18,0,18,0,0
교육기관,교육부,전주동신초등학교,교육부 전라북도교육청 전라북도전주교육지원청 전주동신초등학교,21,17,4,17,0,17,0,0
교육기관,교육부,전주동중학교,교육부 전라북도교육청 전라북도전주교육지원청 전주동중학교,46,46,0,46,20,12,11,3
교육기관,교육부,전주동초등학교,교육부 전라북도교육청 전라북도전주교육지원청 전주동초등학교,6,6,0,6,0,6,0,0
교육기관,교육부,전주만성중학교,교육부 전라북도교육청 전라북도전주교육지원청 전주만성중학교,34,34,0,34,0,34,0,0
교육기관,교육부,전주만성초등학교,교육부 전라북도교육청 전라북도전주교육지원청 전주만성초등학교,32,32,0,32,32,0,0,0
교육기관,교육부,전주만수초등학교,교육부 전라북도교육청 전라북도전주교육지원청 전주만수초등학교,32,32,0,32,19,13,0,0
교육기관,교육부,전주문정초등학교,교육부 전라북도교육청 전라북도전주교육지원청 전주문정초등학교,11,11,0,11,5,6,0,0
교육기관,교육부,전주문학초등학교,교육부 전라북도교육청 전라북도전주교육지원청 전주문학초등학교,21,21,0,21,10,11,0,0
교육기관,교육부,전주미산초등학교,교육부 전라북도교육청 전라북도전주교육지원청 전주미산초등학교,8,8,0,8,0,8,0,0
교육기관,교육부,전주반월초등학교,교육부 전라북도교육청 전라북도전주교육지원청 전주반월초등학교,16,16,0,16,16,0,0,0
교육기관,교육부,전주부설초등학교,교육부 전라북도교육청 전라북도전주교육지원청 전주부설초등학교,25,25,0,25,25,0,0,0
교육기관,교육부,전주북일초등학교,교육부 전라북도교육청 전라북도전주교육지원청 전주북일초등학교,11,11,0,11,0,11,0,0
교육기관,교육부,전주북초등학교,교육부 전라북도교육청 전라북도전주교육지원청 전주북초등학교,32,32,0,32,32,0,0,0
교육기관,교육부,전주삼천남초등학교,교육부 전라북도교육청 전라북도전주교육지원청 전주삼천남초등학교,23,23,0,23,23,0,0,0
교육기관,교육부,전주삼천초등학교,교육부 전라북도교육청 전라북도전주교육지원청 전주삼천초등학교,21,21,0,21,0,21,0,0
교육기관,교육부,전주새뜰유치원,교육부 전라북도교육청 전라북도전주교육지원청 전주새뜰유치원,12,12,0,12,4,8,0,0
교육기관,교육부,전주새솔유치원,교육부 전라북도교육청 전라북도전주교육지원청 전주새솔유치원,7,7,0,7,6,1,0,0
교육기관,교육부,전주서곡중학교,교육부 전라북도교육청 전라북도전주교육지원청 전주서곡중학교,53,53,0,53,53,0,0,0
교육기관,교육부,전주서곡초등학교,교육부 전라북도교육청 전라북도전주교육지원청 전주서곡초등학교,32,32,0,32,32,0,0,0
교육기관,교육부,전주서문초등학교,교육부 전라북도교육청 전라북도전주교육지원청 전주서문초등학교,17,17,0,17,17,0,0,0
교육기관,교육부,전주서신중학교,교육부 전라북도교육청 전라북도전주교육지원청 전주서신중학교,44,44,0,44,0,44,0,0
교육기관,교육부,전주서신초등학교,교육부 전라북도교육청 전라북도전주교육지원청 전주서신초등학교,14,14,0,14,5,9,0,0
교육기관,교육부,전주서원초등학교,교육부 전라북도교육청 전라북도전주교육지원청 전주서원초등학교,19,19,0,19,19,0,0,0
교육기관,교육부,전주서일초등학교,교육부 전라북도교육청 전라북도전주교육지원청 전주서일초등학교,26,26,0,26,22,4,0,0
교육기관,교육부,전주서중학교,교육부 전라북도교육청 전라북도전주교육지원청 전주서중학교,65,65,0,65,65,0,0,0
교육기관,교육부,전주서천초등학교,교육부 전라북도교육청 전라북도전주교육지원청 전주서천초등학교,14,14,0,14,14,0,0,0
교육기관,교육부,전주성심여자중학교,교육부 전라북도교육청 전라북도전주교육지원청 전주성심여자중학교,11,8,3,8,8,0,0,0
교육기관,교육부,전주성현유치원,교육부 전라북도교육청 전라북도전주교육지원청 전주성현유치원,13,9,4,9,0,9,0,0
교육기관,교육부,전주솔빛중학교,교육부 전라북도교육청 전라북도전주교육지원청 전주솔빛중학교,14,14,0,14,0,14,0,0
교육기관,교육부,전주송북초등학교,교육부 전라북도교육청 전라북도전주교육지원청 전주송북초등학교,8,8,0,8,4,4,0,0
교육기관,교육부,전주송원초등학교,교육부 전라북도교육청 전라북도전주교육지원청 전주송원초등학교,14,14,0,14,14,0,0,0
교육기관,교육부,전주송천초등학교,교육부 전라북도교육청 전라북도전주교육지원청 전주송천초등학교,43,43,0,43,0,43,0,0
교육기관,교육부,전주신동초등학교,교육부 전라북도교육청 전라북도전주교육지원청 전주신동초등학교,8,8,0,8,0,8,0,0
교육기관,교육부,전주신성초등학교,교육부 전라북도교육청 전라북도전주교육지원청 전주신성초등학교,13,13,0,13,13,0,0,0
교육기관,교육부,전주신일중학교,교육부 전라북도교육청 전라북도전주교육지원청 전주신일중학교,32,32,0,32,8,24,0,0
교육기관,교육부,전주신흥중학교,교육부 전라북도교육청 전라북도전주교육지원청 전주신흥중학교,25,25,0,25,14,9,1,1
교육기관,교육부,전주아름유치원,교육부 전라북도교육청 전라북도전주교육지원청 전주아름유치원,16,4,12,4,4,0,0,0
교육기관,교육부,전주아중중학교,교육부 전라북도교육청 전라북도전주교육지원청 전주아중중학교,29,28,1,28,5,23,0,0
교육기관,교육부,전주아중초등학교,교육부 전라북도교육청 전라북도전주교육지원청 전주아중초등학교,21,21,0,21,21,0,0,0
교육기관,교육부,전주양지중학교,교육부 전라북도교육청 전라북도전주교육지원청 전주양지중학교,11,3,8,3,3,0,0,0
교육기관,교육부,전주양지초등학교,교육부 전라북도교육청 전라북도전주교육지원청 전주양지초등학교,8,8,0,8,0,8,0,0
교육기관,교육부,전주양현중학교,교육부 전라북도교육청 전라북도전주교육지원청 전주양현중학교,27,27,0,27,0,27,0,0
교육기관,교육부,전주양현초등학교,교육부 전라북도교육청 전라북도전주교육지원청 전주양현초등학교,38,36,2,36,36,0,0,0
교육기관,교육부,전주여울초등학교,교육부 전라북도교육청 전라북도전주교육지원청 전주여울초등학교,28,28,0,28,14,14,0,0
교육기관,교육부,전주영어체험학습센터,교육부 전라북도교육청 전라북도전주교육지원청 전주영어체험학습센터,19,19,0,19,6,13,0,0
교육기관,교육부,전주오송중학교,교육부 전라북도교육청 전라북도전주교육지원청 전주오송중학교,40,40,0,40,0,40,0,0
교육기관,교육부,전주오송초등학교,교육부 전라북도교육청 전라북도전주교육지원청 전주오송초등학교,15,15,0,15,0,15,0,0
교육기관,교육부,전주온빛중학교,교육부 전라북도교육청 전라북도전주교육지원청 전주온빛중학교,30,30,0,30,0,30,0,0
교육기관,교육부,전주온빛초등학교,교육부 전라북도교육청 전라북도전주교육지원청 전주온빛초등학교,29,29,0,29,0,29,0,0
교육기관,교육부,전주온샘유치원,교육부 전라북도교육청 전라북도전주교육지원청 전주온샘유치원,10,10,0,10,4,6,0,0
교육기관,교육부,전주완산서초등학교,교육부 전라북도교육청 전라북도전주교육지원청 전주완산서초등학교,9,9,0,9,8,1,0,0
교육기관,교육부,전주완산중학교,교육부 전라북도교육청 전라북도전주교육지원청 전주완산중학교,16,16,0,16,14,2,0,0
교육기관,교육부,전주완산초등학교,교육부 전라북도교육청 전라북도전주교육지원청 전주완산초등학교,18,18,0,18,18,0,0,0
교육기관,교육부,전주용덕초등학교,교육부 전라북도교육청 전라북도전주교육지원청 전주용덕초등학교,10,10,0,10,0,10,0,0
교육기관,교육부,전주용소중학교,교육부 전라북도교육청 전라북도전주교육지원청 전주용소중학교,36,36,0,36,36,0,0,0
교육기관,교육부,전주용소초등학교,교육부 전라북도교육청 전라북도전주교육지원청 전주용소초등학교,15,15,0,15,0,15,0,0
교육기관,교육부,전주용와초등학교,교육부 전라북도교육청 전라북도전주교육지원청 전주용와초등학교,31,31,0,31,0,31,0,0
교육기관,교육부,전주용흥초등학교,교육부 전라북도교육청 전라북도전주교육지원청 전주용흥초등학교,29,29,0,29,0,29,0,0
교육기관,교육부,전주우림중학교,교육부 전라북도교육청 전라북도전주교육지원청 전주우림중학교,42,42,0,42,6,36,0,0
교육기관,교육부,전주우림초등학교,교육부 전라북도교육청 전라북도전주교육지원청 전주우림초등학교,26,26,0,26,14,12,0,0
교육기관,교육부,전주우아중학교,교육부 전라북도교육청 전라북도전주교육지원청 전주우아중학교,42,42,0,42,27,14,1,0
교육기관,교육부,전주우전초등학교,교육부 전라북도교육청 전라북도전주교육지원청 전주우전초등학교,24,24,0,24,13,11,0,0
교육기관,교육부,전주원동초등학교,교육부 전라북도교육청 전라북도전주교육지원청 전주원동초등학교,11,11,0,11,11,0,0,0
교육기관,교육부,전주유치원,교육부 전라북도교육청 전라북도전주교육지원청 전주유치원,16,8,8,8,8,0,0,0
교육기관,교육부,전주인봉초등학교,교육부 전라북도교육청 전라북도전주교육지원청 전주인봉초등학교,27,27,0,27,27,0,0,0
교육기관,교육부,전주인후초등학교,교육부 전라북도교육청 전라북도전주교육지원청 전주인후초등학교,8,8,0,8,4,4,0,0
교육기관,교육부,전주자연초등학교,교육부 전라북도교육청 전라북도전주교육지원청 전주자연초등학교,37,37,0,37,35,2,0,0
교육기관,교육부,전주장동초등학교,교육부 전라북도교육청 전라북도전주교육지원청 전주장동초등학교,16,16,0,16,13,3,0,0
교육기관,교육부,전주전라초등학교,교육부 전라북도교육청 전라북도전주교육지원청 전주전라초등학교,16,16,0,16,4,12,0,0
교육기관,교육부,전주전일초등학교,교육부 전라북도교육청 전라북도전주교육지원청 전주전일초등학교,29,16,13,16,7,6,3,0
교육기관,교육부,전주조촌초등학교,교육부 전라북도교육청 전라북도전주교육지원청 전주조촌초등학교,25,25,0,25,0,25,0,0
교육기관,교육부,전주중산초등학교,교육부 전라북도교육청 전라북도전주교육지원청 전주중산초등학교,27,27,0,27,24,0,3,0
교육기관,교육부,전주중앙중학교,교육부 전라북도교육청 전라북도전주교육지원청 전주중앙중학교,44,44,0,44,44,0,0,0
교육기관,교육부,전주중앙초등학교,교육부 전라북도교육청 전라북도전주교육지원청 전주중앙초등학교,8,8,0,8,0,8,0,0
교육기관,교육부,전주중인초등학교,교육부 전라북도교육청 전라북도전주교육지원청 전주중인초등학교,15,15,0,15,0,15,0,0
교육기관,교육부,전주중학교,교육부 전라북도교육청 전라북도전주교육지원청 전주중학교,49,49,0,49,23,26,0,0
교육기관,교육부,전주지곡초등학교,교육부 전라북도교육청 전라북도전주교육지원청 전주지곡초등학교,22,22,0,22,6,16,0,0
교육기관,교육부,전주진북초등학교,교육부 전라북도교육청 전라북도전주교육지원청 전주진북초등학교,18,18,0,18,0,18,0,0
교육기관,교육부,전주초등학교,교육부 전라북도교육청 전라북도전주교육지원청 전주초등학교,23,23,0,23,23,0,0,0
교육기관,교육부,전주초포초등학교,교육부 전라북도교육청 전라북도전주교육지원청 전주초포초등학교,12,12,0,12,6,6,0,0
교육기관,교육부,전주팔복초등학교,교육부 전라북도교육청 전라북도전주교육지원청 전주팔복초등학교,4,4,0,4,0,4,0,0
교육기관,교육부,전주평화중학교,교육부 전라북도교육청 전라북도전주교육지원청 전주평화중학교,18,18,0,18,7,11,0,0
교육기관,교육부,전주평화초등학교,교육부 전라북도교육청 전라북도전주교육지원청 전주평화초등학교,16,16,0,16,16,0,0,0
교육기관,교육부,전주푸른샘유치원,교육부 전라북도교육청 전라북도전주교육지원청 전주푸른샘유치원,12,12,0,12,6,6,0,0
교육기관,교육부,전주풍남유치원,교육부 전라북도교육청 전라북도전주교육지원청 전주풍남유치원,8,8,0,8,5,3,0,0
교육기관,교육부,전주풍남중학교,교육부 전라북도교육청 전라북도전주교육지원청 전주풍남중학교,33,13,20,13,3,10,0,0
교육기관,교육부,전주풍남초등학교,교육부 전라북도교육청 전라북도전주교육지원청 전주풍남초등학교,12,12,0,12,6,6,0,0
교육기관,교육부,전주하가초등학교,교육부 전라북도교육청 전라북도전주교육지원청 전주하가초등학교,16,16,0,16,2,14,0,0
교육기관,교육부,전주한들초등학교,교육부 전라북도교육청 전라북도전주교육지원청 전주한들초등학교,26,26,0,26,19,7,0,0
교육기관,교육부,전주해성중학교,교육부 전라북도교육청 전라북도전주교육지원청 전주해성중학교,15,15,0,15,15,0,0,0
교육기관,교육부,전주호성중학교,교육부 전라북도교육청 전라북도전주교육지원청 전주호성중학교,12,10,2,10,6,4,0,0
교육기관,교육부,전주홍산유치원,교육부 전라북도교육청 전라북도전주교육지원청 전주홍산유치원,8,8,0,8,8,0,0,0
교육기관,교육부,전주홍산초등학교,교육부 전라북도교육청 전라북도전주교육지원청 전주홍산초등학교,25,25,0,25,18,7,0,0
교육기관,교육부,전주화산초등학교,교육부 전라북도교육청 전라북도전주교육지원청 전주화산초등학교,16,16,0,16,16,0,0,0
교육기관,교육부,전주화정중학교,교육부 전라북도교육청 전라북도전주교육지원청 전주화정중학교,26,21,5,21,20,1,0,0
교육기관,교육부,전주화정초등학교,교육부 전라북도교육청 전라북도전주교육지원청 전주화정초등학교,37,37,0,37,0,37,0,0
교육기관,교육부,전주효림초등학교,교육부 전라북도교육청 전라북도전주교육지원청 전주효림초등학교,16,16,0,16,5,11,0,0
교육기관,교육부,전주효문중학교,교육부 전라북도교육청 전라북도전주교육지원청 전주효문중학교,20,20,0,20,0,20,0,0
교육기관,교육부,전주효문초등학교,교육부 전라북도교육청 전라북도전주교육지원청 전주효문초등학교,30,30,0,30,0,30,0,0
교육기관,교육부,전주효자초등학교,교육부 전라북도교육청 전라북도전주교육지원청 전주효자초등학교,19,19,0,19,0,19,0,0
교육기관,교육부,전주효정중학교,교육부 전라북도교육청 전라북도전주교육지원청 전주효정중학교,16,16,0,16,5,11,0,0
교육기관,교육부,전주효천초등학교,교육부 전라북도교육청 전라북도전주교육지원청 전주효천초등학교,28,26,2,26,26,0,0,0
교육기관,교육부,전라북도정읍교육지원청,교육부 전라북도교육청 전라북도정읍교육지원청,26,26,0,26,13,13,0,0
교육기관,교육부,감곡초등학교,교육부 전라북도교육청 전라북도정읍교육지원청 감곡초등학교,10,10,0,10,4,6,0,0
교육기관,교육부,고부중학교,교육부 전라북도교육청 전라북도정읍교육지원청 고부중학교,12,12,0,12,6,6,0,0
교육기관,교육부,고부초등학교,교육부 전라북도교육청 전라북도정읍교육지원청 고부초등학교,10,10,0,10,10,0,0,0
교육기관,교육부,교암초등학교,교육부 전라북도교육청 전라북도정읍교육지원청 교암초등학교,12,12,0,12,0,12,0,0
교육기관,교육부,내장초등학교,교육부 전라북도교육청 전라북도정읍교육지원청 내장초등학교,9,9,0,9,1,8,0,0
교육기관,교육부,능교초등학교,교육부 전라북도교육청 전라북도정읍교육지원청 능교초등학교,5,5,0,5,2,3,0,0
교육기관,교육부,대흥초등학교,교육부 전라북도교육청 전라북도정읍교육지원청 대흥초등학교,8,8,0,8,8,0,0,0
교육기관,교육부,덕천초등학교,교육부 전라북도교육청 전라북도정읍교육지원청 덕천초등학교,8,8,0,8,8,0,0,0
교육기관,교육부,도학초등학교,교육부 전라북도교육청 전라북도정읍교육지원청 도학초등학교,4,4,0,4,0,4,0,0
교육기관,교육부,동신초등학교,교육부 전라북도교육청 전라북도정읍교육지원청 동신초등학교,36,36,0,36,0,36,0,0
교육기관,교육부,배영중학교,교육부 전라북도교육청 전라북도정읍교육지원청 배영중학교,3,2,1,2,1,1,0,0
교육기관,교육부,백암초등학교,교육부 전라북도교육청 전라북도정읍교육지원청 백암초등학교,11,11,0,11,5,6,0,0
교육기관,교육부,보성초등학교,교육부 전라북도교육청 전라북도정읍교육지원청 보성초등학교,16,16,0,16,0,16,0,0
교육기관,교육부,북면초등학교,교육부 전라북도교육청 전라북도정읍교육지원청 북면초등학교,14,14,0,14,4,10,0,0
교육기관,교육부,산외중학교,교육부 전라북도교육청 전라북도정읍교육지원청 산외중학교,9,9,0,9,1,8,0,0
교육기관,교육부,산외초등학교,교육부 전라북도교육청 전라북도정읍교육지원청 산외초등학교,6,6,0,6,2,4,0,0
교육기관,교육부,샘고을중학교,교육부 전라북도교육청 전라북도정읍교육지원청 샘고을중학교,24,22,2,22,10,12,0,0
교육기관,교육부,서신초등학교,교육부 전라북도교육청 전라북도정읍교육지원청 서신초등학교,9,9,0,9,4,5,0,0
교육기관,교육부,소성초등학교,교육부 전라북도교육청 전라북도정읍교육지원청 소성초등학교,8,8,0,8,4,4,0,0
교육기관,교육부,수곡초등학교,교육부 전라북도교육청 전라북도정읍교육지원청 수곡초등학교,12,12,0,12,0,12,0,0
교육기관,교육부,신태인초등학교,교육부 전라북도교육청 전라북도정읍교육지원청 신태인초등학교,12,12,0,12,12,0,0,0
교육기관,교육부,영산초등학교,교육부 전라북도교육청 전라북도정읍교육지원청 영산초등학교,12,12,0,12,6,6,0,0
교육기관,교육부,영원초등학교,교육부 전라북도교육청 전라북도정읍교육지원청 영원초등학교,8,8,0,8,2,2,2,2
교육기관,교육부,옹동초등학교,교육부 전라북도교육청 전라북도정읍교육지원청 옹동초등학교,6,6,0,6,3,3,0,0
교육기관,교육부,이평중학교,교육부 전라북도교육청 전라북도정읍교육지원청 이평중학교,12,12,0,12,1,11,0,0
교육기관,교육부,이평초등학교,교육부 전라북도교육청 전라북도정읍교육지원청 이평초등학교,16,16,0,16,14,2,0,0
교육기관,교육부,입암중학교,교육부 전라북도교육청 전라북도정읍교육지원청 입암중학교,8,8,0,8,0,8,0,0
교육기관,교육부,입암초등학교,교육부 전라북도교육청 전라북도정읍교육지원청 입암초등학교,11,11,0,11,0,11,0,0
교육기관,교육부,전북동화중학교,교육부 전라북도교육청 전라북도정읍교육지원청 전북동화중학교,12,12,0,12,0,12,0,0
교육기관,교육부,정남초등학교,교육부 전라북도교육청 전라북도정읍교육지원청 정남초등학교,14,14,0,14,14,0,0,0
교육기관,교육부,정산중학교,교육부 전라북도교육청 전라북도정읍교육지원청 정산중학교,5,5,0,5,3,2,0,0
교육기관,교육부,정우초등학교,교육부 전라북도교육청 전라북도정읍교육지원청 정우초등학교,19,19,0,19,0,19,0,0
교육기관,교육부,정읍남초등학교,교육부 전라북도교육청 전라북도정읍교육지원청 정읍남초등학교,21,21,0,21,0,21,0,0
교육기관,교육부,정읍동초등학교,교육부 전라북도교육청 전라북도정읍교육지원청 정읍동초등학교,14,14,0,14,0,14,0,0
교육기관,교육부,정읍북초등학교,교육부 전라북도교육청 전라북도정읍교육지원청 정읍북초등학교,20,20,0,20,10,10,0,0
교육기관,교육부,정읍서초등학교,교육부 전라북도교육청 전라북도정읍교육지원청 정읍서초등학교,16,16,0,16,0,16,0,0
교육기관,교육부,정읍수성초등학교,교육부 전라북도교육청 전라북도정읍교육지원청 정읍수성초등학교,17,17,0,17,14,3,0,0
교육기관,교육부,정읍연지유치원,교육부 전라북도교육청 전라북도정읍교육지원청 정읍연지유치원,10,10,0,10,6,3,1,0
교육기관,교육부,정읍중학교,교육부 전라북도교육청 전라북도정읍교육지원청 정읍중학교,25,25,0,25,25,0,0,0
교육기관,교육부,정읍초등학교,교육부 전라북도교육청 전라북도정읍교육지원청 정읍초등학교,13,13,0,13,0,13,0,0
교육기관,교육부,정읍학생복지회관,교육부 전라북도교육청 전라북도정읍교육지원청 정읍학생복지회관,14,14,0,14,14,0,0,0
교육기관,교육부,정일중학교,교육부 전라북도교육청 전라북도정읍교육지원청 정일중학교,21,21,0,21,0,21,0,0
교육기관,교육부,정일초등학교,교육부 전라북도교육청 전라북도정읍교육지원청 정일초등학교,8,8,0,8,8,0,0,0
교육기관,교육부,칠보중학교,교육부 전라북도교육청 전라북도정읍교육지원청 칠보중학교,9,8,1,8,8,0,0,0
교육기관,교육부,칠보초등학교,교육부 전라북도교육청 전라북도정읍교육지원청 칠보초등학교,18,18,0,18,12,6,0,0
교육기관,교육부,태인초등학교,교육부 전라북도교육청 전라북도정읍교육지원청 태인초등학교,8,8,0,8,0,8,0,0
교육기관,교육부,학산중학교,교육부 전라북도교육청 전라북도정읍교육지원청 학산중학교,4,4,0,4,4,0,0,0
교육기관,교육부,한솔초등학교,교육부 전라북도교육청 전라북도정읍교육지원청 한솔초등학교,26,26,0,26,8,18,0,0
교육기관,교육부,호남중학교,교육부 전라북도교육청 전라북도정읍교육지원청 호남중학교,8,8,0,8,0,8,0,0
교육기관,교육부,전라북도진안교육지원청,교육부 전라북도교육청 전라북도진안교육지원청,8,8,0,8,4,4,0,0
교육기관,교육부,동향중학교,교육부 전라북도교육청 전라북도진안교육지원청 동향중학교,7,7,0,7,7,0,0,0
교육기관,교육부,동향초등학교,교육부 전라북도교육청 전라북도진안교육지원청 동향초등학교,15,15,0,15,0,15,0,0
교육기관,교육부,마령중학교,교육부 전라북도교육청 전라북도진안교육지원청 마령중학교,6,6,0,6,1,3,1,1
교육기관,교육부,마령초등학교,교육부 전라북도교육청 전라북도진안교육지원청 마령초등학교,9,9,0,9,0,9,0,0
교육기관,교육부,백운중학교,교육부 전라북도교육청 전라북도진안교육지원청 백운중학교,8,8,0,8,8,0,0,0
교육기관,교육부,백운초등학교,교육부 전라북도교육청 전라북도진안교육지원청 백운초등학교,12,12,0,12,0,12,0,0
교육기관,교육부,부귀중학교,교육부 전라북도교육청 전라북도진안교육지원청 부귀중학교,11,11,0,11,11,0,0,0
교육기관,교육부,부귀초등학교,교육부 전라북도교육청 전라북도진안교육지원청 부귀초등학교,4,4,0,4,4,0,0,0
교육기관,교육부,송풍초등학교,교육부 전라북도교육청 전라북도진안교육지원청 송풍초등학교,15,15,0,15,15,0,0,0
교육기관,교육부,안천중학교,교육부 전라북도교육청 전라북도진안교육지원청 안천중학교,12,12,0,12,12,0,0,0
교육기관,교육부,안천초등학교,교육부 전라북도교육청 전라북도진안교육지원청 안천초등학교,12,12,0,12,12,0,0,0
교육기관,교육부,오천초등학교,교육부 전라북도교육청 전라북도진안교육지원청 오천초등학교,8,8,0,8,0,8,0,0
교육기관,교육부,외궁초등학교,교육부 전라북도교육청 전라북도진안교육지원청 외궁초등학교,8,8,0,8,5,3,0,0
교육기관,교육부,용담중학교,교육부 전라북도교육청 전라북도진안교육지원청 용담중학교,15,15,0,15,15,0,0,0
교육기관,교육부,장승초등학교,교육부 전라북도교육청 전라북도진안교육지원청 장승초등학교,13,13,0,13,0,13,0,0
교육기관,교육부,전라북도교육청진안도서관,교육부 전라북도교육청 전라북도진안교육지원청 전라북도교육청진안도서관,9,9,0,9,2,7,0,0
교육기관,교육부,조림초등학교,교육부 전라북도교육청 전라북도진안교육지원청 조림초등학교,9,9,0,9,5,4,0,0
교육기관,교육부,주천중학교,교육부 전라북도교육청 전라북도진안교육지원청 주천중학교,8,8,0,8,8,0,0,0
교육기관,교육부,주천초등학교,교육부 전라북도교육청 전라북도진안교육지원청 주천초등학교,8,8,0,8,4,4,0,0
교육기관,교육부,진성중학교,교육부 전라북도교육청 전라북도진안교육지원청 진성중학교,6,6,0,6,3,3,0,0
교육기관,교육부,진안마이꿈유치원,교육부 전라북도교육청 전라북도진안교육지원청 진안마이꿈유치원,7,7,0,7,0,7,0,0
교육기관,교육부,진안여자중학교,교육부 전라북도교육청 전라북도진안교육지원청 진안여자중학교,5,5,0,5,0,5,0,0
교육기관,교육부,진안중앙초등학교,교육부 전라북도교육청 전라북도진안교육지원청 진안중앙초등학교,19,19,0,19,19,0,0,0
교육기관,교육부,진안중학교,교육부 전라북도교육청 전라북도진안교육지원청 진안중학교,6,6,0,6,6,0,0,0
교육기관,교육부,진안초등학교,교육부 전라북도교육청 전라북도진안교육지원청 진안초등학교,9,9,0,9,7,2,0,0
교육기관,교육부,전북과학고등학교,교육부 전라북도교육청 전북과학고등학교,10,10,0,10,0,10,0,0
교육기관,교육부,전북맹아학교,교육부 전라북도교육청 전북맹아학교,13,13,0,13,0,13,0,0
교육기관,교육부,전북여자고등학교,교육부 전라북도교육청 전북여자고등학교,58,26,32,26,0,26,0,0
교육기관,교육부,전북외국어고등학교,교육부 전라북도교육청 전북외국어고등학교,36,36,0,36,0,36,0,0
교육기관,교육부,전북유니텍고등학교,교육부 전라북도교육청 전북유니텍고등학교,30,30,0,30,30,0,0,0
교육기관,교육부,전북제일고등학교,교육부 전라북도교육청 전북제일고등학교,72,72,0,72,1,71,0,0
교육기관,교육부,전북체육고등학교,교육부 전라북도교육청 전북체육고등학교,44,44,0,44,0,44,0,0
교육기관,교육부,전북푸른학교,교육부 전라북도교육청 전북푸른학교,16,16,0,16,16,0,0,0
교육기관,교육부,전북하이텍고등학교,교육부 전라북도교육청 전북하이텍고등학교,7,7,0,7,7,0,0,0
교육기관,교육부,전북혜화학교,교육부 전라북도교육청 전북혜화학교,34,34,0,34,18,16,0,0
교육기관,교육부,전일고등학교,교육부 전라북도교육청 전일고등학교,74,73,1,73,41,32,0,0
교육기관,교육부,전주고등학교,교육부 전라북도교육청 전주고등학교,63,63,0,63,0,63,0,0
교육기관,교육부,전주공업고등학교,교육부 전라북도교육청 전주공업고등학교,99,99,0,99,0,99,0,0
교육기관,교육부,전주교육문화회관,교육부 전라북도교육청 전주교육문화회관,65,65,0,65,0,65,0,0
교육기관,교육부,전주근영여자고등학교,교육부 전라북도교육청 전주근영여자고등학교,42,42,0,42,0,42,0,0
교육기관,교육부,전주기전여자고등학교,교육부 전라북도교육청 전주기전여자고등학교,35,34,1,34,34,0,0,0
교육기관,교육부,전주대학교사범대학부설고등학교,교육부 전라북도교육청 전주대학교사범대학부설고등학교,48,48,0,48,0,48,0,0
교육기관,교육부,전주상업정보고등학교,교육부 전라북도교육청 전주상업정보고등학교,41,41,0,41,0,41,0,0
교육기관,교육부,전주선화학교,교육부 전라북도교육청 전주선화학교,18,18,0,18,0,18,0,0
교육기관,교육부,전주성심여자고등학교,교육부 전라북도교육청 전주성심여자고등학교,29,29,0,29,0,29,0,0
교육기관,교육부,전주솔내고등학교,교육부 전라북도교육청 전주솔내고등학교,24,24,0,24,15,9,0,0
교육기관,교육부,전주신흥고등학교,교육부 전라북도교육청 전주신흥고등학교,51,49,2,49,0,49,0,0
교육기관,교육부,전주여자고등학교,교육부 전라북도교육청 전주여자고등학교,41,41,0,41,41,0,0,0
교육기관,교육부,전주영생고등학교,교육부 전라북도교육청 전주영생고등학교,63,63,0,63,0,63,0,0
교육기관,교육부,전주예술고등학교,교육부 전라북도교육청 전주예술고등학교,23,23,0,23,0,23,0,0
교육기관,교육부,전주유화학교,교육부 전라북도교육청 전주유화학교,14,14,0,14,5,9,0,0
교육기관,교육부,전주은화학교,교육부 전라북도교육청 전주은화학교,26,26,0,26,3,23,0,0
교육기관,교육부,전주제일고등학교,교육부 전라북도교육청 전주제일고등학교,60,60,0,60,30,30,0,0
교육기관,교육부,전주중앙여자고등학교,교육부 전라북도교육청 전주중앙여자고등학교,25,25,0,25,16,9,0,0
교육기관,교육부,전주한일고등학교,교육부 전라북도교육청 전주한일고등학교,87,87,0,87,0,87,0,0
교육기관,교육부,전주해성고등학교,교육부 전라북도교육청 전주해성고등학교,16,16,0,16,0,16,0,0
교육기관,교육부,정읍여자고등학교,교육부 전라북도교육청 정읍여자고등학교,7,7,0,7,0,7,0,0
교육기관,교육부,정읍제일고등학교,교육부 전라북도교육청 정읍제일고등학교,14,12,2,12,8,4,0,0
교육기관,교육부,정주고등학교,교육부 전라북도교육청 정주고등학교,33,14,19,14,12,2,0,0
교육기관,교육부,줄포자동차공업고등학교,교육부 전라북도교육청 줄포자동차공업고등학교,8,8,0,8,4,4,0,0
교육기관,교육부,진경여자고등학교,교육부 전라북도교육청 진경여자고등학교,24,24,0,24,0,24,0,0
교육기관,교육부,진안공업고등학교,교육부 전라북도교육청 진안공업고등학교,39,39,0,39,13,26,0,0
교육기관,교육부,진안제일고등학교,교육부 전라북도교육청 진안제일고등학교,19,19,0,19,4,15,0,0
교육기관,교육부,칠보고등학교,교육부 전라북도교육청 칠보고등학교,6,6,0,6,0,6,0,0
교육기관,교육부,태인고등학교,교육부 전라북도교육청 태인고등학교,18,17,1,17,9,6,0,2
교육기관,교육부,푸른꿈고등학교,교육부 전라북도교육청 푸른꿈고등학교,16,16,0,16,0,16,0,0
교육기관,교육부,학산고등학교,교육부 전라북도교육청 학산고등학교,12,11,1,11,11,0,0,0
교육기관,교육부,한국경마축산고등학교,교육부 전라북도교육청 한국경마축산고등학교,45,45,0,45,45,0,0,0
교육기관,교육부,한국전통문화고등학교,교육부 전라북도교육청 한국전통문화고등학교,7,7,0,7,0,7,0,0
교육기관,교육부,한들고등학교,교육부 전라북도교육청 한들고등학교,12,12,0,12,4,8,0,0
교육기관,교육부,한별고등학교,교육부 전라북도교육청 한별고등학교,41,41,0,41,5,36,0,0
교육기관,교육부,한울학교,교육부 전라북도교육청 한울학교,16,16,0,16,0,16,0,0
교육기관,교육부,함열여자고등학교,교육부 전라북도교육청 함열여자고등학교,46,16,30,16,10,6,0,0
교육기관,교육부,해리고등학교,교육부 전라북도교육청 해리고등학교,10,10,0,10,3,6,1,0
교육기관,교육부,호남고등학교,교육부 전라북도교육청 호남고등학교,52,51,1,51,17,34,0,0
교육기관,교육부,호남제일고등학교,교육부 전라북도교육청 호남제일고등학교,98,98,0,98,72,26,0,0
교육기관,교육부,전라남도교육청,교육부 전라남도교육청,67,13,54,13,0,13,0,0
교육기관,교육부,강진고등학교,교육부 전라남도교육청 강진고등학교,87,87,0,87,68,16,2,1
교육기관,교육부,고금고등학교,교육부 전라남도교육청 고금고등학교,4,4,0,4,4,0,0,0
교육기관,교육부,고흥고등학교,교육부 전라남도교육청 고흥고등학교,102,102,0,102,22,80,0,0
교육기관,교육부,고흥도화고등학교,교육부 전라남도교육청 고흥도화고등학교,9,9,0,9,0,9,0,0
교육기관,교육부,고흥산업과학고등학교,교육부 전라남도교육청 고흥산업과학고등학교,25,25,0,25,13,12,0,0
교육기관,교육부,광남고등학교,교육부 전라남도교육청 광남고등학교,28,28,0,28,28,0,0,0
교육기관,교육부,광양고등학교,교육부 전라남도교육청 광양고등학교,87,87,0,87,0,87,0,0
교육기관,교육부,광양백운고등학교,교육부 전라남도교육청 광양백운고등학교,13,13,0,13,10,2,0,1
교육기관,교육부,광양여자고등학교,교육부 전라남도교육청 광양여자고등학교,31,31,0,31,7,24,0,0
교육기관,교육부,광양제철고등학교,교육부 전라남도교육청 광양제철고등학교,68,68,0,68,43,20,5,0
교육기관,교육부,광양하이텍고등학교,교육부 전라남도교육청 광양하이텍고등학교,56,42,14,42,20,20,1,1
교육기관,교육부,광양햇살학교,교육부 전라남도교육청 광양햇살학교,22,22,0,22,16,6,0,0
교육기관,교육부,광영고등학교,교육부 전라남도교육청 광영고등학교,17,11,6,11,0,11,0,0
교육기관,교육부,금성고등학교,교육부 전라남도교육청 금성고등학교,36,36,0,36,22,14,0,0
교육기관,교육부,나주고등학교,교육부 전라남도교육청 나주고등학교,23,23,0,23,18,3,1,1
교육기관,교육부,나주공업고등학교,교육부 전라남도교육청 나주공업고등학교,22,22,0,22,22,0,0,0
교육기관,교육부,나주상업고등학교,교육부 전라남도교육청 나주상업고등학교,16,16,0,16,6,6,2,2
교육기관,교육부,남악고등학교,교육부 전라남도교육청 남악고등학교,79,79,0,79,50,29,0,0
교육기관,교육부,노화고등학교,교육부 전라남도교육청 노화고등학교,13,13,0,13,13,0,0,0
교육기관,교육부,녹동고등학교,교육부 전라남도교육청 녹동고등학교,31,31,0,31,2,29,0,0
교육기관,교육부,능주고등학교,교육부 전라남도교육청 능주고등학교,78,76,2,76,22,54,0,0
교육기관,교육부,다향고등학교,교육부 전라남도교육청 다향고등학교,32,24,8,24,24,0,0,0
교육기관,교육부,담양고등학교,교육부 전라남도교육청 담양고등학교,22,22,0,22,22,0,0,0
교육기관,교육부,담양공업고등학교,교육부 전라남도교육청 담양공업고등학교,35,35,0,35,8,27,0,0
교육기관,교육부,덕수학교,교육부 전라남도교육청 덕수학교,34,34,0,34,0,34,0,0
교육기관,교육부,도초고등학교,교육부 전라남도교육청 도초고등학교,86,86,0,86,0,86,0,0
교육기관,교육부,매성고등학교,교육부 전라남도교육청 매성고등학교,51,49,2,49,0,49,0,0
교육기관,교육부,목상고등학교,교육부 전라남도교육청 목상고등학교,33,13,20,13,8,2,2,1
교육기관,교육부,목포고등학교,교육부 전라남도교육청 목포고등학교,30,17,13,17,13,2,1,1
교육기관,교육부,목포공업고등학교,교육부 전라남도교육청 목포공업고등학교,44,44,0,44,0,44,0,0
교육기관,교육부,목포덕인고등학교,교육부 전라남도교육청 목포덕인고등학교,48,48,0,48,47,1,0,0
교육기관,교육부,목포마리아회고등학교,교육부 전라남도교육청 목포마리아회고등학교,75,75,0,75,0,75,0,0
교육기관,교육부,목포성신고등학교,교육부 전라남도교육청 목포성신고등학교,49,49,0,49,0,49,0,0
교육기관,교육부,목포여자고등학교,교육부 전라남도교육청 목포여자고등학교,50,50,0,50,43,5,1,1
교육기관,교육부,목포여자상업고등학교,교육부 전라남도교육청 목포여자상업고등학교,38,38,0,38,20,18,0,0
교육기관,교육부,목포인성학교,교육부 전라남도교육청 목포인성학교,25,25,0,25,12,13,0,0
교육기관,교육부,목포정명여자고등학교,교육부 전라남도교육청 목포정명여자고등학교,54,54,0,54,21,33,0,0
교육기관,교육부,목포제일여자고등학교,교육부 전라남도교육청 목포제일여자고등학교,23,23,0,23,23,0,0,0
교육기관,교육부,목포중앙고등학교,교육부 전라남도교육청 목포중앙고등학교,69,69,0,69,0,69,0,0
교육기관,교육부,목포혜인여자고등학교,교육부 전라남도교육청 목포혜인여자고등학교,14,14,0,14,14,0,0,0
교육기관,교육부,목포홍일고등학교,교육부 전라남도교육청 목포홍일고등학교,20,20,0,20,0,20,0,0
교육기관,교육부,무안고등학교,교육부 전라남도교육청 무안고등학교,69,69,0,69,38,30,1,0
교육기관,교육부,문태고등학교,교육부 전라남도교육청 문태고등학교,58,58,0,58,0,58,0,0
교육기관,교육부,문향고등학교,교육부 전라남도교육청 문향고등학교,52,52,0,52,23,23,6,0
교육기관,교육부,백제고등학교,교육부 전라남도교육청 백제고등학교,11,10,1,10,10,0,0,0
교육기관,교육부,벌교고등학교,교육부 전라남도교육청 벌교고등학교,61,59,2,59,10,48,1,0
교육기관,교육부,벌교상업고등학교,교육부 전라남도교육청 벌교상업고등학교,33,31,2,31,2,29,0,0
교육기관,교육부,벌교여자고등학교,교육부 전라남도교육청 벌교여자고등학교,11,11,0,11,11,0,0,0
교육기관,교육부,법성고등학교,교육부 전라남도교육청 법성고등학교,29,29,0,29,25,4,0,0
교육기관,교육부,병영상업고등학교,교육부 전라남도교육청 병영상업고등학교,10,9,1,9,7,2,0,0
교육기관,교육부,보성고등학교,교육부 전라남도교육청 보성고등학교,57,57,0,57,14,43,0,0
교육기관,교육부,봉황고등학교,교육부 전라남도교육청 봉황고등학교,21,21,0,21,7,8,4,2
교육기관,교육부,부영여자고등학교,교육부 전라남도교육청 부영여자고등학교,27,26,1,26,25,1,0,0
교육기관,교육부,삼계고등학교,교육부 전라남도교육청 삼계고등학교,20,20,0,20,7,13,0,0
교육기관,교육부,삼호고등학교,교육부 전라남도교육청 삼호고등학교,95,95,0,95,95,0,0,0
교육기관,교육부,성요셉상호문화고등학교,교육부 전라남도교육청 성요셉상호문화고등학교,23,19,4,19,15,4,0,0
교육기관,교육부,성전고등학교,교육부 전라남도교육청 성전고등학교,20,20,0,20,7,13,0,0
교육기관,교육부,송강고등학교,교육부 전라남도교육청 송강고등학교,16,14,2,14,5,5,2,2
교육기관,교육부,송지고등학교,교육부 전라남도교육청 송지고등학교,32,32,0,32,16,16,0,0
교육기관,교육부,신안해양과학고등학교,교육부 전라남도교육청 신안해양과학고등학교,32,3,29,3,1,1,0,1
교육기관,교육부,안좌고등학교,교육부 전라남도교육청 안좌고등학교,24,24,0,24,24,0,0,0
교육기관,교육부,약산고등학교,교육부 전라남도교육청 약산고등학교,6,5,1,5,0,5,0,0
교육기관,교육부,여남고등학교,교육부 전라남도교육청 여남고등학교,23,22,1,22,0,22,0,0
교육기관,교육부,여수고등학교,교육부 전라남도교육청 여수고등학교,47,47,0,47,44,3,0,0
교육기관,교육부,여수공업고등학교,교육부 전라남도교육청 여수공업고등학교,30,30,0,30,30,0,0,0
교육기관,교육부,여수석유화학고등학교,교육부 전라남도교육청 여수석유화학고등학교,90,86,4,86,10,74,2,0
교육기관,교육부,여수여명학교,교육부 전라남도교육청 여수여명학교,48,48,0,48,30,16,2,0
교육기관,교육부,여수여자고등학교,교육부 전라남도교육청 여수여자고등학교,22,22,0,22,11,11,0,0
교육기관,교육부,여수정보과학고등학교,교육부 전라남도교육청 여수정보과학고등학교,57,57,0,57,57,0,0,0
교육기관,교육부,여수중앙여자고등학교,교육부 전라남도교육청 여수중앙여자고등학교,10,10,0,10,10,0,0,0
교육기관,교육부,여수충무고등학교,교육부 전라남도교육청 여수충무고등학교,43,0,43,0,0,0,0,0
교육기관,교육부,여수해양과학고등학교,교육부 전라남도교육청 여수해양과학고등학교,49,49,0,49,29,20,0,0
교육기관,교육부,여수화양고등학교,교육부 전라남도교육청 여수화양고등학교,33,14,19,14,14,0,0,0
교육기관,교육부,여양고등학교,교육부 전라남도교육청 여양고등학교,22,22,0,22,21,1,0,0
교육기관,교육부,여천고등학교,교육부 전라남도교육청 여천고등학교,33,33,0,33,13,20,0,0
교육기관,교육부,영광고등학교,교육부 전라남도교육청 영광고등학교,52,50,2,50,46,4,0,0
교육기관,교육부,영광공업고등학교,교육부 전라남도교육청 영광공업고등학교,64,64,0,64,49,15,0,0
교육기관,교육부,영광전자고등학교,교육부 전라남도교육청 영광전자고등학교,23,23,0,23,7,16,0,0
교육기관,교육부,영산고등학교,교육부 전라남도교육청 영산고등학교,55,55,0,55,0,55,0,0
교육기관,교육부,영산성지고등학교,교육부 전라남도교육청 영산성지고등학교,25,25,0,25,1,24,0,0
교육기관,교육부,영흥고등학교,교육부 전라남도교육청 영흥고등학교,60,60,0,60,38,22,0,0
교육기관,교육부,예당고등학교,교육부 전라남도교육청 예당고등학교,50,50,0,50,42,8,0,0
교육기관,교육부,옥과고등학교,교육부 전라남도교육청 옥과고등학교,52,19,33,19,15,4,0,0
교육기관,교육부,완도고등학교,교육부 전라남도교육청 완도고등학교,39,39,0,39,25,13,0,1
교육기관,교육부,완도금일고등학교,교육부 전라남도교육청 완도금일고등학교,32,32,0,32,24,8,0,0
교육기관,교육부,완도수산고등학교,교육부 전라남도교육청 완도수산고등학교,82,31,51,31,15,14,1,1
교육기관,교육부,임자고등학교,교육부 전라남도교육청 임자고등학교,15,15,0,15,9,5,1,0
교육기관,교육부,장성고등학교,교육부 전라남도교육청 장성고등학교,66,66,0,66,50,16,0,0
교육기관,교육부,장성하이텍고등학교,교육부 전라남도교육청 장성하이텍고등학교,28,27,1,27,26,0,1,0
교육기관,교육부,장흥고등학교,교육부 전라남도교육청 장흥고등학교,41,41,0,41,21,20,0,0
교육기관,교육부,장흥관산고등학교,교육부 전라남도교육청 장흥관산고등학교,13,12,1,12,7,3,1,1
교육기관,교육부,전남과학고등학교,교육부 전라남도교육청 전남과학고등학교,28,26,2,26,13,13,0,0
교육기관,교육부,전남기술과학고등학교,교육부 전라남도교육청 전남기술과학고등학교,50,50,0,50,6,44,0,0
교육기관,교육부,전남미용고등학교,교육부 전라남도교육청 전남미용고등학교,38,38,0,38,12,26,0,0
교육기관,교육부,전남보건고등학교,교육부 전라남도교육청 전남보건고등학교,31,31,0,31,25,6,0,0
교육기관,교육부,전남생명과학고등학교,교육부 전라남도교육청 전남생명과학고등학교,174,174,0,174,83,91,0,0
교육기관,교육부,전남예술고등학교,교육부 전라남도교육청 전남예술고등학교,70,70,0,70,70,0,0,0
교육기관,교육부,전남외국어고등학교,교육부 전라남도교육청 전남외국어고등학교,42,42,0,42,42,0,0,0
교육기관,교육부,전남체육고등학교,교육부 전라남도교육청 전남체육고등학교,52,52,0,52,18,34,0,0
교육기관,교육부,전라남도강진교육지원청,교육부 전라남도교육청 전라남도강진교육지원청,15,15,0,15,0,15,0,0
교육기관,교육부,강진대구중학교,교육부 전라남도교육청 전라남도강진교육지원청 강진대구중학교,4,4,0,4,2,2,0,0
교육기관,교육부,강진동초등학교,교육부 전라남도교육청 전라남도강진교육지원청 강진동초등학교,18,18,0,18,17,0,0,1
교육기관,교육부,강진여자중학교,교육부 전라남도교육청 전라남도강진교육지원청 강진여자중학교,25,25,0,25,25,0,0,0
교육기관,교육부,강진작천중학교,교육부 전라남도교육청 전라남도강진교육지원청 강진작천중학교,6,6,0,6,5,1,0,0
교육기관,교육부,강진중앙초등학교,교육부 전라남도교육청 전라남도강진교육지원청 강진중앙초등학교,53,53,0,53,39,14,0,0
교육기관,교육부,강진중학교,교육부 전라남도교육청 전라남도강진교육지원청 강진중학교,35,35,0,35,35,0,0,0
교육기관,교육부,강진칠량중학교,교육부 전라남도교육청 전라남도강진교육지원청 강진칠량중학교,8,7,1,7,0,7,0,0
교육기관,교육부,계산초등학교,교육부 전라남도교육청 전라남도강진교육지원청 계산초등학교,7,7,0,7,4,3,0,0
교육기관,교육부,군동초등학교,교육부 전라남도교육청 전라남도강진교육지원청 군동초등학교,5,5,0,5,4,0,1,0
교육기관,교육부,대구초등학교,교육부 전라남도교육청 전라남도강진교육지원청 대구초등학교,9,9,0,9,5,4,0,0
교육기관,교육부,도암중학교,교육부 전라남도교육청 전라남도강진교육지원청 도암중학교,17,17,0,17,1,16,0,0
교육기관,교육부,도암초등학교,교육부 전라남도교육청 전라남도강진교육지원청 도암초등학교,14,14,0,14,14,0,0,0
교육기관,교육부,마량초등학교,교육부 전라남도교육청 전라남도강진교육지원청 마량초등학교,13,13,0,13,1,12,0,0
교육기관,교육부,병영중학교,교육부 전라남도교육청 전라남도강진교육지원청 병영중학교,5,4,1,4,4,0,0,0
교육기관,교육부,병영초등학교,교육부 전라남도교육청 전라남도강진교육지원청 병영초등학교,8,8,0,8,8,0,0,0
교육기관,교육부,성전중학교,교육부 전라남도교육청 전라남도강진교육지원청 성전중학교,7,6,1,6,0,5,0,1
교육기관,교육부,성전초등학교,교육부 전라남도교육청 전라남도강진교육지원청 성전초등학교,12,12,0,12,2,10,0,0
교육기관,교육부,신전초등학교,교육부 전라남도교육청 전라남도강진교육지원청 신전초등학교,10,10,0,10,10,0,0,0
교육기관,교육부,옴천초등학교,교육부 전라남도교육청 전라남도강진교육지원청 옴천초등학교,9,9,0,9,2,7,0,0
교육기관,교육부,작천초등학교,교육부 전라남도교육청 전라남도강진교육지원청 작천초등학교,11,11,0,11,11,0,0,0
교육기관,교육부,청람중학교,교육부 전라남도교육청 전라남도강진교육지원청 청람중학교,31,31,0,31,31,0,0,0
교육기관,교육부,칠량초등학교,교육부 전라남도교육청 전라남도강진교육지원청 칠량초등학교,19,19,0,19,15,4,0,0
교육기관,교육부,전라남도고흥교육지원청,교육부 전라남도교육청 전라남도고흥교육지원청,8,8,0,8,0,8,0,0
교육기관,교육부,고흥과역중학교,교육부 전라남도교육청 전라남도고흥교육지원청 고흥과역중학교,8,8,0,8,4,4,0,0
교육기관,교육부,고흥남양중학교,교육부 전라남도교육청 전라남도고흥교육지원청 고흥남양중학교,7,7,0,7,7,0,0,0
교육기관,교육부,고흥대서중학교,교육부 전라남도교육청 전라남도고흥교육지원청 고흥대서중학교,4,4,0,4,2,2,0,0
교육기관,교육부,고흥도덕중학교,교육부 전라남도교육청 전라남도고흥교육지원청 고흥도덕중학교,12,12,0,12,5,6,1,0
교육기관,교육부,고흥도화중학교,교육부 전라남도교육청 전라남도고흥교육지원청 고흥도화중학교,8,8,0,8,8,0,0,0
교육기관,교육부,고흥동초등학교,교육부 전라남도교육청 전라남도고흥교육지원청 고흥동초등학교,17,17,0,17,17,0,0,0
교육기관,교육부,고흥백양중학교,교육부 전라남도교육청 전라남도고흥교육지원청 고흥백양중학교,14,14,0,14,14,0,0,0
교육기관,교육부,고흥여자중학교,교육부 전라남도교육청 전라남도고흥교육지원청 고흥여자중학교,19,19,0,19,19,0,0,0
교육기관,교육부,고흥점암중앙중학교,교육부 전라남도교육청 전라남도고흥교육지원청 고흥점암중앙중학교,8,8,0,8,2,2,2,2
교육기관,교육부,고흥중학교,교육부 전라남도교육청 전라남도고흥교육지원청 고흥중학교,26,26,0,26,26,0,0,0
교육기관,교육부,고흥푸른꿈유치원,교육부 전라남도교육청 전라남도고흥교육지원청 고흥푸른꿈유치원,11,11,0,11,6,5,0,0
교육기관,교육부,고흥풍양중학교,교육부 전라남도교육청 전라남도고흥교육지원청 고흥풍양중학교,7,7,0,7,7,0,0,0
교육기관,교육부,과역초등학교,교육부 전라남도교육청 전라남도고흥교육지원청 과역초등학교,8,8,0,8,0,8,0,0
교육기관,교육부,금산중학교,교육부 전라남도교육청 전라남도고흥교육지원청 금산중학교,16,16,0,16,13,3,0,0
교육기관,교육부,금산초등학교,교육부 전라남도교육청 전라남도고흥교육지원청 금산초등학교,8,8,0,8,8,0,0,0
교육기관,교육부,남양초등학교,교육부 전라남도교육청 전라남도고흥교육지원청 남양초등학교,7,7,0,7,7,0,0,0
교육기관,교육부,녹동중학교,교육부 전라남도교육청 전라남도고흥교육지원청 녹동중학교,19,19,0,19,19,0,0,0
교육기관,교육부,녹동초등학교,교육부 전라남도교육청 전라남도고흥교육지원청 녹동초등학교,25,25,0,25,25,0,0,0
교육기관,교육부,대서초등학교,교육부 전라남도교육청 전라남도고흥교육지원청 대서초등학교,12,12,0,12,10,2,0,0
교육기관,교육부,도덕초등학교,교육부 전라남도교육청 전라남도고흥교육지원청 도덕초등학교,12,12,0,12,12,0,0,0
교육기관,교육부,도화초등학교,교육부 전라남도교육청 전라남도고흥교육지원청 도화초등학교,6,6,0,6,6,0,0,0
교육기관,교육부,동강중학교,교육부 전라남도교육청 전라남도고흥교육지원청 동강중학교,6,6,0,6,4,2,0,0
교육기관,교육부,동강초등학교,교육부 전라남도교육청 전라남도고흥교육지원청 동강초등학교,14,14,0,14,13,1,0,0
교육기관,교육부,두원초등학교,교육부 전라남도교육청 전라남도고흥교육지원청 두원초등학교,4,4,0,4,4,0,0,0
교육기관,교육부,백양초등학교,교육부 전라남도교육청 전라남도고흥교육지원청 백양초등학교,4,4,0,4,4,0,0,0
교육기관,교육부,봉래중학교,교육부 전라남도교육청 전라남도고흥교육지원청 봉래중학교,7,7,0,7,6,1,0,0
교육기관,교육부,봉래초등학교,교육부 전라남도교육청 전라남도고흥교육지원청 봉래초등학교,10,7,3,7,7,0,0,0
교육기관,교육부,영남초등학교,교육부 전라남도교육청 전라남도고흥교육지원청 영남초등학교,4,4,0,4,4,0,0,0
교육기관,교육부,점암초등학교,교육부 전라남도교육청 전라남도고흥교육지원청 점암초등학교,5,5,0,5,1,4,0,0
교육기관,교육부,포두중학교,교육부 전라남도교육청 전라남도고흥교육지원청 포두중학교,10,10,0,10,9,1,0,0
교육기관,교육부,포두초등학교,교육부 전라남도교육청 전라남도고흥교육지원청 포두초등학교,8,8,0,8,4,4,0,0
교육기관,교육부,풍남초등학교,교육부 전라남도교육청 전라남도고흥교육지원청 풍남초등학교,6,6,0,6,6,0,0,0
교육기관,교육부,풍양초등학교,교육부 전라남도교육청 전라남도고흥교육지원청 풍양초등학교,14,14,0,14,14,0,0,0
교육기관,교육부,전라남도곡성교육지원청,교육부 전라남도교육청 전라남도곡성교육지원청,15,15,0,15,0,15,0,0
교육기관,교육부,곡성고등학교,교육부 전라남도교육청 전라남도곡성교육지원청 곡성고등학교,48,48,0,48,25,23,0,0
교육기관,교육부,곡성유치원,교육부 전라남도교육청 전라남도곡성교육지원청 곡성유치원,8,8,0,8,7,1,0,0
교육기관,교육부,삼기초등학교,교육부 전라남도교육청 전라남도곡성교육지원청 삼기초등학교,14,14,0,14,14,0,0,0
교육기관,교육부,석곡중학교,교육부 전라남도교육청 전라남도곡성교육지원청 석곡중학교,10,10,0,10,0,10,0,0
교육기관,교육부,오산초등학교,교육부 전라남도교육청 전라남도곡성교육지원청 오산초등학교,9,9,0,9,6,3,0,0
교육기관,교육부,옥과중학교,교육부 전라남도교육청 전라남도곡성교육지원청 옥과중학교,17,17,0,17,17,0,0,0
교육기관,교육부,옥과초등학교,교육부 전라남도교육청 전라남도곡성교육지원청 옥과초등학교,14,14,0,14,0,14,0,0
교육기관,교육부,입면초등학교,교육부 전라남도교육청 전라남도곡성교육지원청 입면초등학교,11,11,0,11,5,6,0,0
교육기관,교육부,전남조리과학고등학교,교육부 전라남도교육청 전라남도곡성교육지원청 전남조리과학고등학교,73,73,0,73,0,73,0,0
교육기관,교육부,전라남도교육청곡성교육문화회관,교육부 전라남도교육청 전라남도곡성교육지원청 전라남도교육청곡성교육문화회관,15,15,0,15,0,15,0,0
교육기관,교육부,죽곡초등학교,교육부 전라남도교육청 전라남도곡성교육지원청 죽곡초등학교,7,7,0,7,7,0,0,0
교육기관,교육부,한울고등학교,교육부 전라남도교육청 전라남도곡성교육지원청 한울고등학교,66,66,0,66,39,27,0,0
교육기관,교육부,전라남도광양교육지원청,교육부 전라남도교육청 전라남도광양교육지원청,10,10,0,10,0,10,0,0
교육기관,교육부,골약초등학교,교육부 전라남도교육청 전라남도광양교육지원청 골약초등학교,9,9,0,9,9,0,0,0
교육기관,교육부,광양가야초등학교,교육부 전라남도교육청 전라남도광양교육지원청 광양가야초등학교,8,8,0,8,8,0,0,0
교육기관,교육부,광양골약중학교,교육부 전라남도교육청 전라남도광양교육지원청 광양골약중학교,23,23,0,23,16,1,1,5
교육기관,교육부,광양다압중학교,교육부 전라남도교육청 전라남도광양교육지원청 광양다압중학교,8,7,1,7,7,0,0,0
교육기관,교육부,광양덕례초등학교,교육부 전라남도교육청 전라남도광양교육지원청 광양덕례초등학교,11,11,0,11,11,0,0,0
교육기관,교육부,광양동초등학교,교육부 전라남도교육청 전라남도광양교육지원청 광양동초등학교,16,16,0,16,8,8,0,0
교육기관,교육부,광양마동중학교,교육부 전라남도교육청 전라남도광양교육지원청 광양마동중학교,29,27,2,27,27,0,0,0
교육기관,교육부,광양마동초등학교,교육부 전라남도교육청 전라남도광양교육지원청 광양마동초등학교,21,21,0,21,21,0,0,0
교육기관,교육부,광양마로초등학교,교육부 전라남도교육청 전라남도광양교육지원청 광양마로초등학교,13,13,0,13,13,0,0,0
교육기관,교육부,광양백운중학교,교육부 전라남도교육청 전라남도광양교육지원청 광양백운중학교,19,19,0,19,19,0,0,0
교육기관,교육부,광양백운초등학교,교육부 전라남도교육청 전라남도광양교육지원청 광양백운초등학교,14,14,0,14,14,0,0,0
교육기관,교육부,광양북초등학교,교육부 전라남도교육청 전라남도광양교육지원청 광양북초등학교,12,12,0,12,6,6,0,0
교육기관,교육부,광양서초등학교,교육부 전라남도교육청 전라남도광양교육지원청 광양서초등학교,17,17,0,17,8,7,1,1
교육기관,교육부,광양여자중학교,교육부 전라남도교육청 전라남도광양교육지원청 광양여자중학교,36,18,18,18,10,8,0,0
교육기관,교육부,광양와우초등학교,교육부 전라남도교육청 전라남도광양교육지원청 광양와우초등학교,16,16,0,16,0,16,0,0
교육기관,교육부,광양용강중학교,교육부 전라남도교육청 전라남도광양교육지원청 광양용강중학교,54,54,0,54,30,24,0,0
교육기관,교육부,광양용강초등학교,교육부 전라남도교육청 전라남도광양교육지원청 광양용강초등학교,18,18,0,18,18,0,0,0
교육기관,교육부,광양제철남초등학교,교육부 전라남도교육청 전라남도광양교육지원청 광양제철남초등학교,16,16,0,16,0,16,0,0
교육기관,교육부,광양제철초등학교,교육부 전라남도교육청 전라남도광양교육지원청 광양제철초등학교,16,16,0,16,0,16,0,0
교육기관,교육부,광양중동중학교,교육부 전라남도교육청 전라남도광양교육지원청 광양중동중학교,43,43,0,43,15,13,15,0
교육기관,교육부,광양중동초등학교,교육부 전라남도교육청 전라남도광양교육지원청 광양중동초등학교,30,30,0,30,29,1,0,0
교육기관,교육부,광양중마유치원,교육부 전라남도교육청 전라남도광양교육지원청 광양중마유치원,15,15,0,15,15,0,0,0
교육기관,교육부,광양중마초등학교,교육부 전라남도교육청 전라남도광양교육지원청 광양중마초등학교,12,12,0,12,0,12,0,0
교육기관,교육부,광양중앙초등학교,교육부 전라남도교육청 전라남도광양교육지원청 광양중앙초등학교,16,16,0,16,16,0,0,0
교육기관,교육부,광양중진초등학교,교육부 전라남도교육청 전라남도광양교육지원청 광양중진초등학교,13,13,0,13,13,0,0,0
교육기관,교육부,광양중학교,교육부 전라남도교육청 전라남도광양교육지원청 광양중학교,24,24,0,24,12,12,0,0
교육기관,교육부,광양진월중학교,교육부 전라남도교육청 전라남도광양교육지원청 광양진월중학교,5,5,0,5,2,3,0,0
교육기관,교육부,광양칠성초등학교,교육부 전라남도교육청 전라남도광양교육지원청 광양칠성초등학교,15,15,0,15,15,0,0,0
교육기관,교육부,광영중학교,교육부 전라남도교육청 전라남도광양교육지원청 광영중학교,9,9,0,9,0,9,0,0
교육기관,교육부,광영초등학교,교육부 전라남도교육청 전라남도광양교육지원청 광영초등학교,16,16,0,16,8,8,0,0
교육기관,교육부,다압초등학교,교육부 전라남도교육청 전라남도광양교육지원청 다압초등학교,13,13,0,13,10,3,0,0
교육기관,교육부,동광양중학교,교육부 전라남도교육청 전라남도광양교육지원청 동광양중학교,34,33,1,33,7,26,0,0
교육기관,교육부,봉강초등학교,교육부 전라남도교육청 전라남도광양교육지원청 봉강초등학교,6,6,0,6,6,0,0,0
교육기관,교육부,성황초등학교,교육부 전라남도교육청 전라남도광양교육지원청 성황초등학교,21,21,0,21,21,0,0,0
교육기관,교육부,세풍초등학교,교육부 전라남도교육청 전라남도광양교육지원청 세풍초등학교,17,17,0,17,8,8,1,0
교육기관,교육부,옥곡중학교,교육부 전라남도교육청 전라남도광양교육지원청 옥곡중학교,10,9,1,9,9,0,0,0
교육기관,교육부,옥곡초등학교,교육부 전라남도교육청 전라남도광양교육지원청 옥곡초등학교,7,7,0,7,7,0,0,0
교육기관,교육부,옥룡북초등학교,교육부 전라남도교육청 전라남도광양교육지원청 옥룡북초등학교,10,10,0,10,10,0,0,0
교육기관,교육부,옥룡초등학교,교육부 전라남도교육청 전라남도광양교육지원청 옥룡초등학교,7,7,0,7,6,1,0,0
교육기관,교육부,이음학교,교육부 전라남도교육청 전라남도광양교육지원청 이음학교,29,29,0,29,0,29,0,0
교육기관,교육부,전라남도교육청광양도서관,교육부 전라남도교육청 전라남도광양교육지원청 전라남도교육청광양도서관,32,32,0,32,31,1,0,0
교육기관,교육부,진상중학교,교육부 전라남도교육청 전라남도광양교육지원청 진상중학교,10,9,1,9,4,5,0,0
교육기관,교육부,진상초등학교,교육부 전라남도교육청 전라남도광양교육지원청 진상초등학교,10,10,0,10,5,5,0,0
교육기관,교육부,진월초등학교,교육부 전라남도교육청 전라남도광양교육지원청 진월초등학교,18,18,0,18,18,0,0,0
교육기관,교육부,태인초등학교,교육부 전라남도교육청 전라남도광양교육지원청 태인초등학교,9,9,0,9,9,0,0,0
교육기관,교육부,전라남도교육청고흥평생교육관,교육부 전라남도교육청 전라남도교육청고흥평생교육관,37,37,0,37,37,0,0,0
교육기관,교육부,전라남도교육청광양평생교육관,교육부 전라남도교육청 전라남도교육청광양평생교육관,22,22,0,22,15,7,0,0
교육기관,교육부,전라남도교육청교육연구정보원,교육부 전라남도교육청 전라남도교육청교육연구정보원,52,15,37,15,0,15,0,0
교육기관,교육부,전라남도교육청교육연수원,교육부 전라남도교육청 전라남도교육청교육연수원,20,20,0,20,0,20,0,0
교육기관,교육부,전라남도교육청국제교육원,교육부 전라남도교육청 전라남도교육청국제교육원,42,39,3,39,35,4,0,0
교육기관,교육부,전라남도교육청나주도서관,교육부 전라남도교육청 전라남도교육청나주도서관,40,40,0,40,18,22,0,0
교육기관,교육부,전라남도교육청목포도서관,교육부 전라남도교육청 전라남도교육청목포도서관,48,48,0,48,33,15,0,0
교육기관,교육부,전라남도교육청유아교육진흥원,교육부 전라남도교육청 전라남도교육청유아교육진흥원,7,7,0,7,0,7,0,0
교육기관,교육부,전라남도교육청장성도서관,교육부 전라남도교육청 전라남도교육청장성도서관,28,28,0,28,7,21,0,0
교육기관,교육부,전라남도교육청창의융합교육원,교육부 전라남도교육청 전라남도교육청창의융합교육원,25,25,0,25,0,25,0,0
교육기관,교육부,전라남도교육청순천만생태문화교육원,교육부 전라남도교육청 전라남도교육청창의융합교육원 전라남도교육청순천만생태문화교육원,76,76,0,76,0,76,0,0
교육기관,교육부,전라남도교육청자연탐구원,교육부 전라남도교육청 전라남도교육청창의융합교육원 전라남도교육청자연탐구원,27,27,0,27,0,27,0,0
교육기관,교육부,전라남도교육청학생교육문화회관,교육부 전라남도교육청 전라남도교육청학생교육문화회관,48,48,0,48,0,48,0,0
교육기관,교육부,전라남도교육청학생교육원,교육부 전라남도교육청 전라남도교육청학생교육원,15,15,0,15,0,15,0,0
교육기관,교육부,전라남도교육청나로도학생수련장,교육부 전라남도교육청 전라남도교육청학생교육원 전라남도교육청나로도학생수련장,23,23,0,23,16,7,0,0
교육기관,교육부,전라남도교육청백운학생수련장,교육부 전라남도교육청 전라남도교육청학생교육원 전라남도교육청백운학생수련장,22,22,0,22,0,22,0,0
교육기관,교육부,전라남도교육청송호학생수련장,교육부 전라남도교육청 전라남도교육청학생교육원 전라남도교육청송호학생수련장,26,26,0,26,0,26,0,0
교육기관,교육부,전라남도교육청안전체험학습장,교육부 전라남도교육청 전라남도교육청학생교육원 전라남도교육청안전체험학습장,58,58,0,58,29,29,0,0
교육기관,교육부,전라남도교육청월출학생수련장,교육부 전라남도교육청 전라남도교육청학생교육원 전라남도교육청월출학생수련장,30,30,0,30,0,30,0,0
교육기관,교육부,전라남도교육청유달학생수련장,교육부 전라남도교육청 전라남도교육청학생교육원 전라남도교육청유달학생수련장,16,16,0,16,0,16,0,0
교육기관,교육부,전라남도교육청지리산학생수련장,교육부 전라남도교육청 전라남도교육청학생교육원 전라남도교육청지리산학생수련장,22,22,0,22,16,6,0,0
교육기관,교육부,전라남도구례교육지원청,교육부 전라남도교육청 전라남도구례교육지원청,33,33,0,33,0,33,0,0
교육기관,교육부,간문초등학교,교육부 전라남도교육청 전라남도구례교육지원청 간문초등학교,6,6,0,6,4,2,0,0
교육기관,교육부,광의초등학교,교육부 전라남도교육청 전라남도구례교육지원청 광의초등학교,10,10,0,10,4,6,0,0
교육기관,교육부,구례고등학교,교육부 전라남도교육청 전라남도구례교육지원청 구례고등학교,22,22,0,22,22,0,0,0
교육기관,교육부,구례동중학교,교육부 전라남도교육청 전라남도구례교육지원청 구례동중학교,5,5,0,5,5,0,0,0
교육기관,교육부,구례북중학교,교육부 전라남도교육청 전라남도구례교육지원청 구례북중학교,10,10,0,10,5,5,0,0
교육기관,교육부,구례북초등학교,교육부 전라남도교육청 전라남도구례교육지원청 구례북초등학교,18,18,0,18,18,0,0,0
교육기관,교육부,구례산동중학교,교육부 전라남도교육청 전라남도구례교육지원청 구례산동중학교,6,6,0,6,6,0,0,0
교육기관,교육부,구례여자중학교,교육부 전라남도교육청 전라남도구례교육지원청 구례여자중학교,11,11,0,11,11,0,0,0
교육기관,교육부,구례중앙초등학교,교육부 전라남도교육청 전라남도구례교육지원청 구례중앙초등학교,19,19,0,19,8,11,0,0
교육기관,교육부,구례중학교,교육부 전라남도교육청 전라남도구례교육지원청 구례중학교,15,15,0,15,1,14,0,0
교육기관,교육부,문척초등학교,교육부 전라남도교육청 전라남도구례교육지원청 문척초등학교,8,8,0,8,8,0,0,0
교육기관,교육부,용방초등학교,교육부 전라남도교육청 전라남도구례교육지원청 용방초등학교,11,10,1,10,10,0,0,0
교육기관,교육부,원촌초등학교,교육부 전라남도교육청 전라남도구례교육지원청 원촌초등학교,12,12,0,12,0,12,0,0
교육기관,교육부,전남자연과학고등학교,교육부 전라남도교육청 전라남도구례교육지원청 전남자연과학고등학교,23,23,0,23,13,10,0,0
교육기관,교육부,전라남도교육청구례도서관,교육부 전라남도교육청 전라남도구례교육지원청 전라남도교육청구례도서관,26,26,0,26,0,26,0,0
교육기관,교육부,중동초등학교,교육부 전라남도교육청 전라남도구례교육지원청 중동초등학교,11,11,0,11,4,7,0,0
교육기관,교육부,청천초등학교,교육부 전라남도교육청 전라남도구례교육지원청 청천초등학교,12,12,0,12,12,0,0,0
교육기관,교육부,토지초등학교,교육부 전라남도교육청 전라남도구례교육지원청 토지초등학교,12,12,0,12,8,4,0,0
교육기관,교육부,전라남도나주교육지원청,교육부 전라남도교육청 전라남도나주교육지원청,20,15,5,15,0,15,0,0
교육기관,교육부,나주반남중학교,교육부 전라남도교육청 전라남도나주교육지원청 나주반남중학교,7,7,0,7,4,3,0,0
교육기관,교육부,나주이화학교,교육부 전라남도교육청 전라남도나주교육지원청 나주이화학교,14,14,0,14,0,14,0,0
교육기관,교육부,매성중학교,교육부 전라남도교육청 전라남도나주교육지원청 매성중학교,51,49,2,49,32,8,0,9
교육기관,교육부,영산포여자중학교,교육부 전라남도교육청 전라남도나주교육지원청 영산포여자중학교,16,14,2,14,14,0,0,0
교육기관,교육부,전라남도교육청남평도서관,교육부 전라남도교육청 전라남도나주교육지원청 전라남도교육청남평도서관,16,16,0,16,0,14,2,0
교육기관,교육부,전라남도담양교육지원청,교육부 전라남도교육청 전라남도담양교육지원청,8,8,0,8,0,8,0,0
교육기관,교육부,고서초등학교,교육부 전라남도교육청 전라남도담양교육지원청 고서초등학교,8,8,0,8,4,4,0,0
교육기관,교육부,금성초등학교,교육부 전라남도교육청 전라남도담양교육지원청 금성초등학교,11,11,0,11,9,2,0,0
교육기관,교육부,남면초등학교,교육부 전라남도교육청 전라남도담양교육지원청 남면초등학교,6,6,0,6,6,0,0,0
교육기관,교육부,담양고서중학교,교육부 전라남도교육청 전라남도담양교육지원청 담양고서중학교,12,12,0,12,12,0,0,0
교육기관,교육부,담양금성중학교,교육부 전라남도교육청 전라남도담양교육지원청 담양금성중학교,7,7,0,7,0,7,0,0
교육기관,교육부,담양남초등학교,교육부 전라남도교육청 전라남도담양교육지원청 담양남초등학교,12,12,0,12,12,0,0,0
교육기관,교육부,담양동초등학교,교육부 전라남도교육청 전라남도담양교육지원청 담양동초등학교,17,17,0,17,10,7,0,0
교육기관,교육부,담양수북중학교,교육부 전라남도교육청 전라남도담양교육지원청 담양수북중학교,8,8,0,8,8,0,0,0
교육기관,교육부,담양여자중학교,교육부 전라남도교육청 전라남도담양교육지원청 담양여자중학교,7,7,0,7,7,0,0,0
교육기관,교육부,담양중학교,교육부 전라남도교육청 전라남도담양교육지원청 담양중학교,12,12,0,12,12,0,0,0
교육기관,교육부,담주초등학교,교육부 전라남도교육청 전라남도담양교육지원청 담주초등학교,13,13,0,13,13,0,0,0
교육기관,교육부,만덕초등학교,교육부 전라남도교육청 전라남도담양교육지원청 만덕초등학교,5,5,0,5,5,0,0,0
교육기관,교육부,무정초등학교,교육부 전라남도교육청 전라남도담양교육지원청 무정초등학교,6,6,0,6,3,3,0,0
교육기관,교육부,봉산초등학교,교육부 전라남도교육청 전라남도담양교육지원청 봉산초등학교,5,5,0,5,0,5,0,0
교육기관,교육부,수북초등학교,교육부 전라남도교육청 전라남도담양교육지원청 수북초등학교,8,8,0,8,8,0,0,0
교육기관,교육부,용면초등학교,교육부 전라남도교육청 전라남도담양교육지원청 용면초등학교,4,4,0,4,4,0,0,0
교육기관,교육부,월산초등학교,교육부 전라남도교육청 전라남도담양교육지원청 월산초등학교,6,6,0,6,5,1,0,0
교육기관,교육부,전라남도교육청담양도서관,교육부 전라남도교육청 전라남도담양교육지원청 전라남도교육청담양도서관,21,21,0,21,0,21,0,0
교육기관,교육부,창평중학교,교육부 전라남도교육청 전라남도담양교육지원청 창평중학교,13,13,0,13,13,0,0,0
교육기관,교육부,창평초등학교,교육부 전라남도교육청 전라남도담양교육지원청 창평초등학교,14,14,0,14,12,2,0,0
교육기관,교육부,한재중학교,교육부 전라남도교육청 전라남도담양교육지원청 한재중학교,15,14,1,14,14,0,0,0
교육기관,교육부,한재초등학교,교육부 전라남도교육청 전라남도담양교육지원청 한재초등학교,8,8,0,8,5,3,0,0
교육기관,교육부,전라남도목포교육지원청,교육부 전라남도교육청 전라남도목포교육지원청,36,35,1,35,0,35,0,0
교육기관,교육부,목포남초등학교,교육부 전라남도교육청 전라남도목포교육지원청 목포남초등학교,13,13,0,13,13,0,0,0
교육기관,교육부,목포대성초등학교,교육부 전라남도교육청 전라남도목포교육지원청 목포대성초등학교,14,14,0,14,12,2,0,0
교육기관,교육부,목포대연초등학교,교육부 전라남도교육청 전라남도목포교육지원청 목포대연초등학교,19,19,0,19,19,0,0,0
교육기관,교육부,목포덕인중학교,교육부 전라남도교육청 전라남도목포교육지원청 목포덕인중학교,22,22,0,22,22,0,0,0
교육기관,교육부,목포동초등학교,교육부 전라남도교육청 전라남도목포교육지원청 목포동초등학교,15,15,0,15,11,4,0,0
교육기관,교육부,목포미항초등학교,교육부 전라남도교육청 전라남도목포교육지원청 목포미항초등학교,11,11,0,11,9,2,0,0
교육기관,교육부,목포백련유치원,교육부 전라남도교육청 전라남도목포교육지원청 목포백련유치원,9,9,0,9,7,2,0,0
교육기관,교육부,목포백련초등학교,교육부 전라남도교육청 전라남도목포교육지원청 목포백련초등학교,24,24,0,24,16,8,0,0
교육기관,교육부,목포부설초등학교,교육부 전라남도교육청 전라남도목포교육지원청 목포부설초등학교,35,35,0,35,35,0,0,0
교육기관,교육부,목포부영초등학교,교육부 전라남도교육청 전라남도목포교육지원청 목포부영초등학교,12,12,0,12,12,0,0,0
교육기관,교육부,목포부주초등학교,교육부 전라남도교육청 전라남도목포교육지원청 목포부주초등학교,14,14,0,14,12,2,0,0
교육기관,교육부,목포북교초등학교,교육부 전라남도교육청 전라남도목포교육지원청 목포북교초등학교,10,10,0,10,10,0,0,0
교육기관,교육부,목포삼학초등학교,교육부 전라남도교육청 전라남도목포교육지원청 목포삼학초등학교,15,15,0,15,12,0,0,3
교육기관,교육부,목포상동초등학교,교육부 전라남도교육청 전라남도목포교육지원청 목포상동초등학교,27,27,0,27,12,15,0,0
교육기관,교육부,목포서부유치원,교육부 전라남도교육청 전라남도목포교육지원청 목포서부유치원,4,4,0,4,4,0,0,0
교육기관,교육부,목포서부초등학교,교육부 전라남도교육청 전라남도목포교육지원청 목포서부초등학교,12,12,0,12,0,12,0,0
교육기관,교육부,목포서산초등학교,교육부 전라남도교육청 전라남도목포교육지원청 목포서산초등학교,6,6,0,6,3,3,0,0
교육기관,교육부,목포서해초등학교,교육부 전라남도교육청 전라남도목포교육지원청 목포서해초등학교,22,22,0,22,19,3,0,0
교육기관,교육부,목포석현초등학교,교육부 전라남도교육청 전라남도목포교육지원청 목포석현초등학교,19,16,3,16,16,0,0,0
교육기관,교육부,목포신흥초등학교,교육부 전라남도교육청 전라남도목포교육지원청 목포신흥초등학교,9,9,0,9,9,0,0,0
교육기관,교육부,목포애향중학교,교육부 전라남도교육청 전라남도목포교육지원청 목포애향중학교,40,40,0,40,40,0,0,0
교육기관,교육부,목포애향초등학교,교육부 전라남도교육청 전라남도목포교육지원청 목포애향초등학교,16,16,0,16,16,0,0,0
교육기관,교육부,목포여자중학교,교육부 전라남도교육청 전라남도목포교육지원청 목포여자중학교,12,12,0,12,6,6,0,0
교육기관,교육부,목포연동초등학교,교육부 전라남도교육청 전라남도목포교육지원청 목포연동초등학교,9,9,0,9,5,4,0,0
교육기관,교육부,목포연산초등학교,교육부 전라남도교육청 전라남도목포교육지원청 목포연산초등학교,11,9,2,9,8,1,0,0
교육기관,교육부,목포영산초등학교,교육부 전라남도교육청 전라남도목포교육지원청 목포영산초등학교,13,13,0,13,7,6,0,0
교육기관,교육부,목포영화중학교,교육부 전라남도교육청 전라남도목포교육지원청 목포영화중학교,22,13,9,13,3,1,0,9
교육기관,교육부,목포옥암유치원,교육부 전라남도교육청 전라남도목포교육지원청 목포옥암유치원,4,4,0,4,0,4,0,0
교육기관,교육부,목포옥암중학교,교육부 전라남도교육청 전라남도목포교육지원청 목포옥암중학교,24,24,0,24,0,24,0,0
교육기관,교육부,목포옥암초등학교,교육부 전라남도교육청 전라남도목포교육지원청 목포옥암초등학교,24,24,0,24,17,2,5,0
교육기관,교육부,목포용해초등학교,교육부 전라남도교육청 전라남도목포교육지원청 목포용해초등학교,13,13,0,13,13,0,0,0
교육기관,교육부,목포용호초등학교,교육부 전라남도교육청 전라남도목포교육지원청 목포용호초등학교,16,16,0,16,16,0,0,0
교육기관,교육부,목포유달중학교,교육부 전라남도교육청 전라남도목포교육지원청 목포유달중학교,40,40,0,40,0,40,0,0
교육기관,교육부,목포유달초등학교,교육부 전라남도교육청 전라남도목포교육지원청 목포유달초등학교,23,23,0,23,20,3,0,0
교육기관,교육부,목포이로초등학교,교육부 전라남도교육청 전라남도목포교육지원청 목포이로초등학교,18,18,0,18,18,0,0,0
교육기관,교육부,목포임성초등학교,교육부 전라남도교육청 전라남도목포교육지원청 목포임성초등학교,6,6,0,6,2,4,0,0
교육기관,교육부,목포정명여자중학교,교육부 전라남도교육청 전라남도목포교육지원청 목포정명여자중학교,34,34,0,34,32,2,0,0
교육기관,교육부,목포제일중학교,교육부 전라남도교육청 전라남도목포교육지원청 목포제일중학교,32,32,0,32,19,13,0,0
교육기관,교육부,목포중앙여자중학교,교육부 전라남도교육청 전라남도목포교육지원청 목포중앙여자중학교,32,31,1,31,9,22,0,0
교육기관,교육부,목포중앙초등학교,교육부 전라남도교육청 전라남도목포교육지원청 목포중앙초등학교,11,11,0,11,11,0,0,0
교육기관,교육부,목포청호중학교,교육부 전라남도교육청 전라남도목포교육지원청 목포청호중학교,32,32,0,32,16,16,0,0
교육기관,교육부,목포청호초등학교,교육부 전라남도교육청 전라남도목포교육지원청 목포청호초등학교,16,16,0,16,16,0,0,0
교육기관,교육부,목포하당중학교,교육부 전라남도교육청 전라남도목포교육지원청 목포하당중학교,41,41,0,41,11,30,0,0
교육기관,교육부,목포하당초등학교,교육부 전라남도교육청 전라남도목포교육지원청 목포하당초등학교,15,15,0,15,12,3,0,0
교육기관,교육부,목포한빛초등학교,교육부 전라남도교육청 전라남도목포교육지원청 목포한빛초등학교,19,19,0,19,16,3,0,0
교육기관,교육부,목포항도여자중학교,교육부 전라남도교육청 전라남도목포교육지원청 목포항도여자중학교,10,8,2,8,4,4,0,0
교육기관,교육부,목포항도초등학교,교육부 전라남도교육청 전라남도목포교육지원청 목포항도초등학교,12,12,0,12,7,5,0,0
교육기관,교육부,목포혜인여자중학교,교육부 전라남도교육청 전라남도목포교육지원청 목포혜인여자중학교,22,22,0,22,12,10,0,0
교육기관,교육부,목포홍일중학교,교육부 전라남도교육청 전라남도목포교육지원청 목포홍일중학교,18,18,0,18,7,11,0,0
교육기관,교육부,문태중학교,교육부 전라남도교육청 전라남도목포교육지원청 문태중학교,29,28,1,28,17,9,2,0
교육기관,교육부,영흥중학교,교육부 전라남도교육청 전라남도목포교육지원청 영흥중학교,12,12,0,12,3,9,0,0
교육기관,교육부,전라남도무안교육지원청,교육부 전라남도교육청 전라남도무안교육지원청,12,12,0,12,0,12,0,0
교육기관,교육부,남악유치원,교육부 전라남도교육청 전라남도무안교육지원청 남악유치원,12,12,0,12,10,2,0,0
교육기관,교육부,남악중학교,교육부 전라남도교육청 전라남도무안교육지원청 남악중학교,19,19,0,19,19,0,0,0
교육기관,교육부,남악초등학교,교육부 전라남도교육청 전라남도무안교육지원청 남악초등학교,15,15,0,15,10,5,0,0
교육기관,교육부,망운중학교,교육부 전라남도교육청 전라남도무안교육지원청 망운중학교,8,8,0,8,4,4,0,0
교육기관,교육부,망운초등학교,교육부 전라남도교육청 전라남도무안교육지원청 망운초등학교,8,8,0,8,8,0,0,0
교육기관,교육부,몽탄초등학교,교육부 전라남도교육청 전라남도무안교육지원청 몽탄초등학교,16,16,0,16,8,8,0,0
교육기관,교육부,무안몽탄중학교,교육부 전라남도교육청 전라남도무안교육지원청 무안몽탄중학교,8,8,0,8,4,4,0,0
교육기관,교육부,무안북중학교,교육부 전라남도교육청 전라남도무안교육지원청 무안북중학교,22,20,2,20,16,4,0,0
교육기관,교육부,무안중학교,교육부 전라남도교육청 전라남도무안교육지원청 무안중학교,27,26,1,26,15,11,0,0
교육기관,교육부,무안청계중학교,교육부 전라남도교육청 전라남도무안교육지원청 무안청계중학교,8,8,0,8,6,1,1,0
교육기관,교육부,무안초등학교,교육부 전라남도교육청 전라남도무안교육지원청 무안초등학교,29,29,0,29,24,3,1,1
교육기관,교육부,무안행복중학교,교육부 전라남도교육청 전라남도무안교육지원청 무안행복중학교,43,43,0,43,30,13,0,0
교육기관,교육부,무안행복초등학교,교육부 전라남도교육청 전라남도무안교육지원청 무안행복초등학교,15,15,0,15,15,0,0,0
교육기관,교육부,무안현경중학교,교육부 전라남도교육청 전라남도무안교육지원청 무안현경중학교,15,15,0,15,8,5,2,0
교육기관,교육부,삼향동초등학교,교육부 전라남도교육청 전라남도무안교육지원청 삼향동초등학교,13,13,0,13,0,13,0,0
교육기관,교육부,삼향북초등학교,교육부 전라남도교육청 전라남도무안교육지원청 삼향북초등학교,6,6,0,6,4,2,0,0
교육기관,교육부,삼향초등학교,교육부 전라남도교육청 전라남도무안교육지원청 삼향초등학교,19,19,0,19,0,19,0,0
교육기관,교육부,오룡유치원,교육부 전라남도교육청 전라남도무안교육지원청 오룡유치원,14,14,0,14,14,0,0,0
교육기관,교육부,오룡중학교,교육부 전라남도교육청 전라남도무안교육지원청 오룡중학교,26,26,0,26,11,15,0,0
교육기관,교육부,오룡초등학교,교육부 전라남도교육청 전라남도무안교육지원청 오룡초등학교,27,27,0,27,19,8,0,0
교육기관,교육부,운남초등학교,교육부 전라남도교육청 전라남도무안교육지원청 운남초등학교,9,9,0,9,0,9,0,0
교육기관,교육부,일로동초등학교,교육부 전라남도교육청 전라남도무안교육지원청 일로동초등학교,9,9,0,9,9,0,0,0
교육기관,교육부,일로초등학교,교육부 전라남도교육청 전라남도무안교육지원청 일로초등학교,18,18,0,18,13,5,0,0
교육기관,교육부,전남체육중학교,교육부 전라남도교육청 전라남도무안교육지원청 전남체육중학교,52,52,0,52,18,34,0,0
교육기관,교육부,전라남도교육청무안도서관,교육부 전라남도교육청 전라남도무안교육지원청 전라남도교육청무안도서관,8,8,0,8,0,8,0,0
교육기관,교육부,제일로유치원,교육부 전라남도교육청 전라남도무안교육지원청 제일로유치원,10,10,0,10,5,5,0,0
교육기관,교육부,청계남초등학교,교육부 전라남도교육청 전라남도무안교육지원청 청계남초등학교,10,10,0,10,6,4,0,0
교육기관,교육부,청계북초등학교,교육부 전라남도교육청 전라남도무안교육지원청 청계북초등학교,8,8,0,8,8,0,0,0
교육기관,교육부,청계초등학교,교육부 전라남도교육청 전라남도무안교육지원청 청계초등학교,10,10,0,10,10,0,0,0
교육기관,교육부,해제중학교,교육부 전라남도교육청 전라남도무안교육지원청 해제중학교,5,5,0,5,5,0,0,0
교육기관,교육부,해제초등학교,교육부 전라남도교육청 전라남도무안교육지원청 해제초등학교,8,8,0,8,8,0,0,0
교육기관,교육부,현경북초등학교,교육부 전라남도교육청 전라남도무안교육지원청 현경북초등학교,11,7,4,7,7,0,0,0
교육기관,교육부,현경초등학교,교육부 전라남도교육청 전라남도무안교육지원청 현경초등학교,6,6,0,6,4,2,0,0
교육기관,교육부,전라남도보성교육지원청,교육부 전라남도교육청 전라남도보성교육지원청,39,39,0,39,7,32,0,0
교육기관,교육부,겸백초등학교,교육부 전라남도교육청 전라남도보성교육지원청 겸백초등학교,15,15,0,15,15,0,0,0
교육기관,교육부,낙성초등학교,교육부 전라남도교육청 전라남도보성교육지원청 낙성초등학교,12,12,0,12,12,0,0,0
교육기관,교육부,노동초등학교,교육부 전라남도교육청 전라남도보성교육지원청 노동초등학교,19,19,0,19,0,19,0,0
교육기관,교육부,득량남초등학교,교육부 전라남도교육청 전라남도보성교육지원청 득량남초등학교,7,7,0,7,7,0,0,0
교육기관,교육부,득량중학교,교육부 전라남도교육청 전라남도보성교육지원청 득량중학교,11,11,0,11,11,0,0,0
교육기관,교육부,문덕초등학교,교육부 전라남도교육청 전라남도보성교육지원청 문덕초등학교,7,7,0,7,0,7,0,0
교육기관,교육부,미력초등학교,교육부 전라남도교육청 전라남도보성교육지원청 미력초등학교,7,7,0,7,7,0,0,0
교육기관,교육부,벌교여자중학교,교육부 전라남도교육청 전라남도보성교육지원청 벌교여자중학교,10,10,0,10,10,0,0,0
교육기관,교육부,벌교중앙초등학교,교육부 전라남도교육청 전라남도보성교육지원청 벌교중앙초등학교,17,17,0,17,17,0,0,0
교육기관,교육부,벌교중학교,교육부 전라남도교육청 전라남도보성교육지원청 벌교중학교,13,12,1,12,9,3,0,0
교육기관,교육부,벌교초등학교,교육부 전라남도교육청 전라남도보성교육지원청 벌교초등학교,21,21,0,21,21,0,0,0
교육기관,교육부,보성남초등학교,교육부 전라남도교육청 전라남도보성교육지원청 보성남초등학교,14,14,0,14,14,0,0,0
교육기관,교육부,보성복내중학교,교육부 전라남도교육청 전라남도보성교육지원청 보성복내중학교,53,53,0,53,17,36,0,0
교육기관,교육부,보성여자중학교,교육부 전라남도교육청 전라남도보성교육지원청 보성여자중학교,16,16,0,16,16,0,0,0
교육기관,교육부,보성중학교,교육부 전라남도교육청 전라남도보성교육지원청 보성중학교,12,12,0,12,2,10,0,0
교육기관,교육부,보성초등학교,교육부 전라남도교육청 전라남도보성교육지원청 보성초등학교,13,13,0,13,13,0,0,0
교육기관,교육부,보성회천중학교,교육부 전라남도교육청 전라남도보성교육지원청 보성회천중학교,5,5,0,5,3,1,1,0
교육기관,교육부,복내초등학교,교육부 전라남도교육청 전라남도보성교육지원청 복내초등학교,5,5,0,5,2,3,0,0
교육기관,교육부,삼광중학교,교육부 전라남도교육청 전라남도보성교육지원청 삼광중학교,4,4,0,4,4,0,0,0
교육기관,교육부,예당중학교,교육부 전라남도교육청 전라남도보성교육지원청 예당중학교,8,8,0,8,5,3,0,0
교육기관,교육부,예당초등학교,교육부 전라남도교육청 전라남도보성교육지원청 예당초등학교,11,11,0,11,6,5,0,0
교육기관,교육부,용정중학교,교육부 전라남도교육청 전라남도보성교육지원청 용정중학교,43,43,0,43,25,18,0,0
교육기관,교육부,율어초등학교,교육부 전라남도교육청 전라남도보성교육지원청 율어초등학교,8,8,0,8,4,4,0,0
교육기관,교육부,전라남도교육청벌교도서관,교육부 전라남도교육청 전라남도보성교육지원청 전라남도교육청벌교도서관,14,14,0,14,0,14,0,0
교육기관,교육부,전라남도교육청보성도서관,교육부 전라남도교육청 전라남도보성교육지원청 전라남도교육청보성도서관,31,31,0,31,0,31,0,0
교육기관,교육부,조성남초등학교,교육부 전라남도교육청 전라남도보성교육지원청 조성남초등학교,4,4,0,4,4,0,0,0
교육기관,교육부,조성중학교,교육부 전라남도교육청 전라남도보성교육지원청 조성중학교,5,5,0,5,5,0,0,0
교육기관,교육부,조성초등학교,교육부 전라남도교육청 전라남도보성교육지원청 조성초등학교,13,13,0,13,13,0,0,0
교육기관,교육부,회천서초등학교,교육부 전라남도교육청 전라남도보성교육지원청 회천서초등학교,5,5,0,5,4,1,0,0
교육기관,교육부,회천초등학교,교육부 전라남도교육청 전라남도보성교육지원청 회천초등학교,5,5,0,5,3,2,0,0
교육기관,교육부,전라남도순천교육지원청,교육부 전라남도교육청 전라남도순천교육지원청,20,18,2,18,0,18,0,0
교육기관,교육부,낙안초등학교,교육부 전라남도교육청 전라남도순천교육지원청 낙안초등학교,8,8,0,8,4,2,1,1
교육기관,교육부,동명초등학교,교육부 전라남도교육청 전라남도순천교육지원청 동명초등학교,18,18,0,18,18,0,0,0
교육기관,교육부,동산초등학교,교육부 전라남도교육청 전라남도순천교육지원청 동산초등학교,27,27,0,27,10,17,0,0
교육기관,교육부,매안초등학교,교육부 전라남도교육청 전라남도순천교육지원청 매안초등학교,26,26,0,26,26,0,0,0
교육기관,교육부,별량초등학교,교육부 전라남도교육청 전라남도순천교육지원청 별량초등학교,8,8,0,8,8,0,0,0
교육기관,교육부,상사초등학교,교육부 전라남도교육청 전라남도순천교육지원청 상사초등학교,8,8,0,8,8,0,0,0
교육기관,교육부,송광초등학교,교육부 전라남도교육청 전라남도순천교육지원청 송광초등학교,13,13,0,13,3,9,0,1
교육기관,교육부,송산초등학교,교육부 전라남도교육청 전라남도순천교육지원청 송산초등학교,4,4,0,4,4,0,0,0
교육기관,교육부,순천강남여자고등학교,교육부 전라남도교육청 전라남도순천교육지원청 순천강남여자고등학교,37,35,2,35,35,0,0,0
교육기관,교육부,순천고등학교,교육부 전라남도교육청 전라남도순천교육지원청 순천고등학교,13,13,0,13,7,6,0,0
교육기관,교육부,순천공업고등학교,교육부 전라남도교육청 전라남도순천교육지원청 순천공업고등학교,44,44,0,44,28,16,0,0
교육기관,교육부,순천금당고등학교,교육부 전라남도교육청 전라남도순천교육지원청 순천금당고등학교,45,45,0,45,0,45,0,0
교육기관,교육부,순천금당중학교,교육부 전라남도교육청 전라남도순천교육지원청 순천금당중학교,43,43,0,43,0,43,0,0
교육기관,교육부,순천낙안중학교,교육부 전라남도교육청 전라남도순천교육지원청 순천낙안중학교,8,8,0,8,8,0,0,0
교육기관,교육부,순천남산중학교,교육부 전라남도교육청 전라남도순천교육지원청 순천남산중학교,34,33,1,33,0,33,0,0
교육기관,교육부,순천남산초등학교,교육부 전라남도교육청 전라남도순천교육지원청 순천남산초등학교,36,36,0,36,0,36,0,0
교육기관,교육부,순천남초등학교,교육부 전라남도교육청 전라남도순천교육지원청 순천남초등학교,15,15,0,15,14,1,0,0
교육기관,교육부,순천대석초등학교,교육부 전라남도교육청 전라남도순천교육지원청 순천대석초등학교,18,18,0,18,18,0,0,0
교육기관,교육부,순천도사초등학교,교육부 전라남도교육청 전라남도순천교육지원청 순천도사초등학교,8,8,0,8,8,0,0,0
교육기관,교육부,순천동산여자중학교,교육부 전라남도교육청 전라남도순천교육지원청 순천동산여자중학교,20,13,7,13,13,0,0,0
교육기관,교육부,순천매산고등학교,교육부 전라남도교육청 전라남도순천교육지원청 순천매산고등학교,60,60,0,60,54,6,0,0
교육기관,교육부,순천매산여자고등학교,교육부 전라남도교육청 전라남도순천교육지원청 순천매산여자고등학교,33,29,4,29,29,0,0,0
교육기관,교육부,순천매산중학교,교육부 전라남도교육청 전라남도순천교육지원청 순천매산중학교,32,32,0,32,32,0,0,0
교육기관,교육부,순천미래과학고등학교,교육부 전라남도교육청 전라남도순천교육지원청 순천미래과학고등학교,46,46,0,46,45,1,0,0
교육기관,교육부,순천별량중학교,교육부 전라남도교육청 전라남도순천교육지원청 순천별량중학교,14,13,1,13,6,5,1,1
교육기관,교육부,순천복성고등학교,교육부 전라남도교육청 전라남도순천교육지원청 순천복성고등학교,55,23,32,23,0,23,0,0
교육기관,교육부,순천봉화초등학교,교육부 전라남도교육청 전라남도순천교육지원청 순천봉화초등학교,12,12,0,12,12,0,0,0
교육기관,교육부,순천부영초등학교,교육부 전라남도교육청 전라남도순천교육지원청 순천부영초등학교,29,17,12,17,0,17,0,0
교육기관,교육부,순천북유치원,교육부 전라남도교육청 전라남도순천교육지원청 순천북유치원,6,6,0,6,0,6,0,0
교육기관,교육부,순천북초등학교,교육부 전라남도교육청 전라남도순천교육지원청 순천북초등학교,14,14,0,14,14,0,0,0
교육기관,교육부,순천비봉유치원,교육부 전라남도교육청 전라남도순천교육지원청 순천비봉유치원,8,8,0,8,0,8,0,0
교육기관,교육부,순천비봉초등학교,교육부 전라남도교육청 전라남도순천교육지원청 순천비봉초등학교,15,15,0,15,14,1,0,0
교육기관,교육부,순천삼산중학교,교육부 전라남도교육청 전라남도순천교육지원청 순천삼산중학교,42,40,2,40,18,22,0,0
교육기관,교육부,순천삼산초등학교,교육부 전라남도교육청 전라남도순천교육지원청 순천삼산초등학교,11,11,0,11,11,0,0,0
교육기관,교육부,순천선혜학교,교육부 전라남도교육청 전라남도순천교육지원청 순천선혜학교,34,34,0,34,33,1,0,0
교육기관,교육부,순천성남초등학교,교육부 전라남도교육청 전라남도순천교육지원청 순천성남초등학교,19,19,0,19,0,19,0,0
교육기관,교육부,순천성동초등학교,교육부 전라남도교육청 전라남도순천교육지원청 순천성동초등학교,8,8,0,8,8,0,0,0
교육기관,교육부,순천승남중학교,교육부 전라남도교육청 전라남도순천교육지원청 순천승남중학교,8,8,0,8,2,6,0,0
교육기관,교육부,순천승주중학교,교육부 전라남도교육청 전라남도순천교육지원청 순천승주중학교,9,9,0,9,6,3,0,0
교육기관,교육부,순천승평중학교,교육부 전라남도교육청 전라남도순천교육지원청 순천승평중학교,39,39,0,39,24,15,0,0
교육기관,교육부,순천신흥중학교,교육부 전라남도교육청 전라남도순천교육지원청 순천신흥중학교,37,37,0,37,36,1,0,0
교육기관,교육부,순천신흥초등학교,교육부 전라남도교육청 전라남도순천교육지원청 순천신흥초등학교,16,16,0,16,16,0,0,0
교육기관,교육부,순천여자고등학교,교육부 전라남도교육청 전라남도순천교육지원청 순천여자고등학교,41,41,0,41,11,30,0,0
교육기관,교육부,순천여자중학교,교육부 전라남도교육청 전라남도순천교육지원청 순천여자중학교,9,5,4,5,2,1,1,1
교육기관,교육부,순천연향중학교,교육부 전라남도교육청 전라남도순천교육지원청 순천연향중학교,39,39,0,39,19,20,0,0
교육기관,교육부,순천연향초등학교,교육부 전라남도교육청 전라남도순천교육지원청 순천연향초등학교,16,16,0,16,7,5,2,2
교육기관,교육부,순천왕운중학교,교육부 전라남도교육청 전라남도순천교육지원청 순천왕운중학교,41,41,0,41,0,41,0,0
교육기관,교육부,순천왕운초등학교,교육부 전라남도교육청 전라남도순천교육지원청 순천왕운초등학교,24,24,0,24,24,0,0,0
교육기관,교육부,순천왕의중학교,교육부 전라남도교육청 전라남도순천교육지원청 순천왕의중학교,53,53,0,53,53,0,0,0
교육기관,교육부,순천왕조초등학교,교육부 전라남도교육청 전라남도순천교육지원청 순천왕조초등학교,15,15,0,15,15,0,0,0
교육기관,교육부,순천왕지초등학교,교육부 전라남도교육청 전라남도순천교육지원청 순천왕지초등학교,17,17,0,17,14,3,0,0
교육기관,교육부,순천용당초등학교,교육부 전라남도교육청 전라남도순천교육지원청 순천용당초등학교,18,18,0,18,9,9,0,0
교육기관,교육부,순천월전중학교,교육부 전라남도교육청 전라남도순천교육지원청 순천월전중학교,10,10,0,10,1,9,0,0
교육기관,교육부,순천율산유치원,교육부 전라남도교육청 전라남도순천교육지원청 순천율산유치원,12,12,0,12,12,0,0,0
교육기관,교육부,순천율산초등학교,교육부 전라남도교육청 전라남도순천교육지원청 순천율산초등학교,19,19,0,19,12,7,0,0
교육기관,교육부,순천이수중학교,교육부 전라남도교육청 전라남도순천교육지원청 순천이수중학교,17,17,0,17,15,2,0,0
교육기관,교육부,순천이수초등학교,교육부 전라남도교육청 전라남도순천교육지원청 순천이수초등학교,15,15,0,15,15,0,0,0
교육기관,교육부,순천인안초등학교,교육부 전라남도교육청 전라남도순천교육지원청 순천인안초등학교,9,9,0,9,8,1,0,0
교육기관,교육부,순천정원유치원,교육부 전라남도교육청 전라남도순천교육지원청 순천정원유치원,7,7,0,7,2,5,0,0
교육기관,교육부,순천제일고등학교,교육부 전라남도교육청 전라남도순천교육지원청 순천제일고등학교,60,60,0,60,55,5,0,0
교육기관,교육부,순천조례초등학교,교육부 전라남도교육청 전라남도순천교육지원청 순천조례초등학교,22,22,0,22,19,3,0,0
교육기관,교육부,순천주암중학교,교육부 전라남도교육청 전라남도순천교육지원청 순천주암중학교,8,7,1,7,0,7,0,0
교육기관,교육부,순천중앙초등학교,교육부 전라남도교육청 전라남도순천교육지원청 순천중앙초등학교,10,10,0,10,10,0,0,0
교육기관,교육부,순천청암고등학교,교육부 전라남도교육청 전라남도순천교육지원청 순천청암고등학교,64,62,2,62,62,0,0,0
교육기관,교육부,순천팔마고등학교,교육부 전라남도교육청 전라남도순천교육지원청 순천팔마고등학교,118,59,59,59,59,0,0,0
교육기관,교육부,순천팔마중학교,교육부 전라남도교육청 전라남도순천교육지원청 순천팔마중학교,42,42,0,42,42,0,0,0
교육기관,교육부,순천풍덕중학교,교육부 전라남도교육청 전라남도순천교육지원청 순천풍덕중학교,35,35,0,35,34,1,0,0
교육기관,교육부,순천풍덕초등학교,교육부 전라남도교육청 전라남도순천교육지원청 순천풍덕초등학교,16,16,0,16,10,6,0,0
교육기관,교육부,순천향림중학교,교육부 전라남도교육청 전라남도순천교육지원청 순천향림중학교,19,19,0,19,18,1,0,0
교육기관,교육부,순천향림초등학교,교육부 전라남도교육청 전라남도순천교육지원청 순천향림초등학교,11,11,0,11,11,0,0,0
교육기관,교육부,순천효산고등학교,교육부 전라남도교육청 전라남도순천교육지원청 순천효산고등학교,59,58,1,58,2,56,0,0
교육기관,교육부,순천효천고등학교,교육부 전라남도교육청 전라남도순천교육지원청 순천효천고등학교,48,47,1,47,0,47,0,0
교육기관,교육부,승주초등학교,교육부 전라남도교육청 전라남도순천교육지원청 승주초등학교,6,6,0,6,6,0,0,0
교육기관,교육부,신대유치원,교육부 전라남도교육청 전라남도순천교육지원청 신대유치원,5,5,0,5,1,2,1,1
교육기관,교육부,신대초등학교,교육부 전라남도교육청 전라남도순천교육지원청 신대초등학교,16,16,0,16,16,0,0,0
교육기관,교육부,외서초등학교,교육부 전라남도교육청 전라남도순천교육지원청 외서초등학교,7,7,0,7,5,2,0,0
교육기관,교육부,월등초등학교,교육부 전라남도교육청 전라남도순천교육지원청 월등초등학교,6,6,0,6,6,0,0,0
교육기관,교육부,좌야초등학교,교육부 전라남도교육청 전라남도순천교육지원청 좌야초등학교,28,28,0,28,15,13,0,0
교육기관,교육부,주암초등학교,교육부 전라남도교육청 전라남도순천교육지원청 주암초등학교,5,5,0,5,0,5,0,0
교육기관,교육부,창촌초등학교,교육부 전라남도교육청 전라남도순천교육지원청 창촌초등학교,10,10,0,10,0,10,0,0
교육기관,교육부,팔마초등학교,교육부 전라남도교육청 전라남도순천교육지원청 팔마초등학교,18,18,0,18,0,18,0,0
교육기관,교육부,한국바둑고등학교,교육부 전라남도교육청 전라남도순천교육지원청 한국바둑고등학교,13,13,0,13,11,2,0,0
교육기관,교육부,한국바둑중학교,교육부 전라남도교육청 전라남도순천교육지원청 한국바둑중학교,12,12,0,12,8,4,0,0
교육기관,교육부,해룡초등학교,교육부 전라남도교육청 전라남도순천교육지원청 해룡초등학교,10,10,0,10,8,2,0,0
교육기관,교육부,황전초등학교,교육부 전라남도교육청 전라남도순천교육지원청 황전초등학교,7,7,0,7,7,0,0,0
교육기관,교육부,전라남도신안교육지원청,교육부 전라남도교육청 전라남도신안교육지원청,8,8,0,8,0,8,0,0
교육기관,교육부,가거도초등학교,교육부 전라남도교육청 전라남도신안교육지원청 가거도초등학교,4,4,0,4,4,0,0,0
교육기관,교육부,도초초등학교,교육부 전라남도교육청 전라남도신안교육지원청 도초초등학교,12,12,0,12,12,0,0,0
교육기관,교육부,비금동초등학교,교육부 전라남도교육청 전라남도신안교육지원청 비금동초등학교,13,13,0,13,0,13,0,0
교육기관,교육부,비금중학교,교육부 전라남도교육청 전라남도신안교육지원청 비금중학교,74,74,0,74,17,57,0,0
교육기관,교육부,비금초등학교,교육부 전라남도교육청 전라남도신안교육지원청 비금초등학교,22,22,0,22,15,7,0,0
교육기관,교육부,신안신의중학교,교육부 전라남도교육청 전라남도신안교육지원청 신안신의중학교,16,7,9,7,0,7,0,0
교육기관,교육부,신안증도중학교,교육부 전라남도교육청 전라남도신안교육지원청 신안증도중학교,9,8,1,8,4,4,0,0
교육기관,교육부,신안흑산중학교,교육부 전라남도교육청 전라남도신안교육지원청 신안흑산중학교,19,18,1,18,8,9,1,0
교육기관,교육부,신의초등학교,교육부 전라남도교육청 전라남도신안교육지원청 신의초등학교,5,5,0,5,5,0,0,0
교육기관,교육부,안좌중학교,교육부 전라남도교육청 전라남도신안교육지원청 안좌중학교,5,4,1,4,4,0,0,0
교육기관,교육부,안좌초등학교,교육부 전라남도교육청 전라남도신안교육지원청 안좌초등학교,11,11,0,11,11,0,0,0
교육기관,교육부,암태중학교,교육부 전라남도교육청 전라남도신안교육지원청 암태중학교,15,15,0,15,15,0,0,0
교육기관,교육부,암태초등학교,교육부 전라남도교육청 전라남도신안교육지원청 암태초등학교,11,11,0,11,2,9,0,0
교육기관,교육부,압해동초등학교,교육부 전라남도교육청 전라남도신안교육지원청 압해동초등학교,4,4,0,4,3,1,0,0
교육기관,교육부,압해서초등학교,교육부 전라남도교육청 전라남도신안교육지원청 압해서초등학교,4,4,0,4,4,0,0,0
교육기관,교육부,압해중학교,교육부 전라남도교육청 전라남도신안교육지원청 압해중학교,16,15,1,15,15,0,0,0
교육기관,교육부,압해초등학교,교육부 전라남도교육청 전라남도신안교육지원청 압해초등학교,14,14,0,14,6,8,0,0
교육기관,교육부,임자남초등학교,교육부 전라남도교육청 전라남도신안교육지원청 임자남초등학교,8,8,0,8,8,0,0,0
교육기관,교육부,임자중학교,교육부 전라남도교육청 전라남도신안교육지원청 임자중학교,3,3,0,3,2,1,0,0
교육기관,교육부,임자초등학교,교육부 전라남도교육청 전라남도신안교육지원청 임자초등학교,4,4,0,4,4,0,0,0
교육기관,교육부,자은중학교,교육부 전라남도교육청 전라남도신안교육지원청 자은중학교,10,9,1,9,9,0,0,0
교육기관,교육부,자은초등학교,교육부 전라남도교육청 전라남도신안교육지원청 자은초등학교,17,17,0,17,17,0,0,0
교육기관,교육부,장산중학교,교육부 전라남도교육청 전라남도신안교육지원청 장산중학교,5,4,1,4,1,1,1,1
교육기관,교육부,장산초등학교,교육부 전라남도교육청 전라남도신안교육지원청 장산초등학교,16,16,0,16,16,0,0,0
교육기관,교육부,증도초등학교,교육부 전라남도교육청 전라남도신안교육지원청 증도초등학교,8,8,0,8,8,0,0,0
교육기관,교육부,지도초등학교,교육부 전라남도교육청 전라남도신안교육지원청 지도초등학교,13,13,0,13,13,0,0,0
교육기관,교육부,지명중학교,교육부 전라남도교육청 전라남도신안교육지원청 지명중학교,4,4,0,4,4,0,0,0
교육기관,교육부,팔금초등학교,교육부 전라남도교육청 전라남도신안교육지원청 팔금초등학교,5,5,0,5,5,0,0,0
교육기관,교육부,하의중학교,교육부 전라남도교육청 전라남도신안교육지원청 하의중학교,2,2,0,2,1,1,0,0
교육기관,교육부,하의초등학교,교육부 전라남도교육청 전라남도신안교육지원청 하의초등학교,11,11,0,11,6,4,0,1
교육기관,교육부,흑산초등학교,교육부 전라남도교육청 전라남도신안교육지원청 흑산초등학교,30,12,18,12,8,4,0,0
교육기관,교육부,전라남도여수교육지원청,교육부 전라남도교육청 전라남도여수교육지원청,20,20,0,20,0,20,0,0
교육기관,교육부,거문중학교,교육부 전라남도교육청 전라남도여수교육지원청 거문중학교,6,6,0,6,6,0,0,0
교육기관,교육부,거문초등학교,교육부 전라남도교육청 전라남도여수교육지원청 거문초등학교,15,15,0,15,15,0,0,0
교육기관,교육부,경호초등학교,교육부 전라남도교육청 전라남도여수교육지원청 경호초등학교,12,12,0,12,12,0,0,0
교육기관,교육부,관기초등학교,교육부 전라남도교육청 전라남도여수교육지원청 관기초등학교,6,6,0,6,0,6,0,0
교육기관,교육부,나진초등학교,교육부 전라남도교육청 전라남도여수교육지원청 나진초등학교,5,5,0,5,5,0,0,0
교육기관,교육부,도원초등학교,교육부 전라남도교육청 전라남도여수교육지원청 도원초등학교,12,12,0,12,11,1,0,0
교육기관,교육부,돌산중앙중학교,교육부 전라남도교육청 전라남도여수교육지원청 돌산중앙중학교,9,9,0,9,8,1,0,0
교육기관,교육부,돌산중학교,교육부 전라남도교육청 전라남도여수교육지원청 돌산중학교,6,5,1,5,2,3,0,0
교육기관,교육부,돌산초등학교,교육부 전라남도교육청 전라남도여수교육지원청 돌산초등학교,12,12,0,12,12,0,0,0
교육기관,교육부,동백초등학교,교육부 전라남도교육청 전라남도여수교육지원청 동백초등학교,21,11,10,11,6,5,0,0
교육기관,교육부,무선중학교,교육부 전라남도교육청 전라남도여수교육지원청 무선중학교,51,49,2,49,0,49,0,0
교육기관,교육부,무선초등학교,교육부 전라남도교육청 전라남도여수교육지원청 무선초등학교,16,16,0,16,9,6,1,0
교육기관,교육부,백초초등학교,교육부 전라남도교육청 전라남도여수교육지원청 백초초등학교,9,9,0,9,7,0,1,1
교육기관,교육부,봉덕초등학교,교육부 전라남도교육청 전라남도여수교육지원청 봉덕초등학교,14,14,0,14,0,14,0,0
교육기관,교육부,상암초등학교,교육부 전라남도교육청 전라남도여수교육지원청 상암초등학교,21,21,0,21,12,9,0,0
교육기관,교육부,성산초등학교,교육부 전라남도교육청 전라남도여수교육지원청 성산초등학교,17,17,0,17,17,0,0,0
교육기관,교육부,소라초등학교,교육부 전라남도교육청 전라남도여수교육지원청 소라초등학교,27,27,0,27,27,0,0,0
교육기관,교육부,소호초등학교,교육부 전라남도교육청 전라남도여수교육지원청 소호초등학교,21,21,0,21,0,21,0,0
교육기관,교육부,송현유치원,교육부 전라남도교육청 전라남도여수교육지원청 송현유치원,7,7,0,7,7,0,0,0
교육기관,교육부,시전초등학교,교육부 전라남도교육청 전라남도여수교육지원청 시전초등학교,12,12,0,12,12,0,0,0
교육기관,교육부,신기초등학교,교육부 전라남도교육청 전라남도여수교육지원청 신기초등학교,19,19,0,19,0,19,0,0
교육기관,교육부,신풍초등학교,교육부 전라남도교육청 전라남도여수교육지원청 신풍초등학교,10,10,0,10,10,0,0,0
교육기관,교육부,쌍봉초등학교,교육부 전라남도교육청 전라남도여수교육지원청 쌍봉초등학교,17,14,3,14,14,0,0,0
교육기관,교육부,안산중학교,교육부 전라남도교육청 전라남도여수교육지원청 안산중학교,28,28,0,28,17,11,0,0
교육기관,교육부,안심초등학교,교육부 전라남도교육청 전라남도여수교육지원청 안심초등학교,22,22,0,22,22,0,0,0
교육기관,교육부,안일초등학교,교육부 전라남도교육청 전라남도여수교육지원청 안일초등학교,4,4,0,4,3,1,0,0
교육기관,교육부,안일초등학교백야분교장,교육부 전라남도교육청 전라남도여수교육지원청 안일초등학교백야분교장,2,2,0,2,2,0,0,0
교육기관,교육부,여남중학교,교육부 전라남도교육청 전라남도여수교육지원청 여남중학교,8,7,1,7,4,3,0,0
교육기관,교육부,여남초등학교,교육부 전라남도교육청 전라남도여수교육지원청 여남초등학교,7,7,0,7,3,4,0,0
교육기관,교육부,여도중학교,교육부 전라남도교육청 전라남도여수교육지원청 여도중학교,29,29,0,29,0,29,0,0
교육기관,교육부,여도초등학교,교육부 전라남도교육청 전라남도여수교육지원청 여도초등학교,12,12,0,12,12,0,0,0
교육기관,교육부,여선중학교,교육부 전라남도교육청 전라남도여수교육지원청 여선중학교,40,40,0,40,4,36,0,0
교육기관,교육부,여수개도중학교,교육부 전라남도교육청 전라남도여수교육지원청 여수개도중학교,5,5,0,5,5,0,0,0
교육기관,교육부,여수구봉중학교,교육부 전라남도교육청 전라남도여수교육지원청 여수구봉중학교,43,43,0,43,31,12,0,0
교육기관,교육부,여수구봉초등학교,교육부 전라남도교육청 전라남도여수교육지원청 여수구봉초등학교,24,24,0,24,0,24,0,0
교육기관,교육부,여수남산초등학교,교육부 전라남도교육청 전라남도여수교육지원청 여수남산초등학교,6,6,0,6,6,0,0,0
교육기관,교육부,여수남초등학교,교육부 전라남도교육청 전라남도여수교육지원청 여수남초등학교,22,22,0,22,22,0,0,0
교육기관,교육부,여수동초등학교,교육부 전라남도교육청 전라남도여수교육지원청 여수동초등학교,24,24,0,24,7,7,5,5
교육기관,교육부,여수문수중학교,교육부 전라남도교육청 전라남도여수교육지원청 여수문수중학교,26,26,0,26,26,0,0,0
교육기관,교육부,여수문수초등학교,교육부 전라남도교육청 전라남도여수교육지원청 여수문수초등학교,12,12,0,12,0,12,0,0
교육기관,교육부,여수미평초등학교,교육부 전라남도교육청 전라남도여수교육지원청 여수미평초등학교,14,14,0,14,14,0,0,0
교육기관,교육부,여수봉산초등학교,교육부 전라남도교육청 전라남도여수교육지원청 여수봉산초등학교,10,10,0,10,10,0,0,0
교육기관,교육부,여수부영초등학교,교육부 전라남도교육청 전라남도여수교육지원청 여수부영초등학교,44,44,0,44,42,2,0,0
교육기관,교육부,여수북초등학교,교육부 전라남도교육청 전라남도여수교육지원청 여수북초등학교,7,7,0,7,7,0,0,0
교육기관,교육부,여수삼일중학교,교육부 전라남도교육청 전라남도여수교육지원청 여수삼일중학교,40,40,0,40,36,2,1,1
교육기관,교육부,여수서초등학교,교육부 전라남도교육청 전라남도여수교육지원청 여수서초등학교,22,22,0,22,5,17,0,0
교육기관,교육부,여수성산유치원,교육부 전라남도교육청 전라남도여수교육지원청 여수성산유치원,8,8,0,8,0,4,0,4
교육기관,교육부,여수송현초등학교,교육부 전라남도교육청 전라남도여수교육지원청 여수송현초등학교,16,16,0,16,8,8,0,0
교육기관,교육부,여수신월초등학교,교육부 전라남도교육청 전라남도여수교육지원청 여수신월초등학교,33,33,0,33,33,0,0,0
교육기관,교육부,여수양지초등학교,교육부 전라남도교육청 전라남도여수교육지원청 여수양지초등학교,8,8,0,8,4,4,0,0
교육기관,교육부,여수여문초등학교,교육부 전라남도교육청 전라남도여수교육지원청 여수여문초등학교,20,20,0,20,0,20,0,0
교육기관,교육부,여수여자중학교,교육부 전라남도교육청 전라남도여수교육지원청 여수여자중학교,28,27,1,27,27,0,0,0
교육기관,교육부,여수웅천중학교,교육부 전라남도교육청 전라남도여수교육지원청 여수웅천중학교,39,39,0,39,27,12,0,0
교육기관,교육부,여수종고중학교,교육부 전라남도교육청 전라남도여수교육지원청 여수종고중학교,15,15,0,15,9,4,2,0
교육기관,교육부,여수종고초등학교,교육부 전라남도교육청 전라남도여수교육지원청 여수종고초등학교,8,8,0,8,0,8,0,0
교육기관,교육부,여수좌수영초등학교,교육부 전라남도교육청 전라남도여수교육지원청 여수좌수영초등학교,39,23,16,23,21,2,0,0
교육기관,교육부,여수중앙여자중학교,교육부 전라남도교육청 전라남도여수교육지원청 여수중앙여자중학교,7,6,1,6,2,4,0,0
교육기관,교육부,여수중앙초등학교,교육부 전라남도교육청 전라남도여수교육지원청 여수중앙초등학교,24,24,0,24,12,12,0,0
교육기관,교육부,여수중학교,교육부 전라남도교육청 전라남도여수교육지원청 여수중학교,29,29,0,29,27,2,0,0
교육기관,교육부,여수진남초등학교,교육부 전라남도교육청 전라남도여수교육지원청 여수진남초등학교,13,13,0,13,13,0,0,0
교육기관,교육부,여수한려초등학교,교육부 전라남도교육청 전라남도여수교육지원청 여수한려초등학교,47,47,0,47,0,47,0,0
교육기관,교육부,여양중학교,교육부 전라남도교육청 전라남도여수교육지원청 여양중학교,5,5,0,5,5,0,0,0
교육기관,교육부,여천중학교,교육부 전라남도교육청 전라남도여수교육지원청 여천중학교,13,10,3,10,6,1,0,3
교육기관,교육부,여천초등학교,교육부 전라남도교육청 전라남도여수교육지원청 여천초등학교,14,14,0,14,10,2,2,0
교육기관,교육부,웅천초등학교,교육부 전라남도교육청 전라남도여수교육지원청 웅천초등학교,25,25,0,25,25,0,0,0
교육기관,교육부,율촌중학교,교육부 전라남도교육청 전라남도여수교육지원청 율촌중학교,8,8,0,8,8,0,0,0
교육기관,교육부,율촌초등학교,교육부 전라남도교육청 전라남도여수교육지원청 율촌초등학교,13,13,0,13,4,9,0,0
교육기관,교육부,죽림초등학교,교육부 전라남도교육청 전라남도여수교육지원청 죽림초등학교,24,24,0,24,14,10,0,0
교육기관,교육부,진남여자중학교,교육부 전라남도교육청 전라남도여수교육지원청 진남여자중학교,35,23,12,23,23,0,0,0
교육기관,교육부,진성여자중학교,교육부 전라남도교육청 전라남도여수교육지원청 진성여자중학교,11,10,1,10,4,6,0,0
교육기관,교육부,충덕중학교,교육부 전라남도교육청 전라남도여수교육지원청 충덕중학교,27,27,0,27,17,10,0,0
교육기관,교육부,화양중학교,교육부 전라남도교육청 전라남도여수교육지원청 화양중학교,15,13,2,13,13,0,0,0
교육기관,교육부,화양초등학교,교육부 전라남도교육청 전라남도여수교육지원청 화양초등학교,12,12,0,12,6,6,0,0
교육기관,교육부,화정초등학교,교육부 전라남도교육청 전라남도여수교육지원청 화정초등학교,8,8,0,8,8,0,0,0
교육기관,교육부,전라남도교육청영광도서관,교육부 전라남도교육청 전라남도영광교육지원청 전라남도교육청영광도서관,31,29,2,29,0,29,0,0
교육기관,교육부,전라남도영암교육지원청,교육부 전라남도교육청 전라남도영암교육지원청,12,12,0,12,0,12,0,0
교육기관,교육부,구림공업고등학교,교육부 전라남도교육청 전라남도영암교육지원청 구림공업고등학교,32,32,0,32,14,17,1,0
교육기관,교육부,구림중학교,교육부 전라남도교육청 전라남도영암교육지원청 구림중학교,4,4,0,4,2,2,0,0
교육기관,교육부,구림초등학교,교육부 전라남도교육청 전라남도영암교육지원청 구림초등학교,4,4,0,4,3,1,0,0
교육기관,교육부,금정초등학교,교육부 전라남도교육청 전라남도영암교육지원청 금정초등학교,9,9,0,9,9,0,0,0
교육기관,교육부,대불초등학교,교육부 전라남도교육청 전라남도영암교육지원청 대불초등학교,16,16,0,16,16,0,0,0
교육기관,교육부,덕진초등학교,교육부 전라남도교육청 전라남도영암교육지원청 덕진초등학교,6,6,0,6,6,0,0,0
교육기관,교육부,도포초등학교,교육부 전라남도교육청 전라남도영암교육지원청 도포초등학교,10,10,0,10,5,5,0,0
교육기관,교육부,독천초등학교,교육부 전라남도교육청 전라남도영암교육지원청 독천초등학교,10,10,0,10,10,0,0,0
교육기관,교육부,삼호서초등학교,교육부 전라남도교육청 전라남도영암교육지원청 삼호서초등학교,16,16,0,16,16,0,0,0
교육기관,교육부,삼호유치원,교육부 전라남도교육청 전라남도영암교육지원청 삼호유치원,16,16,0,16,13,3,0,0
교육기관,교육부,삼호중앙초등학교,교육부 전라남도교육청 전라남도영암교육지원청 삼호중앙초등학교,11,11,0,11,11,0,0,0
교육기관,교육부,삼호중학교,교육부 전라남도교육청 전라남도영암교육지원청 삼호중학교,30,30,0,30,30,0,0,0
교육기관,교육부,서창초등학교,교육부 전라남도교육청 전라남도영암교육지원청 서창초등학교,10,10,0,10,5,5,0,0
교육기관,교육부,소림학교,교육부 전라남도교육청 전라남도영암교육지원청 소림학교,35,35,0,35,0,35,0,0
교육기관,교육부,시종중학교,교육부 전라남도교육청 전라남도영암교육지원청 시종중학교,12,12,0,12,6,6,0,0
교육기관,교육부,시종초등학교,교육부 전라남도교육청 전라남도영암교육지원청 시종초등학교,7,7,0,7,7,0,0,0
교육기관,교육부,신북중학교,교육부 전라남도교육청 전라남도영암교육지원청 신북중학교,8,7,1,7,6,1,0,0
교육기관,교육부,영암고등학교,교육부 전라남도교육청 전라남도영암교육지원청 영암고등학교,50,50,0,50,11,38,0,1
교육기관,교육부,영암금정중학교,교육부 전라남도교육청 전라남도영암교육지원청 영암금정중학교,2,2,0,2,1,1,0,0
교육기관,교육부,영암낭주고등학교,교육부 전라남도교육청 전라남도영암교육지원청 영암낭주고등학교,17,16,1,16,4,12,0,0
교육기관,교육부,영암낭주중학교,교육부 전라남도교육청 전라남도영암교육지원청 영암낭주중학교,10,10,0,10,10,0,0,0
교육기관,교육부,영암도포중학교,교육부 전라남도교육청 전라남도영암교육지원청 영암도포중학교,5,4,1,4,2,2,0,0
교육기관,교육부,영암서호중학교,교육부 전라남도교육청 전라남도영암교육지원청 영암서호중학교,4,4,0,4,2,2,0,0
교육기관,교육부,영암여자고등학교,교육부 전라남도교육청 전라남도영암교육지원청 영암여자고등학교,55,21,34,21,16,5,0,0
교육기관,교육부,영암여자중학교,교육부 전라남도교육청 전라남도영암교육지원청 영암여자중학교,5,5,0,5,2,3,0,0
교육기관,교육부,영암중학교,교육부 전라남도교육청 전라남도영암교육지원청 영암중학교,7,7,0,7,7,0,0,0
교육기관,교육부,영암초등학교,교육부 전라남도교육청 전라남도영암교육지원청 영암초등학교,20,20,0,20,16,2,2,0
교육기관,교육부,은광학교,교육부 전라남도교육청 전라남도영암교육지원청 은광학교,6,5,1,5,1,4,0,0
교육기관,교육부,장천초등학교,교육부 전라남도교육청 전라남도영암교육지원청 장천초등학교,6,6,0,6,4,2,0,0
교육기관,교육부,전남에너지고등학교,교육부 전라남도교육청 전라남도영암교육지원청 전남에너지고등학교,27,27,0,27,20,7,0,0
교육기관,교육부,전라남도교육청영암도서관,교육부 전라남도교육청 전라남도영암교육지원청 전라남도교육청영암도서관,16,16,0,16,5,11,0,0
교육기관,교육부,학산초등학교,교육부 전라남도교육청 전라남도영암교육지원청 학산초등학교,8,8,0,8,8,0,0,0
교육기관,교육부,전라남도완도교육지원청,교육부 전라남도교육청 전라남도완도교육지원청,22,22,0,22,0,22,0,0
교육기관,교육부,고금중학교,교육부 전라남도교육청 전라남도완도교육지원청 고금중학교,17,16,1,16,16,0,0,0
교육기관,교육부,고금초등학교,교육부 전라남도교육청 전라남도완도교육지원청 고금초등학교,11,11,0,11,11,0,0,0
교육기관,교육부,군외중학교,교육부 전라남도교육청 전라남도완도교육지원청 군외중학교,8,7,1,7,2,3,1,1
교육기관,교육부,군외초등학교,교육부 전라남도교육청 전라남도완도교육지원청 군외초등학교,9,9,0,9,5,4,0,0
교육기관,교육부,금당중학교,교육부 전라남도교육청 전라남도완도교육지원청 금당중학교,12,10,2,10,3,7,0,0
교육기관,교육부,금당초등학교,교육부 전라남도교육청 전라남도완도교육지원청 금당초등학교,5,5,0,5,0,5,0,0
교육기관,교육부,금일동초등학교,교육부 전라남도교육청 전라남도완도교육지원청 금일동초등학교,11,11,0,11,8,3,0,0
교육기관,교육부,금일중학교,교육부 전라남도교육청 전라남도완도교육지원청 금일중학교,9,9,0,9,9,0,0,0
교육기관,교육부,금일중학교생일분교장,교육부 전라남도교육청 전라남도완도교육지원청 금일중학교생일분교장,5,4,1,4,4,0,0,0
교육기관,교육부,금일초등학교,교육부 전라남도교육청 전라남도완도교육지원청 금일초등학교,16,16,0,16,16,0,0,0
교육기관,교육부,넙도초등학교,교육부 전라남도교육청 전라남도완도교육지원청 넙도초등학교,28,28,0,28,0,28,0,0
교육기관,교육부,노화북초등학교,교육부 전라남도교육청 전라남도완도교육지원청 노화북초등학교,11,11,0,11,11,0,0,0
교육기관,교육부,노화중앙초등학교,교육부 전라남도교육청 전라남도완도교육지원청 노화중앙초등학교,11,11,0,11,8,3,0,0
교육기관,교육부,노화중학교,교육부 전라남도교육청 전라남도완도교육지원청 노화중학교,12,11,1,11,5,6,0,0
교육기관,교육부,노화초등학교,교육부 전라남도교육청 전라남도완도교육지원청 노화초등학교,18,18,0,18,16,2,0,0
교육기관,교육부,보길동초등학교,교육부 전라남도교육청 전라남도완도교육지원청 보길동초등학교,9,9,0,9,9,0,0,0
교육기관,교육부,보길초등학교,교육부 전라남도교육청 전라남도완도교육지원청 보길초등학교,9,9,0,9,5,4,0,0
교육기관,교육부,생영초등학교,교육부 전라남도교육청 전라남도완도교육지원청 생영초등학교,8,8,0,8,6,2,0,0
교육기관,교육부,소안중학교,교육부 전라남도교육청 전라남도완도교육지원청 소안중학교,5,5,0,5,1,4,0,0
교육기관,교육부,소안초등학교,교육부 전라남도교육청 전라남도완도교육지원청 소안초등학교,14,14,0,14,14,0,0,0
교육기관,교육부,신지동초등학교,교육부 전라남도교육청 전라남도완도교육지원청 신지동초등학교,6,6,0,6,3,3,0,0
교육기관,교육부,신지초등학교,교육부 전라남도교육청 전라남도완도교육지원청 신지초등학교,5,5,0,5,5,0,0,0
교육기관,교육부,약산중학교,교육부 전라남도교육청 전라남도완도교육지원청 약산중학교,4,4,0,4,4,0,0,0
교육기관,교육부,약산초등학교,교육부 전라남도교육청 전라남도완도교육지원청 약산초등학교,10,10,0,10,10,0,0,0
교육기관,교육부,완도보길중학교,교육부 전라남도교육청 전라남도완도교육지원청 완도보길중학교,10,10,0,10,10,0,0,0
교육기관,교육부,완도신지중학교,교육부 전라남도교육청 전라남도완도교육지원청 완도신지중학교,10,8,2,8,6,2,0,0
교육기관,교육부,완도여자중학교,교육부 전라남도교육청 전라남도완도교육지원청 완도여자중학교,9,8,1,8,4,4,0,0
교육기관,교육부,완도유치원,교육부 전라남도교육청 전라남도완도교육지원청 완도유치원,8,8,0,8,0,8,0,0
교육기관,교육부,완도중앙초등학교,교육부 전라남도교육청 전라남도완도교육지원청 완도중앙초등학교,20,20,0,20,10,10,0,0
교육기관,교육부,완도중학교,교육부 전라남도교육청 전라남도완도교육지원청 완도중학교,11,10,1,10,10,0,0,0
교육기관,교육부,완도초등학교,교육부 전라남도교육청 전라남도완도교육지원청 완도초등학교,29,29,0,29,29,0,0,0
교육기관,교육부,청산중학교,교육부 전라남도교육청 전라남도완도교육지원청 청산중학교,4,4,0,4,4,0,0,0
교육기관,교육부,청산초등학교,교육부 전라남도교육청 전라남도완도교육지원청 청산초등학교,10,10,0,10,8,2,0,0
교육기관,교육부,청해초등학교,교육부 전라남도교육청 전라남도완도교육지원청 청해초등학교,10,10,0,10,0,10,0,0
교육기관,교육부,화흥초등학교,교육부 전라남도교육청 전라남도완도교육지원청 화흥초등학교,15,15,0,15,11,4,0,0
교육기관,교육부,전라남도장성교육지원청,교육부 전라남도교육청 전라남도장성교육지원청,7,7,0,7,1,6,0,0
교육기관,교육부,동화초등학교,교육부 전라남도교육청 전라남도장성교육지원청 동화초등학교,9,9,0,9,0,9,0,0
교육기관,교육부,북이초등학교,교육부 전라남도교육청 전라남도장성교육지원청 북이초등학교,11,11,0,11,6,5,0,0
교육기관,교육부,북일초등학교,교육부 전라남도교육청 전라남도장성교육지원청 북일초등학교,10,10,0,10,8,2,0,0
교육기관,교육부,분향초등학교,교육부 전라남도교육청 전라남도장성교육지원청 분향초등학교,11,11,0,11,7,4,0,0
교육기관,교육부,사창유치원,교육부 전라남도교육청 전라남도장성교육지원청 사창유치원,4,4,0,4,0,4,0,0
교육기관,교육부,사창초등학교,교육부 전라남도교육청 전라남도장성교육지원청 사창초등학교,14,14,0,14,7,7,0,0
교육기관,교육부,삼계중학교,교육부 전라남도교육청 전라남도장성교육지원청 삼계중학교,13,13,0,13,13,0,0,0
교육기관,교육부,삼서초등학교,교육부 전라남도교육청 전라남도장성교육지원청 삼서초등학교,10,10,0,10,5,5,0,0
교육기관,교육부,서삼초등학교,교육부 전라남도교육청 전라남도장성교육지원청 서삼초등학교,11,11,0,11,8,1,1,1
교육기관,교육부,약수초등학교,교육부 전라남도교육청 전라남도장성교육지원청 약수초등학교,11,11,0,11,10,1,0,0
교육기관,교육부,월평초등학교,교육부 전라남도교육청 전라남도장성교육지원청 월평초등학교,16,16,0,16,16,0,0,0
교육기관,교육부,장성남중학교,교육부 전라남도교육청 전라남도장성교육지원청 장성남중학교,8,8,0,8,4,4,0,0
교육기관,교육부,장성백암중학교,교육부 전라남도교육청 전라남도장성교육지원청 장성백암중학교,26,26,0,26,14,12,0,0
교육기관,교육부,장성삼서중학교,교육부 전라남도교육청 전라남도장성교육지원청 장성삼서중학교,10,9,1,9,3,5,1,0
교육기관,교육부,장성성산초등학교,교육부 전라남도교육청 전라남도장성교육지원청 장성성산초등학교,15,15,0,15,11,3,1,0
교육기관,교육부,장성여자중학교,교육부 전라남도교육청 전라남도장성교육지원청 장성여자중학교,29,28,1,28,21,7,0,0
교육기관,교육부,장성중앙초등학교,교육부 전라남도교육청 전라남도장성교육지원청 장성중앙초등학교,16,16,0,16,6,10,0,0
교육기관,교육부,장성중학교,교육부 전라남도교육청 전라남도장성교육지원청 장성중학교,8,8,0,8,2,2,2,2
교육기관,교육부,장성황룡중학교,교육부 전라남도교육청 전라남도장성교육지원청 장성황룡중학교,9,9,0,9,9,0,0,0
교육기관,교육부,진원동초등학교,교육부 전라남도교육청 전라남도장성교육지원청 진원동초등학교,10,10,0,10,8,2,0,0
교육기관,교육부,진원초등학교,교육부 전라남도교육청 전라남도장성교육지원청 진원초등학교,14,14,0,14,14,0,0,0
교육기관,교육부,전라남도장흥교육지원청,교육부 전라남도교육청 전라남도장흥교육지원청,5,5,0,5,0,5,0,0
교육기관,교육부,관산남초등학교,교육부 전라남도교육청 전라남도장흥교육지원청 관산남초등학교,11,11,0,11,11,0,0,0
교육기관,교육부,관산초등학교,교육부 전라남도교육청 전라남도장흥교육지원청 관산초등학교,7,7,0,7,0,7,0,0
교육기관,교육부,대덕중학교,교육부 전라남도교육청 전라남도장흥교육지원청 대덕중학교,8,7,1,7,7,0,0,0
교육기관,교육부,대덕초등학교,교육부 전라남도교육청 전라남도장흥교육지원청 대덕초등학교,12,12,0,12,6,6,0,0
교육기관,교육부,명덕초등학교,교육부 전라남도교육청 전라남도장흥교육지원청 명덕초등학교,5,5,0,5,5,0,0,0
교육기관,교육부,부산초등학교,교육부 전라남도교육청 전라남도장흥교육지원청 부산초등학교,15,15,0,15,8,7,0,0
교육기관,교육부,안양초등학교,교육부 전라남도교육청 전라남도장흥교육지원청 안양초등학교,7,7,0,7,7,0,0,0
교육기관,교육부,용산초등학교,교육부 전라남도교육청 전라남도장흥교육지원청 용산초등학교,2,2,0,2,2,0,0,0
교육기관,교육부,유치초등학교,교육부 전라남도교육청 전라남도장흥교육지원청 유치초등학교,13,12,1,12,12,0,0,0
교육기관,교육부,장동초등학교,교육부 전라남도교육청 전라남도장흥교육지원청 장동초등학교,5,5,0,5,4,1,0,0
교육기관,교육부,장평초등학교,교육부 전라남도교육청 전라남도장흥교육지원청 장평초등학교,4,4,0,4,1,1,1,1
교육기관,교육부,장흥관산중학교,교육부 전라남도교육청 전라남도장흥교육지원청 장흥관산중학교,17,17,0,17,13,4,0,0
교육기관,교육부,장흥남초등학교,교육부 전라남도교육청 전라남도장흥교육지원청 장흥남초등학교,9,9,0,9,9,0,0,0
교육기관,교육부,장흥서초등학교,교육부 전라남도교육청 전라남도장흥교육지원청 장흥서초등학교,4,4,0,4,4,0,0,0
교육기관,교육부,장흥안양중학교,교육부 전라남도교육청 전라남도장흥교육지원청 장흥안양중학교,8,8,0,8,8,0,0,0
교육기관,교육부,장흥용산중학교,교육부 전라남도교육청 전라남도장흥교육지원청 장흥용산중학교,12,12,0,12,6,6,0,0
교육기관,교육부,장흥장평중학교,교육부 전라남도교육청 전라남도장흥교육지원청 장흥장평중학교,5,4,1,4,4,0,0,0
교육기관,교육부,장흥중학교,교육부 전라남도교육청 전라남도장흥교육지원청 장흥중학교,17,17,0,17,3,12,2,0
교육기관,교육부,장흥초등학교,교육부 전라남도교육청 전라남도장흥교육지원청 장흥초등학교,26,26,0,26,26,0,0,0
교육기관,교육부,장흥회덕중학교,교육부 전라남도교육청 전라남도장흥교육지원청 장흥회덕중학교,8,8,0,8,4,4,0,0
교육기관,교육부,전라남도교육청장흥도서관,교육부 전라남도교육청 전라남도장흥교육지원청 전라남도교육청장흥도서관,2,2,0,2,1,1,0,0
교육기관,교육부,회진초등학교,교육부 전라남도교육청 전라남도장흥교육지원청 회진초등학교,12,12,0,12,12,0,0,0
교육기관,교육부,전라남도진도교육지원청,교육부 전라남도교육청 전라남도진도교육지원청,17,17,0,17,0,17,0,0
교육기관,교육부,고성중학교,교육부 전라남도교육청 전라남도진도교육지원청 고성중학교,7,7,0,7,0,7,0,0
교육기관,교육부,고성초등학교,교육부 전라남도교육청 전라남도진도교육지원청 고성초등학교,12,12,0,12,7,5,0,0
교육기관,교육부,군내북초등학교,교육부 전라남도교육청 전라남도진도교육지원청 군내북초등학교,8,8,0,8,8,0,0,0
교육기관,교육부,금성초등학교,교육부 전라남도교육청 전라남도진도교육지원청 금성초등학교,8,8,0,8,4,4,0,0
교육기관,교육부,석교중학교,교육부 전라남도교육청 전라남도진도교육지원청 석교중학교,6,6,0,6,6,0,0,0
교육기관,교육부,석교초등학교,교육부 전라남도교육청 전라남도진도교육지원청 석교초등학교,16,16,0,16,0,16,0,0
교육기관,교육부,오산초등학교,교육부 전라남도교육청 전라남도진도교육지원청 오산초등학교,14,14,0,14,8,6,0,0
교육기관,교육부,의신중학교,교육부 전라남도교육청 전라남도진도교육지원청 의신중학교,11,11,0,11,5,6,0,0
교육기관,교육부,의신초등학교,교육부 전라남도교육청 전라남도진도교육지원청 의신초등학교,18,18,0,18,17,1,0,0
교육기관,교육부,전라남도교육청진도도서관,교육부 전라남도교육청 전라남도진도교육지원청 전라남도교육청진도도서관,29,29,0,29,0,29,0,0
교육기관,교육부,조도중학교,교육부 전라남도교육청 전라남도진도교육지원청 조도중학교,18,18,0,18,11,7,0,0
교육기관,교육부,조도초등학교,교육부 전라남도교육청 전라남도진도교육지원청 조도초등학교,27,27,0,27,27,0,0,0
교육기관,교육부,지산초등학교,교육부 전라남도교육청 전라남도진도교육지원청 지산초등학교,11,11,0,11,11,0,0,0
교육기관,교육부,진도군내중학교,교육부 전라남도교육청 전라남도진도교육지원청 진도군내중학교,5,5,0,5,4,1,0,0
교육기관,교육부,진도서초등학교,교육부 전라남도교육청 전라남도진도교육지원청 진도서초등학교,12,12,0,12,12,0,0,0
교육기관,교육부,진도유치원,교육부 전라남도교육청 전라남도진도교육지원청 진도유치원,13,13,0,13,1,10,1,1
교육기관,교육부,진도중앙유치원,교육부 전라남도교육청 전라남도진도교육지원청 진도중앙유치원,8,3,5,3,1,0,1,1
교육기관,교육부,진도중학교,교육부 전라남도교육청 전라남도진도교육지원청 진도중학교,18,18,0,18,0,18,0,0
교육기관,교육부,진도지산중학교,교육부 전라남도교육청 전라남도진도교육지원청 진도지산중학교,16,16,0,16,16,0,0,0
교육기관,교육부,진도초등학교,교육부 전라남도교육청 전라남도진도교육지원청 진도초등학교,34,34,0,34,4,30,0,0
교육기관,교육부,전라남도함평교육지원청,교육부 전라남도교육청 전라남도함평교육지원청,24,24,0,24,0,24,0,0
교육기관,교육부,기산초등학교,교육부 전라남도교육청 전라남도함평교육지원청 기산초등학교,6,6,0,6,2,3,1,0
교육기관,교육부,나산실용예술중학교,교육부 전라남도교육청 전라남도함평교육지원청 나산실용예술중학교,59,59,0,59,25,34,0,0
교육기관,교육부,나산초등학교,교육부 전라남도교육청 전라남도함평교육지원청 나산초등학교,5,5,0,5,3,2,0,0
교육기관,교육부,대동향교초등학교,교육부 전라남도교육청 전라남도함평교육지원청 대동향교초등학교,14,14,0,14,14,0,0,0
교육기관,교육부,손불서초등학교,교육부 전라남도교육청 전라남도함평교육지원청 손불서초등학교,5,5,0,5,0,4,1,0
교육기관,교육부,손불초등학교,교육부 전라남도교육청 전라남도함평교육지원청 손불초등학교,8,8,0,8,4,4,0,0
교육기관,교육부,신광초등학교,교육부 전라남도교육청 전라남도함평교육지원청 신광초등학교,5,5,0,5,5,0,0,0
교육기관,교육부,엄다초등학교,교육부 전라남도교육청 전라남도함평교육지원청 엄다초등학교,10,10,0,10,7,3,0,0
교육기관,교육부,월광기독학교,교육부 전라남도교육청 전라남도함평교육지원청 월광기독학교,87,87,0,87,50,28,5,4
교육기관,교육부,월야초등학교,교육부 전라남도교육청 전라남도함평교육지원청 월야초등학교,15,15,0,15,10,2,2,1
교육기관,교육부,전라남도교육청함평도서관,교육부 전라남도교육청 전라남도함평교육지원청 전라남도교육청함평도서관,7,7,0,7,0,7,0,0
교육기관,교육부,학다리중앙초등학교,교육부 전라남도교육청 전라남도함평교육지원청 학다리중앙초등학교,8,8,0,8,3,5,0,0
교육기관,교육부,함평손불중학교,교육부 전라남도교육청 전라남도함평교육지원청 함평손불중학교,4,4,0,4,4,0,0,0
교육기관,교육부,함평신광중학교,교육부 전라남도교육청 전라남도함평교육지원청 함평신광중학교,5,4,1,4,4,0,0,0
교육기관,교육부,함평여자중학교,교육부 전라남도교육청 전라남도함평교육지원청 함평여자중학교,8,8,0,8,8,0,0,0
교육기관,교육부,함평월야중학교,교육부 전라남도교육청 전라남도함평교육지원청 함평월야중학교,6,5,1,5,2,3,0,0
교육기관,교육부,함평중학교,교육부 전라남도교육청 전라남도함평교육지원청 함평중학교,42,42,0,42,12,30,0,0
교육기관,교육부,함평초등학교,교육부 전라남도교육청 전라남도함평교육지원청 함평초등학교,14,14,0,14,7,5,1,1
교육기관,교육부,함평해보중학교,교육부 전라남도교육청 전라남도함평교육지원청 함평해보중학교,9,9,0,9,9,0,0,0
교육기관,교육부,해보초등학교,교육부 전라남도교육청 전라남도함평교육지원청 해보초등학교,13,13,0,13,0,13,0,0
교육기관,교육부,전라남도해남교육지원청,교육부 전라남도교육청 전라남도해남교육지원청,24,22,2,22,1,21,0,0
교육기관,교육부,계곡초등학교,교육부 전라남도교육청 전라남도해남교육지원청 계곡초등학교,5,5,0,5,5,0,0,0
교육기관,교육부,두륜중학교,교육부 전라남도교육청 전라남도해남교육지원청 두륜중학교,13,13,0,13,13,0,0,0
교육기관,교육부,마산초등학교,교육부 전라남도교육청 전라남도해남교육지원청 마산초등학교,12,12,0,12,9,3,0,0
교육기관,교육부,마산초등학교용전분교장,교육부 전라남도교육청 전라남도해남교육지원청 마산초등학교용전분교장,4,4,0,4,0,4,0,0
교육기관,교육부,북일초등학교,교육부 전라남도교육청 전라남도해남교육지원청 북일초등학교,14,14,0,14,14,0,0,0
교육기관,교육부,북평중학교,교육부 전라남도교육청 전라남도해남교육지원청 북평중학교,4,4,0,4,0,4,0,0
교육기관,교육부,북평초등학교,교육부 전라남도교육청 전라남도해남교육지원청 북평초등학교,11,11,0,11,6,5,0,0
교육기관,교육부,산이서초등학교,교육부 전라남도교육청 전라남도해남교육지원청 산이서초등학교,7,7,0,7,0,7,0,0
교육기관,교육부,산이초등학교,교육부 전라남도교육청 전라남도해남교육지원청 산이초등학교,4,4,0,4,4,0,0,0
교육기관,교육부,삼산초등학교,교육부 전라남도교육청 전라남도해남교육지원청 삼산초등학교,13,13,0,13,13,0,0,0
교육기관,교육부,서정초등학교,교육부 전라남도교육청 전라남도해남교육지원청 서정초등학교,8,8,0,8,8,0,0,0
교육기관,교육부,송지중학교,교육부 전라남도교육청 전라남도해남교육지원청 송지중학교,21,21,0,21,21,0,0,0
교육기관,교육부,송지초등학교,교육부 전라남도교육청 전라남도해남교육지원청 송지초등학교,15,15,0,15,0,15,0,0
교육기관,교육부,어란진초등학교,교육부 전라남도교육청 전라남도해남교육지원청 어란진초등학교,12,12,0,12,12,0,0,0
교육기관,교육부,우수영중학교,교육부 전라남도교육청 전라남도해남교육지원청 우수영중학교,11,11,0,11,8,3,0,0
교육기관,교육부,우수영초등학교,교육부 전라남도교육청 전라남도해남교육지원청 우수영초등학교,22,17,5,17,0,17,0,0
교육기관,교육부,전라남도교육청해남도서관,교육부 전라남도교육청 전라남도해남교육지원청 전라남도교육청해남도서관,29,29,0,29,0,29,0,0
교육기관,교육부,해남동초등학교,교육부 전라남도교육청 전라남도해남교육지원청 해남동초등학교,39,39,0,39,16,23,0,0
교육기관,교육부,해남서초등학교,교육부 전라남도교육청 전라남도해남교육지원청 해남서초등학교,14,14,0,14,6,8,0,0
교육기관,교육부,해남제일중학교,교육부 전라남도교육청 전라남도해남교육지원청 해남제일중학교,32,32,0,32,30,2,0,0
교육기관,교육부,해남중학교,교육부 전라남도교육청 전라남도해남교육지원청 해남중학교,56,56,0,56,30,26,0,0
교육기관,교육부,현산남초등학교,교육부 전라남도교육청 전라남도해남교육지원청 현산남초등학교,7,7,0,7,7,0,0,0
교육기관,교육부,현산중학교,교육부 전라남도교육청 전라남도해남교육지원청 현산중학교,9,9,0,9,7,2,0,0
교육기관,교육부,화산중학교,교육부 전라남도교육청 전라남도해남교육지원청 화산중학교,8,8,0,8,8,0,0,0
교육기관,교육부,화산초등학교,교육부 전라남도교육청 전라남도해남교육지원청 화산초등학교,12,12,0,12,6,6,0,0
교육기관,교육부,화원중학교,교육부 전라남도교육청 전라남도해남교육지원청 화원중학교,4,4,0,4,0,4,0,0
교육기관,교육부,화원초등학교,교육부 전라남도교육청 전라남도해남교육지원청 화원초등학교,6,6,0,6,6,0,0,0
교육기관,교육부,황산중학교,교육부 전라남도교육청 전라남도해남교육지원청 황산중학교,16,15,1,15,0,15,0,0
교육기관,교육부,황산초등학교,교육부 전라남도교육청 전라남도해남교육지원청 황산초등학교,20,20,0,20,20,0,0,0
교육기관,교육부,전라남도화순교육지원청,교육부 전라남도교육청 전라남도화순교육지원청,35,35,0,35,20,15,0,0
교육기관,교육부,능주중학교,교육부 전라남도교육청 전라남도화순교육지원청 능주중학교,17,17,0,17,17,0,0,0
교육기관,교육부,능주초등학교,교육부 전라남도교육청 전라남도화순교육지원청 능주초등학교,10,10,0,10,0,10,0,0
교육기관,교육부,도곡중앙초등학교,교육부 전라남도교육청 전라남도화순교육지원청 도곡중앙초등학교,9,9,0,9,5,4,0,0
교육기관,교육부,도곡초등학교,교육부 전라남도교육청 전라남도화순교육지원청 도곡초등학교,15,15,0,15,14,1,0,0
교육기관,교육부,동면초등학교,교육부 전라남도교육청 전라남도화순교육지원청 동면초등학교,10,10,0,10,10,0,0,0
교육기관,교육부,동복초등학교,교육부 전라남도교육청 전라남도화순교육지원청 동복초등학교,15,15,0,15,15,0,0,0
교육기관,교육부,사평초등학교,교육부 전라남도교육청 전라남도화순교육지원청 사평초등학교,11,11,0,11,11,0,0,0
교육기관,교육부,아산초등학교,교육부 전라남도교육청 전라남도화순교육지원청 아산초등학교,12,12,0,12,0,12,0,0
교육기관,교육부,이양초등학교,교육부 전라남도교육청 전라남도화순교육지원청 이양초등학교,9,9,0,9,9,0,0,0
교육기관,교육부,전라남도교육청화순도서관,교육부 전라남도교육청 전라남도화순교육지원청 전라남도교육청화순도서관,22,22,0,22,11,11,0,0
교육기관,교육부,천태초등학교,교육부 전라남도교육청 전라남도화순교육지원청 천태초등학교,4,4,0,4,4,0,0,0
교육기관,교육부,청풍초등학교,교육부 전라남도교육청 전라남도화순교육지원청 청풍초등학교,10,8,2,8,8,0,0,0
교육기관,교육부,춘양초등학교,교육부 전라남도교육청 전라남도화순교육지원청 춘양초등학교,7,7,0,7,7,0,0,0
교육기관,교육부,한천초등학교,교육부 전라남도교육청 전라남도화순교육지원청 한천초등학교,5,5,0,5,5,0,0,0
교육기관,교육부,화순도곡중학교,교육부 전라남도교육청 전라남도화순교육지원청 화순도곡중학교,13,12,1,12,0,12,0,0
교육기관,교육부,화순도암중학교,교육부 전라남도교육청 전라남도화순교육지원청 화순도암중학교,7,7,0,7,7,0,0,0
교육기관,교육부,화순동면중학교,교육부 전라남도교육청 전라남도화순교육지원청 화순동면중학교,7,6,1,6,2,2,1,1
교육기관,교육부,화순동복중학교,교육부 전라남도교육청 전라남도화순교육지원청 화순동복중학교,6,6,0,6,6,0,0,0
교육기관,교육부,화순만연초등학교,교육부 전라남도교육청 전라남도화순교육지원청 화순만연초등학교,11,11,0,11,11,0,0,0
교육기관,교육부,화순북면중학교,교육부 전라남도교육청 전라남도화순교육지원청 화순북면중학교,5,5,0,5,5,0,0,0
교육기관,교육부,화순사평중학교,교육부 전라남도교육청 전라남도화순교육지원청 화순사평중학교,12,11,1,11,11,0,0,0
교육기관,교육부,화순오성초등학교,교육부 전라남도교육청 전라남도화순교육지원청 화순오성초등학교,25,25,0,25,20,5,0,0
교육기관,교육부,화순이양중학교,교육부 전라남도교육청 전라남도화순교육지원청 화순이양중학교,17,17,0,17,15,2,0,0
교육기관,교육부,화순제일중학교,교육부 전라남도교육청 전라남도화순교육지원청 화순제일중학교,20,20,0,20,20,0,0,0
교육기관,교육부,화순제일초등학교,교육부 전라남도교육청 전라남도화순교육지원청 화순제일초등학교,20,20,0,20,0,20,0,0
교육기관,교육부,화순중학교,교육부 전라남도교육청 전라남도화순교육지원청 화순중학교,52,52,0,52,0,52,0,0
교육기관,교육부,화순초등학교,교육부 전라남도교육청 전라남도화순교육지원청 화순초등학교,38,34,4,34,30,4,0,0
교육기관,교육부,정남진산업고등학교,교육부 전라남도교육청 정남진산업고등학교,35,35,0,35,29,3,2,1
교육기관,교육부,조도고등학교,교육부 전라남도교육청 조도고등학교,18,18,0,18,11,7,0,0
교육기관,교육부,중마고등학교,교육부 전라남도교육청 중마고등학교,59,57,2,57,57,0,0,0
교육기관,교육부,지명고등학교,교육부 전라남도교육청 지명고등학교,25,24,1,24,16,8,0,0
교육기관,교육부,진도고등학교,교육부 전라남도교육청 진도고등학교,20,20,0,20,20,0,0,0
교육기관,교육부,진도국악고등학교,교육부 전라남도교육청 진도국악고등학교,34,34,0,34,25,9,0,0
교육기관,교육부,진도실업고등학교,교육부 전라남도교육청 진도실업고등학교,18,18,0,18,18,0,0,0
교육기관,교육부,진성여자고등학교,교육부 전라남도교육청 진성여자고등학교,21,20,1,20,4,16,0,0
교육기관,교육부,창평고등학교,교육부 전라남도교육청 창평고등학교,79,77,2,77,28,49,0,0
교육기관,교육부,하의고등학교,교육부 전라남도교육청 하의고등학교,16,16,0,16,8,8,0,0
교육기관,교육부,학력인정목포제일정보중.고등학교,교육부 전라남도교육청 학력인정목포제일정보중.고등학교,9,9,0,9,4,5,0,0
교육기관,교육부,한국말산업고등학교,교육부 전라남도교육청 한국말산업고등학교,39,38,1,38,0,38,0,0
교육기관,교육부,한국창의예술고등학교,교육부 전라남도교육청 한국창의예술고등학교,36,36,0,36,16,20,0,0
교육기관,교육부,한국항만물류고등학교,교육부 전라남도교육청 한국항만물류고등학교,51,51,0,51,0,51,0,0
교육기관,교육부,한빛고등학교,교육부 전라남도교육청 한빛고등학교,23,23,0,23,0,23,0,0
교육기관,교육부,한영고등학교,교육부 전라남도교육청 한영고등학교,75,74,1,74,0,74,0,0
교육기관,교육부,함평고등학교,교육부 전라남도교육청 함평고등학교,50,50,0,50,34,16,0,0
교육기관,교육부,함평골프고등학교,교육부 전라남도교육청 함평골프고등학교,68,68,0,68,68,0,0,0
교육기관,교육부,함평영화학교,교육부 전라남도교육청 함평영화학교,12,12,0,12,0,12,0,0
교육기관,교육부,함평학다리고등학교,교육부 전라남도교육청 함평학다리고등학교,122,122,0,122,117,5,0,0
교육기관,교육부,해남고등학교,교육부 전라남도교육청 해남고등학교,71,71,0,71,0,71,0,0
교육기관,교육부,해남공업고등학교,교육부 전라남도교육청 해남공업고등학교,47,47,0,47,14,33,0,0
교육기관,교육부,해룡고등학교,교육부 전라남도교육청 해룡고등학교,91,91,0,91,10,81,0,0
교육기관,교육부,호남원예고등학교,교육부 전라남도교육청 호남원예고등학교,46,46,0,46,1,45,0,0
교육기관,교육부,화순고등학교,교육부 전라남도교육청 화순고등학교,60,60,0,60,60,0,0,0
교육기관,교육부,화순이양고등학교,교육부 전라남도교육청 화순이양고등학교,20,20,0,20,16,4,0,0
교육기관,교육부,화원고등학교,교육부 전라남도교육청 화원고등학교,28,28,0,28,0,28,0,0
교육기관,교육부,경상북도교육청,교육부 경상북도교육청,89,89,0,89,0,89,0,0
교육기관,교육부,가은고등학교,교육부 경상북도교육청 가은고등학교,14,14,0,14,8,6,0,0
교육기관,교육부,강구정보고등학교,교육부 경상북도교육청 강구정보고등학교,10,9,1,9,3,4,1,1
교육기관,교육부,경구고등학교,교육부 경상북도교육청 경구고등학교,75,75,0,75,4,71,0,0
교육기관,교육부,경북과학고등학교,교육부 경상북도교육청 경북과학고등학교,45,45,0,45,0,45,0,0
교육기관,교육부,경북과학기술고등학교,교육부 경상북도교육청 경북과학기술고등학교,57,57,0,57,37,20,0,0
교육기관,교육부,경북기계금속고등학교,교육부 경상북도교육청 경북기계금속고등학교,71,27,44,27,12,15,0,0
교육기관,교육부,경북기계명장고등학교,교육부 경상북도교육청 경북기계명장고등학교,31,31,0,31,2,29,0,0
교육기관,교육부,경북드론고등학교,교육부 경상북도교육청 경북드론고등학교,81,81,0,81,41,40,0,0
교육기관,교육부,경북바이오마이스터고등학교,교육부 경상북도교육청 경북바이오마이스터고등학교,84,21,63,21,21,0,0,0
교육기관,교육부,경북생활과학고등학교,교육부 경상북도교육청 경북생활과학고등학교,88,88,0,88,52,36,0,0
교육기관,교육부,경북세무고등학교,교육부 경상북도교육청 경북세무고등학교,47,47,0,47,47,0,0,0
교육기관,교육부,경북소프트웨어고등학교,교육부 경상북도교육청 경북소프트웨어고등학교,69,69,0,69,51,17,1,0
교육기관,교육부,경북영광학교,교육부 경상북도교육청 경북영광학교,27,27,0,27,18,9,0,0
교육기관,교육부,경북외국어고등학교,교육부 경상북도교육청 경북외국어고등학교,74,74,0,74,74,0,0,0
교육기관,교육부,경북일고등학교,교육부 경상북도교육청 경북일고등학교,47,12,35,12,3,9,0,0
교육기관,교육부,경북자연과학고등학교,교육부 경상북도교육청 경북자연과학고등학교,64,15,49,15,5,7,3,0
교육기관,교육부,경북체육고등학교,교육부 경상북도교육청 경북체육고등학교,114,114,0,114,90,24,0,0
교육기관,교육부,경북하이텍고등학교,교육부 경상북도교육청 경북하이텍고등학교,14,14,0,14,11,1,1,1
교육기관,교육부,경북항공고등학교,교육부 경상북도교육청 경북항공고등학교,138,138,0,138,0,138,0,0
교육기관,교육부,경산과학고등학교,교육부 경상북도교육청 경산과학고등학교,69,69,0,69,0,69,0,0
교육기관,교육부,경산여자고등학교,교육부 경상북도교육청 경산여자고등학교,51,51,0,51,0,51,0,0
교육기관,교육부,경산자인학교,교육부 경상북도교육청 경산자인학교,50,50,0,50,15,35,0,0
교육기관,교육부,경산제일고등학교,교육부 경상북도교육청 경산제일고등학교,36,36,0,36,18,18,0,0
교육기관,교육부,경상북도경산교육지원청,교육부 경상북도교육청 경상북도경산교육지원청,19,19,0,19,4,15,0,0
교육기관,교육부,경북체육중학교,교육부 경상북도교육청 경상북도경산교육지원청 경북체육중학교,114,114,0,114,90,24,0,0
교육기관,교육부,경산동부초등학교,교육부 경상북도교육청 경상북도경산교육지원청 경산동부초등학교,19,19,0,19,2,10,3,4
교육기관,교육부,경산서부초등학교,교육부 경상북도교육청 경상북도경산교육지원청 경산서부초등학교,26,26,0,26,13,13,0,0
교육기관,교육부,경산압량초등학교,교육부 경상북도교육청 경상북도경산교육지원청 경산압량초등학교,53,53,0,53,53,0,0,0
교육기관,교육부,경산유치원,교육부 경상북도교육청 경상북도경산교육지원청 경산유치원,24,6,18,6,6,0,0,0
교육기관,교육부,경산중학교,교육부 경상북도교육청 경상북도경산교육지원청 경산중학교,34,34,0,34,34,0,0,0
교육기관,교육부,경산초등학교,교육부 경상북도교육청 경상북도경산교육지원청 경산초등학교,23,23,0,23,9,14,0,0
교육기관,교육부,경상북도교육청남부메이커교육센터,교육부 경상북도교육청 경상북도경산교육지원청 경상북도교육청남부메이커교육센터,52,52,0,52,0,52,0,0
교육기관,교육부,계당초등학교,교육부 경상북도교육청 경상북도경산교육지원청 계당초등학교,12,12,0,12,12,0,0,0
교육기관,교육부,금락초등학교,교육부 경상북도교육청 경상북도경산교육지원청 금락초등학교,23,23,0,23,21,2,0,0
교육기관,교육부,남산초등학교,교육부 경상북도교육청 경상북도경산교육지원청 남산초등학교,8,8,0,8,5,3,0,0
교육기관,교육부,남성초등학교,교육부 경상북도교육청 경상북도경산교육지원청 남성초등학교,16,16,0,16,0,16,0,0
교육기관,교육부,남천초등학교,교육부 경상북도교육청 경상북도경산교육지원청 남천초등학교,16,16,0,16,16,0,0,0
교육기관,교육부,다문초등학교,교육부 경상북도교육청 경상북도경산교육지원청 다문초등학교,12,9,3,9,5,2,1,1
교육기관,교육부,대구가톨릭대학교사범대학부속무학중학교,교육부 경상북도교육청 경상북도경산교육지원청 대구가톨릭대학교사범대학부속무학중학교,46,44,2,44,44,0,0,0
교육기관,교육부,대동초등학교,교육부 경상북도교육청 경상북도경산교육지원청 대동초등학교,13,13,0,13,0,13,0,0
교육기관,교육부,문명중학교,교육부 경상북도교육청 경상북도경산교육지원청 문명중학교,30,30,0,30,30,0,0,0
교육기관,교육부,봉황초등학교,교육부 경상북도교육청 경상북도경산교육지원청 봉황초등학교,23,23,0,23,23,0,0,0
교육기관,교육부,부림초등학교,교육부 경상북도교육청 경상북도경산교육지원청 부림초등학교,19,19,0,19,0,19,0,0
교육기관,교육부,사동중학교,교육부 경상북도교육청 경상북도경산교육지원청 사동중학교,48,48,0,48,48,0,0,0
교육기관,교육부,사동초등학교,교육부 경상북도교육청 경상북도경산교육지원청 사동초등학교,16,16,0,16,16,0,0,0
교육기관,교육부,삼성현중학교,교육부 경상북도교육청 경상북도경산교육지원청 삼성현중학교,29,29,0,29,23,6,0,0
교육기관,교육부,삼성현초등학교,교육부 경상북도교육청 경상북도경산교육지원청 삼성현초등학교,18,18,0,18,18,0,0,0
교육기관,교육부,성암초등학교,교육부 경상북도교육청 경상북도경산교육지원청 성암초등학교,32,32,0,32,16,16,0,0
교육기관,교육부,신상중학교,교육부 경상북도교육청 경상북도경산교육지원청 신상중학교,37,37,0,37,37,0,0,0
교육기관,교육부,압량중학교,교육부 경상북도교육청 경상북도경산교육지원청 압량중학교,32,32,0,32,18,12,2,0
교육기관,교육부,옥곡초등학교,교육부 경상북도교육청 경상북도경산교육지원청 옥곡초등학교,25,25,0,25,20,5,0,0
교육기관,교육부,와촌초등학교,교육부 경상북도교육청 경상북도경산교육지원청 와촌초등학교,12,12,0,12,6,6,0,0
교육기관,교육부,용성중학교,교육부 경상북도교육청 경상북도경산교육지원청 용성중학교,8,8,0,8,3,3,1,1
교육기관,교육부,용성초등학교,교육부 경상북도교육청 경상북도경산교육지원청 용성초등학교,14,14,0,14,14,0,0,0
교육기관,교육부,임당초등학교,교육부 경상북도교육청 경상북도경산교육지원청 임당초등학교,22,22,0,22,18,4,0,0
교육기관,교육부,자인중학교,교육부 경상북도교육청 경상북도경산교육지원청 자인중학교,6,6,0,6,0,6,0,0
교육기관,교육부,장산중학교,교육부 경상북도교육청 경상북도경산교육지원청 장산중학교,26,26,0,26,26,0,0,0
교육기관,교육부,장산초등학교,교육부 경상북도교육청 경상북도경산교육지원청 장산초등학교,15,15,0,15,15,0,0,0
교육기관,교육부,정평초등학교,교육부 경상북도교육청 경상북도경산교육지원청 정평초등학교,24,24,0,24,24,0,0,0
교육기관,교육부,진량중학교,교육부 경상북도교육청 경상북도경산교육지원청 진량중학교,53,53,0,53,36,17,0,0
교육기관,교육부,진량초등학교,교육부 경상북도교육청 경상북도경산교육지원청 진량초등학교,15,15,0,15,15,0,0,0
교육기관,교육부,진성초등학교,교육부 경상북도교육청 경상북도경산교육지원청 진성초등학교,13,13,0,13,13,0,0,0
교육기관,교육부,청천초등학교,교육부 경상북도교육청 경상북도경산교육지원청 청천초등학교,12,12,0,12,12,0,0,0
교육기관,교육부,평산초등학교,교육부 경상북도교육청 경상북도경산교육지원청 평산초등학교,38,38,0,38,0,38,0,0
교육기관,교육부,하양여자중학교,교육부 경상북도교육청 경상북도경산교육지원청 하양여자중학교,25,25,0,25,17,8,0,0
교육기관,교육부,하양초등학교,교육부 경상북도교육청 경상북도경산교육지원청 하양초등학교,19,19,0,19,19,0,0,0
교육기관,교육부,하주초등학교,교육부 경상북도교육청 경상북도경산교육지원청 하주초등학교,33,33,0,33,6,27,0,0
교육기관,교육부,현흥초등학교,교육부 경상북도교육청 경상북도경산교육지원청 현흥초등학교,15,15,0,15,9,6,0,0
교육기관,교육부,경상북도경주교육지원청,교육부 경상북도교육청 경상북도경주교육지원청,9,9,0,9,0,9,0,0
교육기관,교육부,감포중학교,교육부 경상북도교육청 경상북도경주교육지원청 감포중학교,18,18,0,18,18,0,0,0
교육기관,교육부,감포초등학교,교육부 경상북도교육청 경상북도경주교육지원청 감포초등학교,20,20,0,20,16,2,0,2
교육기관,교육부,강동초등학교,교육부 경상북도교육청 경상북도경주교육지원청 강동초등학교,14,14,0,14,14,0,0,0
교육기관,교육부,건천초등학교,교육부 경상북도교육청 경상북도경주교육지원청 건천초등학교,19,19,0,19,19,0,0,0
교육기관,교육부,경상북도교육청경주안전체험관,교육부 경상북도교육청 경상북도경주교육지원청 경상북도교육청경주안전체험관,42,42,0,42,0,42,0,0
교육기관,교육부,경상북도교육청경주한국어교육센터,교육부 경상북도교육청 경상북도경주교육지원청 경상북도교육청경주한국어교육센터,17,17,0,17,6,6,5,0
교육기관,교육부,경상북도교육청외동도서관,교육부 경상북도교육청 경상북도경주교육지원청 경상북도교육청외동도서관,12,12,0,12,0,12,0,0
교육기관,교육부,경주여자중학교,교육부 경상북도교육청 경상북도경주교육지원청 경주여자중학교,22,22,0,22,20,2,0,0
교육기관,교육부,경주중학교,교육부 경상북도교육청 경상북도경주교육지원청 경주중학교,38,38,0,38,0,38,0,0
교육기관,교육부,경주초등학교,교육부 경상북도교육청 경상북도경주교육지원청 경주초등학교,16,16,0,16,16,0,0,0
교육기관,교육부,계림중학교,교육부 경상북도교육청 경상북도경주교육지원청 계림중학교,48,48,0,48,14,34,0,0
교육기관,교육부,근화여자중학교,교육부 경상북도교육청 경상북도경주교육지원청 근화여자중학교,31,31,0,31,0,31,0,0
교육기관,교육부,금장초등학교,교육부 경상북도교육청 경상북도경주교육지원청 금장초등학교,11,11,0,11,11,0,0,0
교육기관,교육부,나산초등학교,교육부 경상북도교육청 경상북도경주교육지원청 나산초등학교,16,16,0,16,16,0,0,0
교육기관,교육부,나원초등학교,교육부 경상북도교육청 경상북도경주교육지원청 나원초등학교,18,18,0,18,18,0,0,0
교육기관,교육부,내남초등학교,교육부 경상북도교육청 경상북도경주교육지원청 내남초등학교,8,8,0,8,8,0,0,0
교육기관,교육부,동방초등학교,교육부 경상북도교육청 경상북도경주교육지원청 동방초등학교,23,23,0,23,18,5,0,0
교육기관,교육부,동천초등학교,교육부 경상북도교육청 경상북도경주교육지원청 동천초등학교,16,16,0,16,11,5,0,0
교육기관,교육부,모량초등학교,교육부 경상북도교육청 경상북도경주교육지원청 모량초등학교,17,17,0,17,5,12,0,0
교육기관,교육부,모아초등학교,교육부 경상북도교육청 경상북도경주교육지원청 모아초등학교,13,13,0,13,3,10,0,0
교육기관,교육부,모화초등학교,교육부 경상북도교육청 경상북도경주교육지원청 모화초등학교,18,18,0,18,18,0,0,0
교육기관,교육부,무산중학교,교육부 경상북도교육청 경상북도경주교육지원청 무산중학교,23,23,0,23,15,8,0,0
교육기관,교육부,문화중학교,교육부 경상북도교육청 경상북도경주교육지원청 문화중학교,40,40,0,40,40,0,0,0
교육기관,교육부,불국사초등학교,교육부 경상북도교육청 경상북도경주교육지원청 불국사초등학교,12,12,0,12,9,3,0,0
교육기관,교육부,불국중학교,교육부 경상북도교육청 경상북도경주교육지원청 불국중학교,20,20,0,20,15,5,0,0
교육기관,교육부,사방초등학교,교육부 경상북도교육청 경상북도경주교육지원청 사방초등학교,11,11,0,11,11,0,0,0
교육기관,교육부,산내중학교,교육부 경상북도교육청 경상북도경주교육지원청 산내중학교,14,14,0,14,10,4,0,0
교육기관,교육부,산대초등학교,교육부 경상북도교육청 경상북도경주교육지원청 산대초등학교,14,14,0,14,14,0,0,0
교육기관,교육부,서라벌여자중학교,교육부 경상북도교육청 경상북도경주교육지원청 서라벌여자중학교,33,33,0,33,10,23,0,0
교육기관,교육부,서라벌초등학교,교육부 경상북도교육청 경상북도경주교육지원청 서라벌초등학교,7,7,0,7,7,0,0,0
교육기관,교육부,석계초등학교,교육부 경상북도교육청 경상북도경주교육지원청 석계초등학교,9,9,0,9,0,9,0,0
교육기관,교육부,신라중학교,교육부 경상북도교육청 경상북도경주교육지원청 신라중학교,45,45,0,45,20,25,0,0
교육기관,교육부,신라초등학교,교육부 경상북도교육청 경상북도경주교육지원청 신라초등학교,20,20,0,20,20,0,0,0
교육기관,교육부,아화중학교,교육부 경상북도교육청 경상북도경주교육지원청 아화중학교,8,8,0,8,0,8,0,0
교육기관,교육부,아화초등학교,교육부 경상북도교육청 경상북도경주교육지원청 아화초등학교,16,16,0,16,14,2,0,0
교육기관,교육부,안강여자중학교,교육부 경상북도교육청 경상북도경주교육지원청 안강여자중학교,16,16,0,16,8,8,0,0
교육기관,교육부,안강초등학교,교육부 경상북도교육청 경상북도경주교육지원청 안강초등학교,13,13,0,13,0,13,0,0
교육기관,교육부,양남중학교,교육부 경상북도교육청 경상북도경주교육지원청 양남중학교,16,12,4,12,7,5,0,0
교육기관,교육부,양남초등학교,교육부 경상북도교육청 경상북도경주교육지원청 양남초등학교,12,12,0,12,12,0,0,0
교육기관,교육부,양동초등학교,교육부 경상북도교육청 경상북도경주교육지원청 양동초등학교,10,10,0,10,10,0,0,0
교육기관,교육부,양북중학교,교육부 경상북도교육청 경상북도경주교육지원청 양북중학교,18,18,0,18,5,13,0,0
교육기관,교육부,양북초등학교,교육부 경상북도교육청 경상북도경주교육지원청 양북초등학교,19,19,0,19,5,14,0,0
교육기관,교육부,연안초등학교,교육부 경상북도교육청 경상북도경주교육지원청 연안초등학교,12,12,0,12,12,0,0,0
교육기관,교육부,영지초등학교,교육부 경상북도교육청 경상북도경주교육지원청 영지초등학교,8,8,0,8,8,0,0,0
교육기관,교육부,옥산초등학교,교육부 경상북도교육청 경상북도경주교육지원청 옥산초등학교,14,14,0,14,14,0,0,0
교육기관,교육부,외동중학교,교육부 경상북도교육청 경상북도경주교육지원청 외동중학교,34,33,1,33,24,9,0,0
교육기관,교육부,용강초등학교,교육부 경상북도교육청 경상북도경주교육지원청 용강초등학교,22,22,0,22,22,0,0,0
교육기관,교육부,용황유치원,교육부 경상북도교육청 경상북도경주교육지원청 용황유치원,24,24,0,24,24,0,0,0
교육기관,교육부,월성중학교,교육부 경상북도교육청 경상북도경주교육지원청 월성중학교,36,36,0,36,18,18,0,0
교육기관,교육부,월성초등학교,교육부 경상북도교육청 경상북도경주교육지원청 월성초등학교,20,20,0,20,0,20,0,0
교육기관,교육부,의곡초등학교,교육부 경상북도교육청 경상북도경주교육지원청 의곡초등학교,16,16,0,16,0,16,0,0
교육기관,교육부,입실초등학교,교육부 경상북도교육청 경상북도경주교육지원청 입실초등학교,34,34,0,34,34,0,0,0
교육기관,교육부,천북초등학교,교육부 경상북도교육청 경상북도경주교육지원청 천북초등학교,23,23,0,23,12,11,0,0
교육기관,교육부,천포초등학교,교육부 경상북도교육청 경상북도경주교육지원청 천포초등학교,14,14,0,14,10,3,1,0
교육기관,교육부,현곡초등학교,교육부 경상북도교육청 경상북도경주교육지원청 현곡초등학교,22,22,0,22,0,22,0,0
교육기관,교육부,화랑중학교,교육부 경상북도교육청 경상북도경주교육지원청 화랑중학교,51,51,0,51,42,9,0,0
교육기관,교육부,화랑초등학교,교육부 경상북도교육청 경상북도경주교육지원청 화랑초등학교,12,10,2,10,6,2,1,1
교육기관,교육부,황남초등학교,교육부 경상북도교육청 경상북도경주교육지원청 황남초등학교,60,60,0,60,30,30,0,0
교육기관,교육부,황성초등학교,교육부 경상북도교육청 경상북도경주교육지원청 황성초등학교,25,25,0,25,25,0,0,0
교육기관,교육부,흥무초등학교,교육부 경상북도교육청 경상북도경주교육지원청 흥무초등학교,30,30,0,30,30,0,0,0
교육기관,교육부,경상북도고령교육지원청,교육부 경상북도교육청 경상북도고령교육지원청,18,18,0,18,0,18,0,0
교육기관,교육부,개진초등학교,교육부 경상북도교육청 경상북도고령교육지원청 개진초등학교,13,13,0,13,7,6,0,0
교육기관,교육부,고령중학교,교육부 경상북도교육청 경상북도고령교육지원청 고령중학교,32,32,0,32,8,22,2,0
교육기관,교육부,고령중학교개진분교장,교육부 경상북도교육청 경상북도고령교육지원청 고령중학교개진분교장,4,4,0,4,4,0,0,0
교육기관,교육부,고령초등학교,교육부 경상북도교육청 경상북도고령교육지원청 고령초등학교,15,15,0,15,15,0,0,0
교육기관,교육부,다산중학교,교육부 경상북도교육청 경상북도고령교육지원청 다산중학교,20,20,0,20,20,0,0,0
교육기관,교육부,다산초등학교,교육부 경상북도교육청 경상북도고령교육지원청 다산초등학교,20,20,0,20,0,20,0,0
교육기관,교육부,덕곡초등학교,교육부 경상북도교육청 경상북도고령교육지원청 덕곡초등학교,11,11,0,11,9,2,0,0
교육기관,교육부,박곡초등학교,교육부 경상북도교육청 경상북도고령교육지원청 박곡초등학교,16,16,0,16,8,8,0,0
교육기관,교육부,성산중학교,교육부 경상북도교육청 경상북도고령교육지원청 성산중학교,15,15,0,15,7,8,0,0
교육기관,교육부,성산초등학교,교육부 경상북도교육청 경상북도고령교육지원청 성산초등학교,16,16,0,16,16,0,0,0
교육기관,교육부,쌍림중학교,교육부 경상북도교육청 경상북도고령교육지원청 쌍림중학교,15,15,0,15,12,1,1,1
교육기관,교육부,쌍림초등학교,교육부 경상북도교육청 경상북도고령교육지원청 쌍림초등학교,13,13,0,13,13,0,0,0
교육기관,교육부,우곡중학교,교육부 경상북도교육청 경상북도고령교육지원청 우곡중학교,7,7,0,7,5,2,0,0
교육기관,교육부,우곡초등학교,교육부 경상북도교육청 경상북도고령교육지원청 우곡초등학교,11,11,0,11,11,0,0,0
교육기관,교육부,운수초등학교,교육부 경상북도교육청 경상북도고령교육지원청 운수초등학교,14,14,0,14,10,4,0,0
교육기관,교육부,경상북도교육청과학원,교육부 경상북도교육청 경상북도교육청과학원,42,42,0,42,0,42,0,0
교육기관,교육부,경상북도교육청메이커교육관,교육부 경상북도교육청 경상북도교육청과학원 경상북도교육청메이커교육관,11,11,0,11,0,11,0,0
교육기관,교육부,경상북도교육청발명체험교육관,교육부 경상북도교육청 경상북도교육청과학원 경상북도교육청발명체험교육관,36,36,0,36,0,36,0,0
교육기관,교육부,경상북도교육청구미도서관,교육부 경상북도교육청 경상북도교육청구미도서관,50,50,0,50,0,50,0,0
교육기관,교육부,경상북도교육청문화원,교육부 경상북도교육청 경상북도교육청문화원,76,76,0,76,0,76,0,0
교육기관,교육부,경상북도교육청상주도서관,교육부 경상북도교육청 경상북도교육청상주도서관,30,30,0,30,30,0,0,0
교육기관,교육부,화령분관,교육부 경상북도교육청 경상북도교육청상주도서관 화령분관,11,11,0,11,0,11,0,0
교육기관,교육부,경상북도교육청안동도서관,교육부 경상북도교육청 경상북도교육청안동도서관,94,94,0,94,79,15,0,0
교육기관,교육부,경상북도교육청연구원,교육부 경상북도교육청 경상북도교육청연구원,44,28,16,28,0,28,0,0
교육기관,교육부,경상북도교육청연수원,교육부 경상북도교육청 경상북도교육청연수원,21,19,2,19,0,19,0,0
교육기관,교육부,경상북도교육청영주선비도서관,교육부 경상북도교육청 경상북도교육청영주선비도서관,72,72,0,72,0,72,0,0
교육기관,교육부,경상북도교육청정보센터,교육부 경상북도교육청 경상북도교육청정보센터,64,53,11,53,23,30,0,0
교육기관,교육부,경상북도구미교육지원청,교육부 경상북도교육청 경상북도구미교육지원청,13,13,0,13,0,13,0,0
교육기관,교육부,고아초등학교,교육부 경상북도교육청 경상북도구미교육지원청 고아초등학교,14,14,0,14,14,0,0,0
교육기관,교육부,광평중학교,교육부 경상북도교육청 경상북도구미교육지원청 광평중학교,55,55,0,55,18,37,0,0
교육기관,교육부,구미문성초등학교,교육부 경상북도교육청 경상북도구미교육지원청 구미문성초등학교,52,52,0,52,0,52,0,0
교육기관,교육부,구미봉곡초등학교,교육부 경상북도교육청 경상북도구미교육지원청 구미봉곡초등학교,23,23,0,23,15,8,0,0
교육기관,교육부,구미사곡초등학교,교육부 경상북도교육청 경상북도구미교육지원청 구미사곡초등학교,11,11,0,11,11,0,0,0
교육기관,교육부,구미신당초등학교,교육부 경상북도교육청 경상북도구미교육지원청 구미신당초등학교,69,69,0,69,0,69,0,0
교육기관,교육부,구미신평중학교,교육부 경상북도교육청 경상북도구미교육지원청 구미신평중학교,25,25,0,25,10,15,0,0
교육기관,교육부,구미여자중학교,교육부 경상북도교육청 경상북도구미교육지원청 구미여자중학교,17,17,0,17,2,13,1,1
교육기관,교육부,구미오산초등학교,교육부 경상북도교육청 경상북도구미교육지원청 구미오산초등학교,16,16,0,16,16,0,0,0
교육기관,교육부,구미왕산초등학교,교육부 경상북도교육청 경상북도구미교육지원청 구미왕산초등학교,18,18,0,18,18,0,0,0
교육기관,교육부,구미인덕중학교,교육부 경상북도교육청 경상북도구미교육지원청 구미인덕중학교,52,52,0,52,0,52,0,0
교육기관,교육부,구미인덕초등학교,교육부 경상북도교육청 경상북도구미교육지원청 구미인덕초등학교,74,74,0,74,74,0,0,0
교육기관,교육부,구미중학교,교육부 경상북도교육청 경상북도구미교육지원청 구미중학교,15,14,1,14,3,11,0,0
교육기관,교육부,구운초등학교,교육부 경상북도교육청 경상북도구미교육지원청 구운초등학교,10,10,0,10,10,0,0,0
교육기관,교육부,구평남부초등학교,교육부 경상북도교육청 경상북도구미교육지원청 구평남부초등학교,37,37,0,37,37,0,0,0
교육기관,교육부,구평초등학교,교육부 경상북도교육청 경상북도구미교육지원청 구평초등학교,16,16,0,16,8,6,2,0
교육기관,교육부,금오중학교,교육부 경상북도교육청 경상북도구미교육지원청 금오중학교,27,27,0,27,27,0,0,0
교육기관,교육부,금오초등학교,교육부 경상북도교육청 경상북도구미교육지원청 금오초등학교,32,32,0,32,32,0,0,0
교육기관,교육부,남계초등학교,교육부 경상북도교육청 경상북도구미교육지원청 남계초등학교,10,10,0,10,10,0,0,0
교육기관,교육부,덕촌초등학교,교육부 경상북도교육청 경상북도구미교육지원청 덕촌초등학교,5,5,0,5,5,0,0,0
교육기관,교육부,도량초등학교,교육부 경상북도교육청 경상북도구미교육지원청 도량초등학교,29,29,0,29,29,0,0,0
교육기관,교육부,도봉초등학교,교육부 경상북도교육청 경상북도구미교육지원청 도봉초등학교,24,24,0,24,0,24,0,0
교육기관,교육부,도산유치원,교육부 경상북도교육청 경상북도구미교육지원청 도산유치원,16,16,0,16,3,13,0,0
교육기관,교육부,도산초등학교,교육부 경상북도교육청 경상북도구미교육지원청 도산초등학교,10,10,0,10,10,0,0,0
교육기관,교육부,도송중학교,교육부 경상북도교육청 경상북도구미교육지원청 도송중학교,46,46,0,46,20,26,0,0
교육기관,교육부,무을중학교,교육부 경상북도교육청 경상북도구미교육지원청 무을중학교,10,7,3,7,4,1,1,1
교육기관,교육부,무을초등학교,교육부 경상북도교육청 경상북도구미교육지원청 무을초등학교,8,8,0,8,8,0,0,0
교육기관,교육부,문장초등학교,교육부 경상북도교육청 경상북도구미교육지원청 문장초등학교,9,9,0,9,6,3,0,0
교육기관,교육부,봉곡중학교,교육부 경상북도교육청 경상북도구미교육지원청 봉곡중학교,33,32,1,32,18,12,1,1
교육기관,교육부,브니엘유치원,교육부 경상북도교육청 경상북도구미교육지원청 브니엘유치원,12,12,0,12,0,12,0,0
교육기관,교육부,비산초등학교,교육부 경상북도교육청 경상북도구미교육지원청 비산초등학교,26,26,0,26,26,0,0,0
교육기관,교육부,산동중학교,교육부 경상북도교육청 경상북도구미교육지원청 산동중학교,13,13,0,13,0,13,0,0
교육기관,교육부,산동초등학교,교육부 경상북도교육청 경상북도구미교육지원청 산동초등학교,18,18,0,18,18,0,0,0
교육기관,교육부,상모유치원,교육부 경상북도교육청 경상북도구미교육지원청 상모유치원,12,12,0,12,0,12,0,0
교육기관,교육부,상모중학교,교육부 경상북도교육청 경상북도구미교육지원청 상모중학교,19,19,0,19,0,19,0,0
교육기관,교육부,상모초등학교,교육부 경상북도교육청 경상북도구미교육지원청 상모초등학교,26,26,0,26,0,26,0,0
교육기관,교육부,선산초등학교,교육부 경상북도교육청 경상북도구미교육지원청 선산초등학교,21,20,1,20,20,0,0,0
교육기관,교육부,선주중학교,교육부 경상북도교육청 경상북도구미교육지원청 선주중학교,22,22,0,22,8,14,0,0
교육기관,교육부,선주초등학교,교육부 경상북도교육청 경상북도구미교육지원청 선주초등학교,20,20,0,20,20,0,0,0
교육기관,교육부,송정여자중학교,교육부 경상북도교육청 경상북도구미교육지원청 송정여자중학교,18,18,0,18,18,0,0,0
교육기관,교육부,송정초등학교,교육부 경상북도교육청 경상북도구미교육지원청 송정초등학교,15,15,0,15,15,0,0,0
교육기관,교육부,신기초등학교,교육부 경상북도교육청 경상북도구미교육지원청 신기초등학교,8,8,0,8,4,4,0,0
교육기관,교육부,양포초등학교,교육부 경상북도교육청 경상북도구미교육지원청 양포초등학교,32,32,0,32,0,32,0,0
교육기관,교육부,오상중학교,교육부 경상북도교육청 경상북도구미교육지원청 오상중학교,23,23,0,23,6,17,0,0
교육기관,교육부,오태중학교,교육부 경상북도교육청 경상북도구미교육지원청 오태중학교,46,46,0,46,46,0,0,0
교육기관,교육부,오태초등학교,교육부 경상북도교육청 경상북도구미교육지원청 오태초등학교,20,20,0,20,14,6,0,0
교육기관,교육부,옥계동부중학교,교육부 경상북도교육청 경상북도구미교육지원청 옥계동부중학교,44,43,1,43,0,43,0,0
교육기관,교육부,옥계동부초등학교,교육부 경상북도교육청 경상북도구미교육지원청 옥계동부초등학교,30,30,0,30,22,8,0,0
교육기관,교육부,옥계중학교,교육부 경상북도교육청 경상북도구미교육지원청 옥계중학교,33,15,18,15,15,0,0,0
교육기관,교육부,옥계초등학교,교육부 경상북도교육청 경상북도구미교육지원청 옥계초등학교,23,23,0,23,20,3,0,0
교육기관,교육부,옥성초등학교,교육부 경상북도교육청 경상북도구미교육지원청 옥성초등학교,8,8,0,8,8,0,0,0
교육기관,교육부,원남초등학교,교육부 경상북도교육청 경상북도구미교육지원청 원남초등학교,14,14,0,14,7,7,0,0
교육기관,교육부,원호초등학교,교육부 경상북도교육청 경상북도구미교육지원청 원호초등학교,20,20,0,20,20,0,0,0
교육기관,교육부,인동중학교,교육부 경상북도교육청 경상북도구미교육지원청 인동중학교,26,26,0,26,11,15,0,0
교육기관,교육부,인동초등학교,교육부 경상북도교육청 경상북도구미교육지원청 인동초등학교,26,26,0,26,26,0,0,0
교육기관,교육부,인의초등학교,교육부 경상북도교육청 경상북도구미교육지원청 인의초등학교,23,23,0,23,15,8,0,0
교육기관,교육부,장천초등학교,교육부 경상북도교육청 경상북도구미교육지원청 장천초등학교,12,12,0,12,7,5,0,0
교육기관,교육부,정수초등학교,교육부 경상북도교육청 경상북도구미교육지원청 정수초등학교,19,19,0,19,0,19,0,0
교육기관,교육부,지산초등학교,교육부 경상북도교육청 경상북도구미교육지원청 지산초등학교,4,4,0,4,4,0,0,0
교육기관,교육부,진평중학교,교육부 경상북도교육청 경상북도구미교육지원청 진평중학교,42,41,1,41,0,41,0,0
교육기관,교육부,진평초등학교,교육부 경상북도교육청 경상북도구미교육지원청 진평초등학교,28,28,0,28,28,0,0,0
교육기관,교육부,천생중학교,교육부 경상북도교육청 경상북도구미교육지원청 천생중학교,32,30,2,30,29,1,0,0
교육기관,교육부,해마루초등학교,교육부 경상북도교육청 경상북도구미교육지원청 해마루초등학교,51,17,34,17,16,1,0,0
교육기관,교육부,해평중학교,교육부 경상북도교육청 경상북도구미교육지원청 해평중학교,20,20,0,20,0,20,0,0
교육기관,교육부,해평초등학교,교육부 경상북도교육청 경상북도구미교육지원청 해평초등학교,13,13,0,13,11,2,0,0
교육기관,교육부,현일중학교,교육부 경상북도교육청 경상북도구미교육지원청 현일중학교,26,26,0,26,26,0,0,0
교육기관,교육부,형곡중학교,교육부 경상북도교육청 경상북도구미교육지원청 형곡중학교,53,51,2,51,28,23,0,0
교육기관,교육부,형곡초등학교,교육부 경상북도교육청 경상북도구미교육지원청 형곡초등학교,15,15,0,15,15,0,0,0
교육기관,교육부,형남중학교,교육부 경상북도교육청 경상북도구미교육지원청 형남중학교,32,32,0,32,32,0,0,0
교육기관,교육부,형일초등학교,교육부 경상북도교육청 경상북도구미교육지원청 형일초등학교,33,33,0,33,33,0,0,0
교육기관,교육부,황상초등학교,교육부 경상북도교육청 경상북도구미교육지원청 황상초등학교,14,14,0,14,7,7,0,0
교육기관,교육부,경상북도군위교육지원청,교육부 경상북도교육청 경상북도군위교육지원청,11,10,1,10,0,10,0,0
교육기관,교육부,고매초등학교,교육부 경상북도교육청 경상북도군위교육지원청 고매초등학교,9,9,0,9,9,0,0,0
교육기관,교육부,군위중학교,교육부 경상북도교육청 경상북도군위교육지원청 군위중학교,8,8,0,8,8,0,0,0
교육기관,교육부,군위중학교우보분교장,교육부 경상북도교육청 경상북도군위교육지원청 군위중학교우보분교장,10,10,0,10,10,0,0,0
교육기관,교육부,군위초등학교,교육부 경상북도교육청 경상북도군위교육지원청 군위초등학교,14,14,0,14,4,10,0,0
교육기관,교육부,부계중학교,교육부 경상북도교육청 경상북도군위교육지원청 부계중학교,13,13,0,13,6,7,0,0
교육기관,교육부,부계초등학교,교육부 경상북도교육청 경상북도군위교육지원청 부계초등학교,9,9,0,9,9,0,0,0
교육기관,교육부,삼국유사군위도서관,교육부 경상북도교육청 경상북도군위교육지원청 삼국유사군위도서관,24,24,0,24,0,24,0,0
교육기관,교육부,송원초등학교,교육부 경상북도교육청 경상북도군위교육지원청 송원초등학교,8,8,0,8,8,0,0,0
교육기관,교육부,우보초등학교,교육부 경상북도교육청 경상북도군위교육지원청 우보초등학교,13,13,0,13,13,0,0,0
교육기관,교육부,의흥중학교,교육부 경상북도교육청 경상북도군위교육지원청 의흥중학교,18,18,0,18,18,0,0,0
교육기관,교육부,의흥초등학교,교육부 경상북도교육청 경상북도군위교육지원청 의흥초등학교,21,21,0,21,10,11,0,0
교육기관,교육부,효령초등학교,교육부 경상북도교육청 경상북도군위교육지원청 효령초등학교,8,8,0,8,8,0,0,0
교육기관,교육부,경상북도김천교육지원청,교육부 경상북도교육청 경상북도김천교육지원청,11,11,0,11,11,0,0,0
교육기관,교육부,감문중학교,교육부 경상북도교육청 경상북도김천교육지원청 감문중학교,15,15,0,15,8,7,0,0
교육기관,교육부,감천초등학교,교육부 경상북도교육청 경상북도김천교육지원청 감천초등학교,20,20,0,20,0,20,0,0
교육기관,교육부,개령서부초등학교,교육부 경상북도교육청 경상북도김천교육지원청 개령서부초등학교,14,14,0,14,8,6,0,0
교육기관,교육부,개령중학교,교육부 경상북도교육청 경상북도김천교육지원청 개령중학교,9,9,0,9,9,0,0,0
교육기관,교육부,개령초등학교,교육부 경상북도교육청 경상북도김천교육지원청 개령초등학교,12,12,0,12,12,0,0,0
교육기관,교육부,구성초등학교,교육부 경상북도교육청 경상북도김천교육지원청 구성초등학교,11,11,0,11,0,11,0,0
교육기관,교육부,금릉초등학교,교육부 경상북도교육청 경상북도김천교육지원청 금릉초등학교,14,14,0,14,14,0,0,0
교육기관,교육부,김천다수초등학교,교육부 경상북도교육청 경상북도김천교육지원청 김천다수초등학교,16,16,0,16,16,0,0,0
교육기관,교육부,김천동부초등학교,교육부 경상북도교육청 경상북도김천교육지원청 김천동부초등학교,16,16,0,16,16,0,0,0
교육기관,교육부,김천동신초등학교,교육부 경상북도교육청 경상북도김천교육지원청 김천동신초등학교,34,34,0,34,34,0,0,0
교육기관,교육부,김천모암초등학교,교육부 경상북도교육청 경상북도김천교육지원청 김천모암초등학교,18,18,0,18,18,0,0,0
교육기관,교육부,김천부곡초등학교,교육부 경상북도교육청 경상북도김천교육지원청 김천부곡초등학교,18,18,0,18,0,18,0,0
교육기관,교육부,김천서부초등학교,교육부 경상북도교육청 경상북도김천교육지원청 김천서부초등학교,17,17,0,17,16,1,0,0
교육기관,교육부,김천석천중학교,교육부 경상북도교육청 경상북도김천교육지원청 김천석천중학교,24,24,0,24,24,0,0,0
교육기관,교육부,김천신일초등학교,교육부 경상북도교육청 경상북도김천교육지원청 김천신일초등학교,32,32,0,32,13,19,0,0
교육기관,교육부,김천여자중학교,교육부 경상북도교육청 경상북도김천교육지원청 김천여자중학교,34,32,2,32,2,30,0,0
교육기관,교육부,김천유치원,교육부 경상북도교육청 경상북도김천교육지원청 김천유치원,13,13,0,13,10,3,0,0
교육기관,교육부,김천중앙중학교,교육부 경상북도교육청 경상북도김천교육지원청 김천중앙중학교,31,31,0,31,31,0,0,0
교육기관,교육부,김천중앙초등학교,교육부 경상북도교육청 경상북도김천교육지원청 김천중앙초등학교,14,14,0,14,0,14,0,0
교육기관,교육부,김천초등학교,교육부 경상북도교육청 경상북도김천교육지원청 김천초등학교,22,22,0,22,5,16,1,0
교육기관,교육부,농소유치원,교육부 경상북도교육청 경상북도김천교육지원청 농소유치원,31,30,1,30,0,30,0,0
교육기관,교육부,농소초등학교,교육부 경상북도교육청 경상북도김천교육지원청 농소초등학교,37,37,0,37,37,0,0,0
교육기관,교육부,대덕초등학교,교육부 경상북도교육청 경상북도김천교육지원청 대덕초등학교,12,12,0,12,0,12,0,0
교육기관,교육부,대룡초등학교,교육부 경상북도교육청 경상북도김천교육지원청 대룡초등학교,21,21,0,21,18,1,1,1
교육기관,교육부,문성중학교,교육부 경상북도교육청 경상북도김천교육지원청 문성중학교,50,50,0,50,34,16,0,0
교육기관,교육부,봉계초등학교,교육부 경상북도교육청 경상북도김천교육지원청 봉계초등학교,22,22,0,22,18,4,0,0
교육기관,교육부,성의중학교,교육부 경상북도교육청 경상북도김천교육지원청 성의중학교,16,16,0,16,16,0,0,0
교육기관,교육부,아천초등학교,교육부 경상북도교육청 경상북도김천교육지원청 아천초등학교,10,10,0,10,6,4,0,0
교육기관,교육부,아포초등학교,교육부 경상북도교육청 경상북도김천교육지원청 아포초등학교,20,20,0,20,18,2,0,0
교육기관,교육부,어모중학교,교육부 경상북도교육청 경상북도김천교육지원청 어모중학교,18,18,0,18,10,8,0,0
교육기관,교육부,운남중학교,교육부 경상북도교육청 경상북도김천교육지원청 운남중학교,49,46,3,46,0,46,0,0
교육기관,교육부,위량초등학교,교육부 경상북도교육청 경상북도김천교육지원청 위량초등학교,8,8,0,8,3,3,1,1
교육기관,교육부,율곡유치원,교육부 경상북도교육청 경상북도김천교육지원청 율곡유치원,32,32,0,32,0,32,0,0
교육기관,교육부,율곡중학교,교육부 경상북도교육청 경상북도김천교육지원청 율곡중학교,32,32,0,32,32,0,0,0
교육기관,교육부,율곡초등학교,교육부 경상북도교육청 경상북도김천교육지원청 율곡초등학교,45,45,0,45,16,29,0,0
교육기관,교육부,율빛유치원,교육부 경상북도교육청 경상북도김천교육지원청 율빛유치원,48,48,0,48,22,26,0,0
교육기관,교육부,조마초등학교,교육부 경상북도교육청 경상북도김천교육지원청 조마초등학교,16,16,0,16,16,0,0,0
교육기관,교육부,증산초등학교,교육부 경상북도교육청 경상북도김천교육지원청 증산초등학교,12,12,0,12,0,12,0,0
교육기관,교육부,지례초등학교,교육부 경상북도교육청 경상북도김천교육지원청 지례초등학교,16,16,0,16,12,4,0,0
교육기관,교육부,지품천중학교,교육부 경상북도교육청 경상북도김천교육지원청 지품천중학교,42,42,0,42,0,42,0,0
교육기관,교육부,직지초등학교,교육부 경상북도교육청 경상북도김천교육지원청 직지초등학교,16,16,0,16,0,16,0,0
교육기관,교육부,한일여자중학교,교육부 경상북도교육청 경상북도김천교육지원청 한일여자중학교,52,52,0,52,0,52,0,0
교육기관,교육부,경상북도문경교육지원청,교육부 경상북도교육청 경상북도문경교육지원청,16,16,0,16,7,9,0,0
교육기관,교육부,가은중학교,교육부 경상북도교육청 경상북도문경교육지원청 가은중학교,10,9,1,9,9,0,0,0
교육기관,교육부,경상북도교육청점촌도서관,교육부 경상북도교육청 경상북도문경교육지원청 경상북도교육청점촌도서관,16,16,0,16,4,12,0,0
교육기관,교육부,경상북도교육청점촌도서관가은분관,교육부 경상북도교육청 경상북도문경교육지원청 경상북도교육청점촌도서관가은분관,15,15,0,15,2,13,0,0
교육기관,교육부,농암초등학교,교육부 경상북도교육청 경상북도문경교육지원청 농암초등학교,7,7,0,7,7,0,0,0
교육기관,교육부,당포초등학교,교육부 경상북도교육청 경상북도문경교육지원청 당포초등학교,14,14,0,14,14,0,0,0
교육기관,교육부,동로중학교,교육부 경상북도교육청 경상북도문경교육지원청 동로중학교,6,6,0,6,6,0,0,0
교육기관,교육부,동로초등학교,교육부 경상북도교육청 경상북도문경교육지원청 동로초등학교,5,5,0,5,5,0,0,0
교육기관,교육부,동성초등학교,교육부 경상북도교육청 경상북도문경교육지원청 동성초등학교,15,15,0,15,15,0,0,0
교육기관,교육부,마성중학교,교육부 경상북도교육청 경상북도문경교육지원청 마성중학교,5,4,1,4,2,2,0,0
교육기관,교육부,모전초등학교,교육부 경상북도교육청 경상북도문경교육지원청 모전초등학교,27,27,0,27,14,13,0,0
교육기관,교육부,문경서중학교,교육부 경상북도교육청 경상북도문경교육지원청 문경서중학교,17,16,1,16,0,16,0,0
교육기관,교육부,문경여자중학교,교육부 경상북도교육청 경상북도문경교육지원청 문경여자중학교,13,12,1,12,12,0,0,0
교육기관,교육부,문경중학교,교육부 경상북도교육청 경상북도문경교육지원청 문경중학교,13,12,1,12,12,0,0,0
교육기관,교육부,문경초등학교,교육부 경상북도교육청 경상북도문경교육지원청 문경초등학교,16,16,0,16,16,0,0,0
교육기관,교육부,산북중학교,교육부 경상북도교육청 경상북도문경교육지원청 산북중학교,18,18,0,18,18,0,0,0
교육기관,교육부,산북초등학교,교육부 경상북도교육청 경상북도문경교육지원청 산북초등학교,19,19,0,19,19,0,0,0
교육기관,교육부,산양초등학교,교육부 경상북도교육청 경상북도문경교육지원청 산양초등학교,14,14,0,14,14,0,0,0
교육기관,교육부,신기초등학교,교육부 경상북도교육청 경상북도문경교육지원청 신기초등학교,8,8,0,8,6,2,0,0
교육기관,교육부,영순초등학교,교육부 경상북도교육청 경상북도문경교육지원청 영순초등학교,18,18,0,18,18,0,0,0
교육기관,교육부,용흥초등학교,교육부 경상북도교육청 경상북도문경교육지원청 용흥초등학교,8,8,0,8,6,2,0,0
교육기관,교육부,점촌북초등학교,교육부 경상북도교육청 경상북도문경교육지원청 점촌북초등학교,15,15,0,15,0,15,0,0
교육기관,교육부,점촌중앙초등학교,교육부 경상북도교육청 경상북도문경교육지원청 점촌중앙초등학교,18,18,0,18,14,4,0,0
교육기관,교육부,점촌중학교,교육부 경상북도교육청 경상북도문경교육지원청 점촌중학교,8,8,0,8,4,4,0,0
교육기관,교육부,점촌초등학교,교육부 경상북도교육청 경상북도문경교육지원청 점촌초등학교,27,27,0,27,20,7,0,0
교육기관,교육부,호계초등학교,교육부 경상북도교육청 경상북도문경교육지원청 호계초등학교,13,13,0,13,4,9,0,0
교육기관,교육부,호서남초등학교,교육부 경상북도교육청 경상북도문경교육지원청 호서남초등학교,36,36,0,36,0,36,0,0
교육기관,교육부,경상북도봉화교육지원청,교육부 경상북도교육청 경상북도봉화교육지원청,7,7,0,7,4,3,0,0
교육기관,교육부,경상북도교육청봉화도서관,교육부 경상북도교육청 경상북도봉화교육지원청 경상북도교육청봉화도서관,16,16,0,16,0,16,0,0
교육기관,교육부,도촌초등학교,교육부 경상북도교육청 경상북도봉화교육지원청 도촌초등학교,7,7,0,7,7,0,0,0
교육기관,교육부,동양초등학교,교육부 경상북도교육청 경상북도봉화교육지원청 동양초등학교,6,6,0,6,6,0,0,0
교육기관,교육부,명호초등학교,교육부 경상북도교육청 경상북도봉화교육지원청 명호초등학교,7,7,0,7,7,0,0,0
교육기관,교육부,물야중학교,교육부 경상북도교육청 경상북도봉화교육지원청 물야중학교,6,6,0,6,2,2,1,1
교육기관,교육부,물야초등학교,교육부 경상북도교육청 경상북도봉화교육지원청 물야초등학교,6,6,0,6,6,0,0,0
교육기관,교육부,법전중앙초등학교,교육부 경상북도교육청 경상북도봉화교육지원청 법전중앙초등학교,7,7,0,7,4,3,0,0
교육기관,교육부,봉성초등학교,교육부 경상북도교육청 경상북도봉화교육지원청 봉성초등학교,5,5,0,5,5,0,0,0
교육기관,교육부,봉화중학교,교육부 경상북도교육청 경상북도봉화교육지원청 봉화중학교,29,29,0,29,0,29,0,0
교육기관,교육부,상운초등학교,교육부 경상북도교육청 경상북도봉화교육지원청 상운초등학교,8,8,0,8,0,8,0,0
교육기관,교육부,서벽초등학교,교육부 경상북도교육청 경상북도봉화교육지원청 서벽초등학교,8,8,0,8,8,0,0,0
교육기관,교육부,석포중학교,교육부 경상북도교육청 경상북도봉화교육지원청 석포중학교,11,11,0,11,9,2,0,0
교육기관,교육부,석포초등학교,교육부 경상북도교육청 경상북도봉화교육지원청 석포초등학교,11,11,0,11,5,6,0,0
교육기관,교육부,소천초등학교,교육부 경상북도교육청 경상북도봉화교육지원청 소천초등학교,8,8,0,8,8,0,0,0
교육기관,교육부,소천초등학교두음분교장,교육부 경상북도교육청 경상북도봉화교육지원청 소천초등학교두음분교장,6,6,0,6,6,0,0,0
교육기관,교육부,소천초등학교임기분교장,교육부 경상북도교육청 경상북도봉화교육지원청 소천초등학교임기분교장,6,6,0,6,6,0,0,0
교육기관,교육부,재산초등학교,교육부 경상북도교육청 경상북도봉화교육지원청 재산초등학교,9,9,0,9,9,0,0,0
교육기관,교육부,춘양중학교서벽분교장,교육부 경상북도교육청 경상북도봉화교육지원청 춘양중학교서벽분교장,7,7,0,7,7,0,0,0
교육기관,교육부,춘양초등학교,교육부 경상북도교육청 경상북도봉화교육지원청 춘양초등학교,17,17,0,17,16,1,0,0
교육기관,교육부,경상북도상주교육지원청,교육부 경상북도교육청 경상북도상주교육지원청,24,24,0,24,0,24,0,0
교육기관,교육부,경상북도교육청상주수학체험센터,교육부 경상북도교육청 경상북도상주교육지원청 경상북도교육청상주수학체험센터,22,9,13,9,0,9,0,0
교육기관,교육부,공검초등학교,교육부 경상북도교육청 경상북도상주교육지원청 공검초등학교,16,16,0,16,11,5,0,0
교육기관,교육부,낙동동부초등학교,교육부 경상북도교육청 경상북도상주교육지원청 낙동동부초등학교,11,11,0,11,6,5,0,0
교육기관,교육부,낙동중학교,교육부 경상북도교육청 경상북도상주교육지원청 낙동중학교,8,8,0,8,8,0,0,0
교육기관,교육부,낙동초등학교,교육부 경상북도교육청 경상북도상주교육지원청 낙동초등학교,11,11,0,11,11,0,0,0
교육기관,교육부,낙서초등학교,교육부 경상북도교육청 경상북도상주교육지원청 낙서초등학교,9,9,0,9,9,0,0,0
교육기관,교육부,낙운중학교,교육부 경상북도교육청 경상북도상주교육지원청 낙운중학교,12,12,0,12,9,3,0,0
교육기관,교육부,남산중학교,교육부 경상북도교육청 경상북도상주교육지원청 남산중학교,27,27,0,27,23,4,0,0
교육기관,교육부,모동초등학교,교육부 경상북도교육청 경상북도상주교육지원청 모동초등학교,24,24,0,24,0,24,0,0
교육기관,교육부,모서중학교,교육부 경상북도교육청 경상북도상주교육지원청 모서중학교,15,15,0,15,9,6,0,0
교육기관,교육부,모서초등학교,교육부 경상북도교육청 경상북도상주교육지원청 모서초등학교,10,10,0,10,5,5,0,0
교육기관,교육부,백원초등학교,교육부 경상북도교육청 경상북도상주교육지원청 백원초등학교,7,7,0,7,3,4,0,0
교육기관,교육부,사벌초등학교,교육부 경상북도교육청 경상북도상주교육지원청 사벌초등학교,10,10,0,10,10,0,0,0
교육기관,교육부,상산초등학교,교육부 경상북도교육청 경상북도상주교육지원청 상산초등학교,19,19,0,19,19,0,0,0
교육기관,교육부,상영초등학교,교육부 경상북도교육청 경상북도상주교육지원청 상영초등학교,17,17,0,17,13,4,0,0
교육기관,교육부,상주감꽃유치원,교육부 경상북도교육청 경상북도상주교육지원청 상주감꽃유치원,24,10,14,10,0,10,0,0
교육기관,교육부,상주동부초등학교,교육부 경상북도교육청 경상북도상주교육지원청 상주동부초등학교,16,16,0,16,16,0,0,0
교육기관,교육부,상주중학교,교육부 경상북도교육청 경상북도상주교육지원청 상주중학교,63,63,0,63,33,28,2,0
교육기관,교육부,상주초등학교,교육부 경상북도교육청 경상북도상주교육지원청 상주초등학교,24,24,0,24,23,0,1,0
교육기관,교육부,성동초등학교,교육부 경상북도교육청 경상북도상주교육지원청 성동초등학교,29,29,0,29,29,0,0,0
교육기관,교육부,옥산초등학교,교육부 경상북도교육청 경상북도상주교육지원청 옥산초등학교,25,25,0,25,25,0,0,0
교육기관,교육부,외남초등학교,교육부 경상북도교육청 경상북도상주교육지원청 외남초등학교,10,10,0,10,10,0,0,0
교육기관,교육부,외서초등학교,교육부 경상북도교육청 경상북도상주교육지원청 외서초등학교,5,5,0,5,0,5,0,0
교육기관,교육부,용운중학교,교육부 경상북도교육청 경상북도상주교육지원청 용운중학교,27,27,0,27,15,12,0,0
교육기관,교육부,은척중학교,교육부 경상북도교육청 경상북도상주교육지원청 은척중학교,11,11,0,11,11,0,0,0
교육기관,교육부,이안초등학교,교육부 경상북도교육청 경상북도상주교육지원청 이안초등학교,12,12,0,12,8,4,0,0
교육기관,교육부,중모초등학교,교육부 경상북도교육청 경상북도상주교육지원청 중모초등학교,23,23,0,23,23,0,0,0
교육기관,교육부,청리중학교,교육부 경상북도교육청 경상북도상주교육지원청 청리중학교,10,10,0,10,5,5,0,0
교육기관,교육부,청리초등학교,교육부 경상북도교육청 경상북도상주교육지원청 청리초등학교,9,9,0,9,6,3,0,0
교육기관,교육부,함창중앙초등학교,교육부 경상북도교육청 경상북도상주교육지원청 함창중앙초등학교,12,12,0,12,12,0,0,0
교육기관,교육부,함창초등학교,교육부 경상북도교육청 경상북도상주교육지원청 함창초등학교,16,16,0,16,14,2,0,0
교육기관,교육부,화동중학교,교육부 경상북도교육청 경상북도상주교육지원청 화동중학교,12,12,0,12,8,2,1,1
교육기관,교육부,화동초등학교,교육부 경상북도교육청 경상북도상주교육지원청 화동초등학교,14,14,0,14,14,0,0,0
교육기관,교육부,화령초등학교,교육부 경상북도교육청 경상북도상주교육지원청 화령초등학교,10,10,0,10,10,0,0,0
교육기관,교육부,화북중학교,교육부 경상북도교육청 경상북도상주교육지원청 화북중학교,12,12,0,12,12,0,0,0
교육기관,교육부,화북초등학교,교육부 경상북도교육청 경상북도상주교육지원청 화북초등학교,21,21,0,21,21,0,0,0
교육기관,교육부,경상북도성주교육지원청,교육부 경상북도교육청 경상북도성주교육지원청,9,9,0,9,9,0,0,0
교육기관,교육부,가천중학교,교육부 경상북도교육청 경상북도성주교육지원청 가천중학교,11,7,4,7,7,0,0,0
교육기관,교육부,가천초등학교,교육부 경상북도교육청 경상북도성주교육지원청 가천초등학교,15,15,0,15,15,0,0,0
교육기관,교육부,경상북도교육청성주도서관,교육부 경상북도교육청 경상북도성주교육지원청 경상북도교육청성주도서관,16,16,0,16,0,16,0,0
교육기관,교육부,대가초등학교,교육부 경상북도교육청 경상북도성주교육지원청 대가초등학교,10,10,0,10,6,4,0,0
교육기관,교육부,대동초등학교,교육부 경상북도교육청 경상북도성주교육지원청 대동초등학교,16,16,0,16,16,0,0,0
교육기관,교육부,도원초등학교,교육부 경상북도교육청 경상북도성주교육지원청 도원초등학교,7,7,0,7,4,3,0,0
교육기관,교육부,벽진중학교,교육부 경상북도교육청 경상북도성주교육지원청 벽진중학교,11,11,0,11,10,1,0,0
교육기관,교육부,벽진초등학교,교육부 경상북도교육청 경상북도성주교육지원청 벽진초등학교,14,14,0,14,14,0,0,0
교육기관,교육부,선남초등학교,교육부 경상북도교육청 경상북도성주교육지원청 선남초등학교,16,16,0,16,0,12,4,0
교육기관,교육부,성주여자중학교,교육부 경상북도교육청 경상북도성주교육지원청 성주여자중학교,13,13,0,13,0,13,0,0
교육기관,교육부,성주중앙초등학교,교육부 경상북도교육청 경상북도성주교육지원청 성주중앙초등학교,32,32,0,32,18,14,0,0
교육기관,교육부,성주중학교,교육부 경상북도교육청 경상북도성주교육지원청 성주중학교,16,16,0,16,0,16,0,0
교육기관,교육부,성주초등학교,교육부 경상북도교육청 경상북도성주교육지원청 성주초등학교,22,22,0,22,4,18,0,0
교육기관,교육부,수륜중학교,교육부 경상북도교육청 경상북도성주교육지원청 수륜중학교,8,8,0,8,2,6,0,0
교육기관,교육부,수륜초등학교,교육부 경상북도교육청 경상북도성주교육지원청 수륜초등학교,16,15,1,15,12,3,0,0
교육기관,교육부,용암중학교,교육부 경상북도교육청 경상북도성주교육지원청 용암중학교,16,15,1,15,0,15,0,0
교육기관,교육부,용암초등학교,교육부 경상북도교육청 경상북도성주교육지원청 용암초등학교,10,10,0,10,5,5,0,0
교육기관,교육부,월항초등학교,교육부 경상북도교육청 경상북도성주교육지원청 월항초등학교,22,22,0,22,18,4,0,0
교육기관,교육부,초전중학교,교육부 경상북도교육청 경상북도성주교육지원청 초전중학교,12,11,1,11,3,8,0,0
교육기관,교육부,초전초등학교,교육부 경상북도교육청 경상북도성주교육지원청 초전초등학교,14,14,0,14,9,5,0,0
교육기관,교육부,경상북도안동교육지원청,교육부 경상북도교육청 경상북도안동교육지원청,15,14,1,14,0,14,0,0
교육기관,교육부,강남유치원,교육부 경상북도교육청 경상북도안동교육지원청 강남유치원,15,15,0,15,1,14,0,0
교육기관,교육부,경덕중학교,교육부 경상북도교육청 경상북도안동교육지원청 경덕중학교,67,67,0,67,0,67,0,0
교육기관,교육부,경상북도교육청안동수학체험센터,교육부 경상북도교육청 경상북도안동교육지원청 경상북도교육청안동수학체험센터,36,36,0,36,0,36,0,0
교육기관,교육부,경상북도안동학생수련원,교육부 경상북도교육청 경상북도안동교육지원청 경상북도안동학생수련원,24,24,0,24,9,15,0,0
교육기관,교육부,경안여자중학교,교육부 경상북도교육청 경상북도안동교육지원청 경안여자중학교,20,20,0,20,6,14,0,0
교육기관,교육부,경안중학교,교육부 경상북도교육청 경상북도안동교육지원청 경안중학교,33,31,2,31,31,0,0,0
교육기관,교육부,길안중학교,교육부 경상북도교육청 경상북도안동교육지원청 길안중학교,18,17,1,17,8,9,0,0
교육기관,교육부,길안초등학교,교육부 경상북도교육청 경상북도안동교육지원청 길안초등학교,14,14,0,14,12,0,0,2
교육기관,교육부,길주중학교,교육부 경상북도교육청 경상북도안동교육지원청 길주중학교,43,42,1,42,42,0,0,0
교육기관,교육부,길주초등학교,교육부 경상북도교육청 경상북도안동교육지원청 길주초등학교,39,39,0,39,39,0,0,0
교육기관,교육부,꿈빛유치원,교육부 경상북도교육청 경상북도안동교육지원청 꿈빛유치원,9,9,0,9,0,9,0,0
교육기관,교육부,남선초등학교,교육부 경상북도교육청 경상북도안동교육지원청 남선초등학교,15,15,0,15,10,5,0,0
교육기관,교육부,남후초등학교,교육부 경상북도교육청 경상북도안동교육지원청 남후초등학교,13,13,0,13,13,0,0,0
교육기관,교육부,녹전초등학교,교육부 경상북도교육청 경상북도안동교육지원청 녹전초등학교,10,10,0,10,8,2,0,0
교육기관,교육부,복주여자중학교,교육부 경상북도교육청 경상북도안동교육지원청 복주여자중학교,18,16,2,16,14,2,0,0
교육기관,교육부,복주초등학교,교육부 경상북도교육청 경상북도안동교육지원청 복주초등학교,24,24,0,24,24,0,0,0
교육기관,교육부,북후중학교,교육부 경상북도교육청 경상북도안동교육지원청 북후중학교,16,16,0,16,12,4,0,0
교육기관,교육부,북후초등학교,교육부 경상북도교육청 경상북도안동교육지원청 북후초등학교,6,6,0,6,6,0,0,0
교육기관,교육부,서선초등학교,교육부 경상북도교육청 경상북도안동교육지원청 서선초등학교,14,14,0,14,14,0,0,0
교육기관,교육부,서후초등학교,교육부 경상북도교육청 경상북도안동교육지원청 서후초등학교,16,16,0,16,0,16,0,0
교육기관,교육부,송천초등학교,교육부 경상북도교육청 경상북도안동교육지원청 송천초등학교,14,14,0,14,0,14,0,0
교육기관,교육부,신성초등학교,교육부 경상북도교육청 경상북도안동교육지원청 신성초등학교,8,8,0,8,8,0,0,0
교육기관,교육부,안동강남초등학교,교육부 경상북도교육청 경상북도안동교육지원청 안동강남초등학교,15,15,0,15,15,0,0,0
교육기관,교육부,안동꿈터유치원,교육부 경상북도교육청 경상북도안동교육지원청 안동꿈터유치원,8,8,0,8,0,8,0,0
교육기관,교육부,안동동부초등학교,교육부 경상북도교육청 경상북도안동교육지원청 안동동부초등학교,16,16,0,16,8,8,0,0
교육기관,교육부,안동송현초등학교,교육부 경상북도교육청 경상북도안동교육지원청 안동송현초등학교,20,20,0,20,20,0,0,0
교육기관,교육부,안동여자중학교,교육부 경상북도교육청 경상북도안동교육지원청 안동여자중학교,30,30,0,30,4,26,0,0
교육기관,교육부,안동영호초등학교,교육부 경상북도교육청 경상북도안동교육지원청 안동영호초등학교,28,28,0,28,14,14,0,0
교육기관,교육부,안동용상초등학교,교육부 경상북도교육청 경상북도안동교육지원청 안동용상초등학교,16,16,0,16,6,10,0,0
교육기관,교육부,안동중학교,교육부 경상북도교육청 경상북도안동교육지원청 안동중학교,52,51,1,51,19,32,0,0
교육기관,교육부,영가초등학교,교육부 경상북도교육청 경상북도안동교육지원청 영가초등학교,19,19,0,19,14,5,0,0
교육기관,교육부,영남초등학교,교육부 경상북도교육청 경상북도안동교육지원청 영남초등학교,23,23,0,23,11,12,0,0
교육기관,교육부,온혜초등학교,교육부 경상북도교육청 경상북도안동교육지원청 온혜초등학교,6,6,0,6,6,0,0,0
교육기관,교육부,웅부중학교,교육부 경상북도교육청 경상북도안동교육지원청 웅부중학교,53,53,0,53,53,0,0,0
교육기관,교육부,월곡초등학교,교육부 경상북도교육청 경상북도안동교육지원청 월곡초등학교,7,7,0,7,5,2,0,0
교육기관,교육부,일직중학교,교육부 경상북도교육청 경상북도안동교육지원청 일직중학교,8,8,0,8,8,0,0,0
교육기관,교육부,일직초등학교,교육부 경상북도교육청 경상북도안동교육지원청 일직초등학교,14,14,0,14,12,2,0,0
교육기관,교육부,임동초등학교,교육부 경상북도교육청 경상북도안동교육지원청 임동초등학교,13,13,0,13,13,0,0,0
교육기관,교육부,임하초등학교,교육부 경상북도교육청 경상북도안동교육지원청 임하초등학교,9,9,0,9,9,0,0,0
교육기관,교육부,풍산중학교,교육부 경상북도교육청 경상북도안동교육지원청 풍산중학교,7,7,0,7,2,5,0,0
교육기관,교육부,풍산초등학교,교육부 경상북도교육청 경상북도안동교육지원청 풍산초등학교,16,16,0,16,16,0,0,0
교육기관,교육부,풍천중학교,교육부 경상북도교육청 경상북도안동교육지원청 풍천중학교,59,59,0,59,59,0,0,0
교육기관,교육부,풍천풍서초등학교,교육부 경상북도교육청 경상북도안동교육지원청 풍천풍서초등학교,24,13,11,13,13,0,0,0
교육기관,교육부,경상북도영덕교육지원청,교육부 경상북도교육청 경상북도영덕교육지원청,15,14,1,14,14,0,0,0
교육기관,교육부,강구중학교,교육부 경상북도교육청 경상북도영덕교육지원청 강구중학교,14,14,0,14,10,4,0,0
교육기관,교육부,강구초등학교,교육부 경상북도교육청 경상북도영덕교육지원청 강구초등학교,28,28,0,28,15,13,0,0
교육기관,교육부,경상북도교육청영덕도서관,교육부 경상북도교육청 경상북도영덕교육지원청 경상북도교육청영덕도서관,14,14,0,14,7,7,0,0
교육기관,교육부,경상북도교육청영덕오토캠핑장,교육부 경상북도교육청 경상북도영덕교육지원청 경상북도교육청영덕오토캠핑장,8,8,0,8,0,8,0,0
교육기관,교육부,남정중학교,교육부 경상북도교육청 경상북도영덕교육지원청 남정중학교,8,8,0,8,0,8,0,0
교육기관,교육부,남정초등학교,교육부 경상북도교육청 경상북도영덕교육지원청 남정초등학교,8,8,0,8,8,0,0,0
교육기관,교육부,병곡중학교,교육부 경상북도교육청 경상북도영덕교육지원청 병곡중학교,18,18,0,18,12,6,0,0
교육기관,교육부,병곡초등학교,교육부 경상북도교육청 경상북도영덕교육지원청 병곡초등학교,14,14,0,14,14,0,0,0
교육기관,교육부,영덕야성초등학교,교육부 경상북도교육청 경상북도영덕교육지원청 영덕야성초등학교,22,0,22,0,0,0,0,0
교육기관,교육부,영덕여자중학교,교육부 경상북도교육청 경상북도영덕교육지원청 영덕여자중학교,12,12,0,12,12,0,0,0
교육기관,교육부,영덕중학교,교육부 경상북도교육청 경상북도영덕교육지원청 영덕중학교,6,6,0,6,0,6,0,0
교육기관,교육부,영해중학교,교육부 경상북도교육청 경상북도영덕교육지원청 영해중학교,20,20,0,20,13,7,0,0
교육기관,교육부,영해초등학교,교육부 경상북도교육청 경상북도영덕교육지원청 영해초등학교,15,15,0,15,0,15,0,0
교육기관,교육부,원황초등학교,교육부 경상북도교육청 경상북도영덕교육지원청 원황초등학교,16,16,0,16,2,12,1,1
교육기관,교육부,지품중학교,교육부 경상북도교육청 경상북도영덕교육지원청 지품중학교,8,8,0,8,8,0,0,0
교육기관,교육부,지품초등학교,교육부 경상북도교육청 경상북도영덕교육지원청 지품초등학교,12,12,0,12,12,0,0,0
교육기관,교육부,창수초등학교,교육부 경상북도교육청 경상북도영덕교육지원청 창수초등학교,14,14,0,14,0,14,0,0
교육기관,교육부,축산항초등학교,교육부 경상북도교육청 경상북도영덕교육지원청 축산항초등학교,14,14,0,14,10,4,0,0
교육기관,교육부,경상북도영양교육지원청,교육부 경상북도교육청 경상북도영양교육지원청,10,10,0,10,0,10,0,0
교육기관,교육부,경상북도교육청영양도서관,교육부 경상북도교육청 경상북도영양교육지원청 경상북도교육청영양도서관,16,16,0,16,6,10,0,0
교육기관,교육부,석보중학교,교육부 경상북도교육청 경상북도영양교육지원청 석보중학교,15,15,0,15,15,0,0,0
교육기관,교육부,석보초등학교,교육부 경상북도교육청 경상북도영양교육지원청 석보초등학교,6,4,2,4,0,4,0,0
교육기관,교육부,수비중학교,교육부 경상북도교육청 경상북도영양교육지원청 수비중학교,4,4,0,4,2,2,0,0
교육기관,교육부,수비초등학교,교육부 경상북도교육청 경상북도영양교육지원청 수비초등학교,11,11,0,11,0,11,0,0
교육기관,교육부,영양여자중학교,교육부 경상북도교육청 경상북도영양교육지원청 영양여자중학교,5,5,0,5,0,5,0,0
교육기관,교육부,영양중앙초등학교,교육부 경상북도교육청 경상북도영양교육지원청 영양중앙초등학교,10,10,0,10,0,10,0,0
교육기관,교육부,영양중학교,교육부 경상북도교육청 경상북도영양교육지원청 영양중학교,10,10,0,10,0,10,0,0
교육기관,교육부,영양초등학교,교육부 경상북도교육청 경상북도영양교육지원청 영양초등학교,11,11,0,11,0,11,0,0
교육기관,교육부,일월초등학교,교육부 경상북도교육청 경상북도영양교육지원청 일월초등학교,8,8,0,8,8,0,0,0
교육기관,교육부,일월초등학교청기분교장,교육부 경상북도교육청 경상북도영양교육지원청 일월초등학교청기분교장,4,4,0,4,0,4,0,0
교육기관,교육부,입암초등학교,교육부 경상북도교육청 경상북도영양교육지원청 입암초등학교,9,9,0,9,0,9,0,0
교육기관,교육부,금계중학교,교육부 경상북도교육청 경상북도영주교육지원청 금계중학교,21,21,0,21,20,1,0,0
교육기관,교육부,남산초등학교,교육부 경상북도교육청 경상북도영주교육지원청 남산초등학교,14,14,0,14,3,11,0,0
교육기관,교육부,단산중학교,교육부 경상북도교육청 경상북도영주교육지원청 단산중학교,6,6,0,6,5,1,0,0
교육기관,교육부,대영중학교,교육부 경상북도교육청 경상북도영주교육지원청 대영중학교,27,15,12,15,0,15,0,0
교육기관,교육부,동산여자중학교,교육부 경상북도교육청 경상북도영주교육지원청 동산여자중학교,15,15,0,15,7,8,0,0
교육기관,교육부,문수초등학교,교육부 경상북도교육청 경상북도영주교육지원청 문수초등학교,10,10,0,10,10,0,0,0
교육기관,교육부,봉현초등학교,교육부 경상북도교육청 경상북도영주교육지원청 봉현초등학교,9,9,0,9,6,3,0,0
교육기관,교육부,부석중학교,교육부 경상북도교육청 경상북도영주교육지원청 부석중학교,6,6,0,6,3,3,0,0
교육기관,교육부,부석초등학교,교육부 경상북도교육청 경상북도영주교육지원청 부석초등학교,14,14,0,14,14,0,0,0
교육기관,교육부,소수중학교,교육부 경상북도교육청 경상북도영주교육지원청 소수중학교,6,6,0,6,6,0,0,0
교육기관,교육부,순흥초등학교,교육부 경상북도교육청 경상북도영주교육지원청 순흥초등학교,10,10,0,10,10,0,0,0
교육기관,교육부,안정초등학교,교육부 경상북도교육청 경상북도영주교육지원청 안정초등학교,16,16,0,16,15,1,0,0
교육기관,교육부,영광중학교,교육부 경상북도교육청 경상북도영주교육지원청 영광중학교,11,11,0,11,4,7,0,0
교육기관,교육부,영주가흥초등학교,교육부 경상북도교육청 경상북도영주교육지원청 영주가흥초등학교,27,27,0,27,27,0,0,0
교육기관,교육부,영주남부초등학교,교육부 경상북도교육청 경상북도영주교육지원청 영주남부초등학교,21,21,0,21,14,4,1,2
교육기관,교육부,영주서부초등학교,교육부 경상북도교육청 경상북도영주교육지원청 영주서부초등학교,14,14,0,14,7,7,0,0
교육기관,교육부,영주여자중학교,교육부 경상북도교육청 경상북도영주교육지원청 영주여자중학교,11,11,0,11,11,0,0,0
교육기관,교육부,영주중앙초등학교,교육부 경상북도교육청 경상북도영주교육지원청 영주중앙초등학교,16,16,0,16,12,4,0,0
교육기관,교육부,영주중학교,교육부 경상북도교육청 경상북도영주교육지원청 영주중학교,33,33,0,33,16,17,0,0
교육기관,교육부,영주초등학교,교육부 경상북도교육청 경상북도영주교육지원청 영주초등학교,12,12,0,12,12,0,0,0
교육기관,교육부,옥대초등학교,교육부 경상북도교육청 경상북도영주교육지원청 옥대초등학교,8,8,0,8,8,0,0,0
교육기관,교육부,이산초등학교,교육부 경상북도교육청 경상북도영주교육지원청 이산초등학교,8,8,0,8,8,0,0,0
교육기관,교육부,장수초등학교,교육부 경상북도교육청 경상북도영주교육지원청 장수초등학교,11,11,0,11,11,0,0,0
교육기관,교육부,평은초등학교,교육부 경상북도교육청 경상북도영주교육지원청 평은초등학교,9,9,0,9,8,1,0,0
교육기관,교육부,풍기북부초등학교,교육부 경상북도교육청 경상북도영주교육지원청 풍기북부초등학교,13,13,0,13,8,5,0,0
교육기관,교육부,풍기초등학교,교육부 경상북도교육청 경상북도영주교육지원청 풍기초등학교,22,22,0,22,4,18,0,0
교육기관,교육부,경상북도영천교육지원청,교육부 경상북도교육청 경상북도영천교육지원청,13,12,1,12,7,5,0,0
교육기관,교육부,거여초등학교,교육부 경상북도교육청 경상북도영천교육지원청 거여초등학교,18,18,0,18,13,5,0,0
교육기관,교육부,경상북도교육청금호도서관,교육부 경상북도교육청 경상북도영천교육지원청 경상북도교육청금호도서관,9,9,0,9,4,5,0,0
교육기관,교육부,고경초등학교,교육부 경상북도교육청 경상북도영천교육지원청 고경초등학교,9,9,0,9,5,4,0,0
교육기관,교육부,금호초등학교,교육부 경상북도교육청 경상북도영천교육지원청 금호초등학교,13,13,0,13,13,0,0,0
교육기관,교육부,나무와중학교,교육부 경상북도교육청 경상북도영천교육지원청 나무와중학교,6,6,0,6,0,6,0,0
교육기관,교육부,단포초등학교,교육부 경상북도교육청 경상북도영천교육지원청 단포초등학교,13,13,0,13,3,10,0,0
교육기관,교육부,별빛중학교,교육부 경상북도교육청 경상북도영천교육지원청 별빛중학교,42,41,1,41,41,0,0,0
교육기관,교육부,북안초등학교,교육부 경상북도교육청 경상북도영천교육지원청 북안초등학교,13,13,0,13,13,0,0,0
교육기관,교육부,산자연중학교,교육부 경상북도교육청 경상북도영천교육지원청 산자연중학교,34,34,0,34,25,9,0,0
교육기관,교육부,성남여자중학교,교육부 경상북도교육청 경상북도영천교육지원청 성남여자중학교,20,20,0,20,15,5,0,0
교육기관,교육부,신녕중학교,교육부 경상북도교육청 경상북도영천교육지원청 신녕중학교,84,84,0,84,84,0,0,0
교육기관,교육부,신녕초등학교,교육부 경상북도교육청 경상북도영천교육지원청 신녕초등학교,11,11,0,11,11,0,0,0
교육기관,교육부,영안중학교,교육부 경상북도교육청 경상북도영천교육지원청 영안중학교,11,11,0,11,11,0,0,0
교육기관,교육부,영천동부초등학교,교육부 경상북도교육청 경상북도영천교육지원청 영천동부초등학교,12,12,0,12,7,5,0,0
교육기관,교육부,영천여자중학교,교육부 경상북도교육청 경상북도영천교육지원청 영천여자중학교,37,37,0,37,28,9,0,0
교육기관,교육부,영천중앙유치원,교육부 경상북도교육청 경상북도영천교육지원청 영천중앙유치원,11,11,0,11,5,6,0,0
교육기관,교육부,영천중앙초등학교,교육부 경상북도교육청 경상북도영천교육지원청 영천중앙초등학교,22,22,0,22,0,22,0,0
교육기관,교육부,영천초등학교,교육부 경상북도교육청 경상북도영천교육지원청 영천초등학교,20,20,0,20,14,6,0,0
교육기관,교육부,영화초등학교,교육부 경상북도교육청 경상북도영천교육지원청 영화초등학교,17,17,0,17,11,6,0,0
교육기관,교육부,임고초등학교,교육부 경상북도교육청 경상북도영천교육지원청 임고초등학교,10,10,0,10,7,1,1,1
교육기관,교육부,자천초등학교,교육부 경상북도교육청 경상북도영천교육지원청 자천초등학교,18,18,0,18,8,10,0,0
교육기관,교육부,지곡초등학교,교육부 경상북도교육청 경상북도영천교육지원청 지곡초등학교,13,13,0,13,13,0,0,0
교육기관,교육부,청통중학교,교육부 경상북도교육청 경상북도영천교육지원청 청통중학교,6,6,0,6,3,3,0,0
교육기관,교육부,청통초등학교,교육부 경상북도교육청 경상북도영천교육지원청 청통초등학교,12,12,0,12,12,0,0,0
교육기관,교육부,평천초등학교,교육부 경상북도교육청 경상북도영천교육지원청 평천초등학교,5,5,0,5,5,0,0,0
교육기관,교육부,포은초등학교,교육부 경상북도교육청 경상북도영천교육지원청 포은초등학교,19,19,0,19,19,0,0,0
교육기관,교육부,경상북도예천교육지원청,교육부 경상북도교육청 경상북도예천교육지원청,7,7,0,7,0,7,0,0
교육기관,교육부,감천중학교,교육부 경상북도교육청 경상북도예천교육지원청 감천중학교,13,13,0,13,0,13,0,0
교육기관,교육부,감천초등학교,교육부 경상북도교육청 경상북도예천교육지원청 감천초등학교,16,16,0,16,16,0,0,0
교육기관,교육부,경상북도교육청예천도서관,교육부 경상북도교육청 경상북도예천교육지원청 경상북도교육청예천도서관,9,9,0,9,9,0,0,0
교육기관,교육부,단샘유치원,교육부 경상북도교육청 경상북도예천교육지원청 단샘유치원,32,0,32,0,0,0,0,0
교육기관,교육부,대창중학교,교육부 경상북도교육청 경상북도예천교육지원청 대창중학교,12,4,8,4,2,2,0,0
교육기관,교육부,상리초등학교,교육부 경상북도교육청 경상북도예천교육지원청 상리초등학교,8,8,0,8,8,0,0,0
교육기관,교육부,새벗유치원,교육부 경상북도교육청 경상북도예천교육지원청 새벗유치원,17,17,0,17,8,9,0,0
교육기관,교육부,예천남부초등학교,교육부 경상북도교육청 경상북도예천교육지원청 예천남부초등학교,12,12,0,12,12,0,0,0
교육기관,교육부,예천동부초등학교,교육부 경상북도교육청 경상북도예천교육지원청 예천동부초등학교,28,28,0,28,14,14,0,0
교육기관,교육부,예천여자중학교,교육부 경상북도교육청 경상북도예천교육지원청 예천여자중학교,21,21,0,21,17,2,2,0
교육기관,교육부,예천중학교,교육부 경상북도교육청 경상북도예천교육지원청 예천중학교,26,26,0,26,18,6,1,1
교육기관,교육부,예천초등학교,교육부 경상북도교육청 경상북도예천교육지원청 예천초등학교,30,30,0,30,10,20,0,0
교육기관,교육부,용궁중학교,교육부 경상북도교육청 경상북도예천교육지원청 용궁중학교,8,8,0,8,0,8,0,0
교육기관,교육부,용궁초등학교,교육부 경상북도교육청 경상북도예천교육지원청 용궁초등학교,9,9,0,9,9,0,0,0
교육기관,교육부,용문중학교,교육부 경상북도교육청 경상북도예천교육지원청 용문중학교,9,9,0,9,0,9,0,0
교육기관,교육부,용문초등학교,교육부 경상북도교육청 경상북도예천교육지원청 용문초등학교,16,16,0,16,14,2,0,0
교육기관,교육부,유천초등학교,교육부 경상북도교육청 경상북도예천교육지원청 유천초등학교,11,11,0,11,9,2,0,0
교육기관,교육부,은풍중학교,교육부 경상북도교육청 경상북도예천교육지원청 은풍중학교,8,8,0,8,5,3,0,0
교육기관,교육부,은풍초등학교,교육부 경상북도교육청 경상북도예천교육지원청 은풍초등학교,14,14,0,14,14,0,0,0
교육기관,교육부,지보중학교,교육부 경상북도교육청 경상북도예천교육지원청 지보중학교,16,16,0,16,15,1,0,0
교육기관,교육부,지보초등학교,교육부 경상북도교육청 경상북도예천교육지원청 지보초등학교,10,10,0,10,6,4,0,0
교육기관,교육부,풍양중학교,교육부 경상북도교육청 경상북도예천교육지원청 풍양중학교,12,12,0,12,8,2,1,1
교육기관,교육부,풍양초등학교,교육부 경상북도교육청 경상북도예천교육지원청 풍양초등학교,16,16,0,16,16,0,0,0
교육기관,교육부,호명라온유치원,교육부 경상북도교육청 경상북도예천교육지원청 호명라온유치원,32,32,0,32,3,26,2,1
교육기관,교육부,호명초등학교,교육부 경상북도교육청 경상북도예천교육지원청 호명초등학교,76,76,0,76,34,42,0,0
교육기관,교육부,경상북도울릉교육지원청,교육부 경상북도교육청 경상북도울릉교육지원청,14,13,1,13,7,6,0,0
교육기관,교육부,남양초등학교,교육부 경상북도교육청 경상북도울릉교육지원청 남양초등학교,9,9,0,9,9,0,0,0
교육기관,교육부,울릉공공도서관,교육부 경상북도교육청 경상북도울릉교육지원청 울릉공공도서관,8,8,0,8,8,0,0,0
교육기관,교육부,울릉중학교,교육부 경상북도교육청 경상북도울릉교육지원청 울릉중학교,45,45,0,45,14,31,0,0
교육기관,교육부,저동초등학교,교육부 경상북도교육청 경상북도울릉교육지원청 저동초등학교,15,15,0,15,5,10,0,0
교육기관,교육부,천부초등학교,교육부 경상북도교육청 경상북도울릉교육지원청 천부초등학교,6,6,0,6,6,0,0,0
교육기관,교육부,경상북도울진교육지원청,교육부 경상북도교육청 경상북도울진교육지원청,15,15,0,15,11,4,0,0
교육기관,교육부,경상북도교육청울진도서관,교육부 경상북도교육청 경상북도울진교육지원청 경상북도교육청울진도서관,0,0,0,0,0,0,0,0
교육기관,교육부,기성중학교,교육부 경상북도교육청 경상북도울진교육지원청 기성중학교,16,16,0,16,10,6,0,0
교육기관,교육부,기성초등학교,교육부 경상북도교육청 경상북도울진교육지원청 기성초등학교,16,16,0,16,10,6,0,0
교육기관,교육부,노음초등학교,교육부 경상북도교육청 경상북도울진교육지원청 노음초등학교,11,11,0,11,11,0,0,0
교육기관,교육부,매화중학교,교육부 경상북도교육청 경상북도울진교육지원청 매화중학교,13,13,0,13,2,10,0,1
교육기관,교육부,매화초등학교,교육부 경상북도교육청 경상북도울진교육지원청 매화초등학교,15,15,0,15,15,0,0,0
교육기관,교육부,부구중학교,교육부 경상북도교육청 경상북도울진교육지원청 부구중학교,23,23,0,23,8,15,0,0
교육기관,교육부,부구초등학교,교육부 경상북도교육청 경상북도울진교육지원청 부구초등학교,23,23,0,23,23,0,0,0
교육기관,교육부,삼근초등학교,교육부 경상북도교육청 경상북도울진교육지원청 삼근초등학교,10,9,1,9,9,0,0,0
교육기관,교육부,온정중학교,교육부 경상북도교육청 경상북도울진교육지원청 온정중학교,11,11,0,11,5,6,0,0
교육기관,교육부,온정초등학교,교육부 경상북도교육청 경상북도울진교육지원청 온정초등학교,4,4,0,4,4,0,0,0
교육기관,교육부,울진남부초등학교,교육부 경상북도교육청 경상북도울진교육지원청 울진남부초등학교,17,17,0,17,7,9,0,1
교육기관,교육부,울진중학교,교육부 경상북도교육청 경상북도울진교육지원청 울진중학교,26,26,0,26,13,13,0,0
교육기관,교육부,울진초등학교,교육부 경상북도교육청 경상북도울진교육지원청 울진초등학교,14,14,0,14,14,0,0,0
교육기관,교육부,월송초등학교,교육부 경상북도교육청 경상북도울진교육지원청 월송초등학교,9,9,0,9,9,0,0,0
교육기관,교육부,죽변중학교,교육부 경상북도교육청 경상북도울진교육지원청 죽변중학교,8,8,0,8,4,4,0,0
교육기관,교육부,죽변초등학교,교육부 경상북도교육청 경상북도울진교육지원청 죽변초등학교,16,16,0,16,16,0,0,0
교육기관,교육부,평해중학교,교육부 경상북도교육청 경상북도울진교육지원청 평해중학교,30,30,0,30,30,0,0,0
교육기관,교육부,평해초등학교,교육부 경상북도교육청 경상북도울진교육지원청 평해초등학교,10,10,0,10,10,0,0,0
교육기관,교육부,후포동부초등학교,교육부 경상북도교육청 경상북도울진교육지원청 후포동부초등학교,9,6,3,6,3,1,1,1
교육기관,교육부,후포중학교,교육부 경상북도교육청 경상북도울진교육지원청 후포중학교,10,10,0,10,8,2,0,0
교육기관,교육부,후포초등학교,교육부 경상북도교육청 경상북도울진교육지원청 후포초등학교,20,20,0,20,20,0,0,0
교육기관,교육부,경상북도의성교육지원청,교육부 경상북도교육청 경상북도의성교육지원청,6,6,0,6,0,6,0,0
교육기관,교육부,가음초등학교,교육부 경상북도교육청 경상북도의성교육지원청 가음초등학교,16,16,0,16,13,3,0,0
교육기관,교육부,경북중부중학교,교육부 경상북도교육청 경상북도의성교육지원청 경북중부중학교,67,67,0,67,34,33,0,0
교육기관,교육부,경상북도교육청의성도서관,교육부 경상북도교육청 경상북도의성교육지원청 경상북도교육청의성도서관,31,31,0,31,19,8,1,3
교육기관,교육부,경상북도교육청의성안전체험관,교육부 경상북도교육청 경상북도의성교육지원청 경상북도교육청의성안전체험관,32,32,0,32,0,32,0,0
교육기관,교육부,구천초등학교,교육부 경상북도교육청 경상북도의성교육지원청 구천초등학교,8,8,0,8,6,2,0,0
교육기관,교육부,금성중학교,교육부 경상북도교육청 경상북도의성교육지원청 금성중학교,0,0,0,0,0,0,0,0
교육기관,교육부,금성초등학교,교육부 경상북도교육청 경상북도의성교육지원청 금성초등학교,9,9,0,9,5,4,0,0
교육기관,교육부,다인중학교,교육부 경상북도교육청 경상북도의성교육지원청 다인중학교,9,8,1,8,6,2,0,0
교육기관,교육부,다인초등학교,교육부 경상북도교육청 경상북도의성교육지원청 다인초등학교,8,8,0,8,4,4,0,0
교육기관,교육부,단밀초등학교,교육부 경상북도교육청 경상북도의성교육지원청 단밀초등학교,6,6,0,6,6,0,0,0
교육기관,교육부,단촌초등학교,교육부 경상북도교육청 경상북도의성교육지원청 단촌초등학교,15,15,0,15,15,0,0,0
교육기관,교육부,도리원초등학교,교육부 경상북도교육청 경상북도의성교육지원청 도리원초등학교,10,10,0,10,5,5,0,0
교육기관,교육부,비안초등학교,교육부 경상북도교육청 경상북도의성교육지원청 비안초등학교,9,9,0,9,9,0,0,0
교육기관,교육부,삼성중학교,교육부 경상북도교육청 경상북도의성교육지원청 삼성중학교,7,7,0,7,7,0,0,0
교육기관,교육부,안계중학교,교육부 경상북도교육청 경상북도의성교육지원청 안계중학교,15,15,0,15,6,9,0,0
교육기관,교육부,안계초등학교,교육부 경상북도교육청 경상북도의성교육지원청 안계초등학교,13,13,0,13,13,0,0,0
교육기관,교육부,안평초등학교,교육부 경상북도교육청 경상북도의성교육지원청 안평초등학교,10,10,0,10,10,0,0,0
교육기관,교육부,옥전초등학교,교육부 경상북도교육청 경상북도의성교육지원청 옥전초등학교,16,16,0,16,6,8,2,0
교육기관,교육부,의성북부초등학교,교육부 경상북도교육청 경상북도의성교육지원청 의성북부초등학교,5,5,0,5,3,2,0,0
교육기관,교육부,의성여자중학교,교육부 경상북도교육청 경상북도의성교육지원청 의성여자중학교,17,17,0,17,15,2,0,0
교육기관,교육부,의성초등학교,교육부 경상북도교육청 경상북도의성교육지원청 의성초등학교,22,22,0,22,21,1,0,0
교육기관,교육부,점곡초등학교,교육부 경상북도교육청 경상북도의성교육지원청 점곡초등학교,6,6,0,6,6,0,0,0
교육기관,교육부,춘산초등학교,교육부 경상북도교육청 경상북도의성교육지원청 춘산초등학교,6,6,0,6,4,2,0,0
교육기관,교육부,탑리여자중학교,교육부 경상북도교육청 경상북도의성교육지원청 탑리여자중학교,16,15,1,15,15,0,0,0
교육기관,교육부,경상북도청도교육지원청,교육부 경상북도교육청 경상북도청도교육지원청,12,11,1,11,3,8,0,0
교육기관,교육부,경상북도청도학생수련원,교육부 경상북도교육청 경상북도청도교육지원청 경상북도청도학생수련원,22,22,0,22,0,22,0,0
교육기관,교육부,금천중학교,교육부 경상북도교육청 경상북도청도교육지원청 금천중학교,29,28,1,28,28,0,0,0
교육기관,교육부,금천초등학교,교육부 경상북도교육청 경상북도청도교육지원청 금천초등학교,25,25,0,25,0,25,0,0
교육기관,교육부,남성현초등학교,교육부 경상북도교육청 경상북도청도교육지원청 남성현초등학교,13,13,0,13,13,0,0,0
교육기관,교육부,덕산초등학교,교육부 경상북도교육청 경상북도청도교육지원청 덕산초등학교,14,14,0,14,0,14,0,0
교육기관,교육부,동산초등학교,교육부 경상북도교육청 경상북도청도교육지원청 동산초등학교,7,7,0,7,7,0,0,0
교육기관,교육부,매전중학교,교육부 경상북도교육청 경상북도청도교육지원청 매전중학교,16,16,0,16,16,0,0,0
교육기관,교육부,모계중학교,교육부 경상북도교육청 경상북도청도교육지원청 모계중학교,22,22,0,22,17,5,0,0
교육기관,교육부,이서중학교,교육부 경상북도교육청 경상북도청도교육지원청 이서중학교,11,11,0,11,0,11,0,0
교육기관,교육부,이서초등학교,교육부 경상북도교육청 경상북도청도교육지원청 이서초등학교,16,16,0,16,16,0,0,0
교육기관,교육부,청도공공도서관,교육부 경상북도교육청 경상북도청도교육지원청 청도공공도서관,34,32,2,32,0,32,0,0
교육기관,교육부,청도중앙초등학교,교육부 경상북도교육청 경상북도청도교육지원청 청도중앙초등학교,16,16,0,16,16,0,0,0
교육기관,교육부,청도초등학교,교육부 경상북도교육청 경상북도청도교육지원청 청도초등학교,19,19,0,19,19,0,0,0
교육기관,교육부,풍각초등학교,교육부 경상북도교육청 경상북도청도교육지원청 풍각초등학교,16,16,0,16,16,0,0,0
교육기관,교육부,화양초등학교,교육부 경상북도교육청 경상북도청도교육지원청 화양초등학교,12,12,0,12,5,7,0,0
교육기관,교육부,경상북도청송교육지원청,교육부 경상북도교육청 경상북도청송교육지원청,9,8,1,8,5,3,0,0
교육기관,교육부,경상북도교육청청송도서관,교육부 경상북도교육청 경상북도청송교육지원청 경상북도교육청청송도서관,16,16,0,16,16,0,0,0
교육기관,교육부,구천중학교,교육부 경상북도교육청 경상북도청송교육지원청 구천중학교,9,8,1,8,8,0,0,0
교육기관,교육부,도평초등학교,교육부 경상북도교육청 경상북도청송교육지원청 도평초등학교,12,12,0,12,12,0,0,0
교육기관,교육부,안덕중학교,교육부 경상북도교육청 경상북도청송교육지원청 안덕중학교,14,14,0,14,10,4,0,0
교육기관,교육부,이전초등학교,교육부 경상북도교육청 경상북도청송교육지원청 이전초등학교,11,11,0,11,6,5,0,0
교육기관,교육부,진보중학교,교육부 경상북도교육청 경상북도청송교육지원청 진보중학교,20,20,0,20,12,8,0,0
교육기관,교육부,진보초등학교,교육부 경상북도교육청 경상북도청송교육지원청 진보초등학교,12,12,0,12,6,6,0,0
교육기관,교육부,진성중학교,교육부 경상북도교육청 경상북도청송교육지원청 진성중학교,17,17,0,17,12,5,0,0
교육기관,교육부,청송여자중학교,교육부 경상북도교육청 경상북도청송교육지원청 청송여자중학교,14,12,2,12,10,2,0,0
교육기관,교육부,청송중학교,교육부 경상북도교육청 경상북도청송교육지원청 청송중학교,40,31,9,31,8,20,2,1
교육기관,교육부,청송중학교부동분교장,교육부 경상북도교육청 경상북도청송교육지원청 청송중학교부동분교장,4,4,0,4,2,2,0,0
교육기관,교육부,청송초등학교,교육부 경상북도교육청 경상북도청송교육지원청 청송초등학교,34,34,0,34,0,34,0,0
교육기관,교육부,파천초등학교,교육부 경상북도교육청 경상북도청송교육지원청 파천초등학교,9,9,0,9,3,6,0,0
교육기관,교육부,현동중학교,교육부 경상북도교육청 경상북도청송교육지원청 현동중학교,12,12,0,12,12,0,0,0
교육기관,교육부,현서중학교,교육부 경상북도교육청 경상북도청송교육지원청 현서중학교,20,20,0,20,10,10,0,0
교육기관,교육부,화목초등학교,교육부 경상북도교육청 경상북도청송교육지원청 화목초등학교,13,13,0,13,7,6,0,0
교육기관,교육부,가산초등학교,교육부 경상북도교육청 경상북도칠곡교육지원청 가산초등학교,11,11,0,11,11,0,0,0
교육기관,교육부,경상북도교육청칠곡도서관,교육부 경상북도교육청 경상북도칠곡교육지원청 경상북도교육청칠곡도서관,16,16,0,16,8,8,0,0
교육기관,교육부,경상북도교육청칠곡수학체험센터,교육부 경상북도교육청 경상북도칠곡교육지원청 경상북도교육청칠곡수학체험센터,18,18,0,18,0,18,0,0
교육기관,교육부,관호초등학교,교육부 경상북도교육청 경상북도칠곡교육지원청 관호초등학교,10,10,0,10,10,0,0,0
교육기관,교육부,낙산초등학교,교육부 경상북도교육청 경상북도칠곡교육지원청 낙산초등학교,6,6,0,6,6,0,0,0
교육기관,교육부,남율유치원,교육부 경상북도교육청 경상북도칠곡교육지원청 남율유치원,13,7,6,7,0,7,0,0
교육기관,교육부,다부초등학교,교육부 경상북도교육청 경상북도칠곡교육지원청 다부초등학교,12,12,0,12,10,2,0,0
교육기관,교육부,대교초등학교,교육부 경상북도교육청 경상북도칠곡교육지원청 대교초등학교,24,24,0,24,24,0,0,0
교육기관,교육부,동명동부초등학교,교육부 경상북도교육청 경상북도칠곡교육지원청 동명동부초등학교,15,15,0,15,5,10,0,0
교육기관,교육부,동명중학교,교육부 경상북도교육청 경상북도칠곡교육지원청 동명중학교,8,8,0,8,2,6,0,0
교육기관,교육부,동명초등학교,교육부 경상북도교육청 경상북도칠곡교육지원청 동명초등학교,9,9,0,9,9,0,0,0
교육기관,교육부,매원초등학교,교육부 경상북도교육청 경상북도칠곡교육지원청 매원초등학교,9,9,0,9,9,0,0,0
교육기관,교육부,북삼중학교,교육부 경상북도교육청 경상북도칠곡교육지원청 북삼중학교,36,36,0,36,27,9,0,0
교육기관,교육부,북삼초등학교,교육부 경상북도교육청 경상북도칠곡교육지원청 북삼초등학교,54,54,0,54,54,0,0,0
교육기관,교육부,석적유치원,교육부 경상북도교육청 경상북도칠곡교육지원청 석적유치원,23,9,14,9,0,9,0,0
교육기관,교육부,석적중학교,교육부 경상북도교육청 경상북도칠곡교육지원청 석적중학교,43,38,5,38,19,19,0,0
교육기관,교육부,석적초등학교,교육부 경상북도교육청 경상북도칠곡교육지원청 석적초등학교,29,29,0,29,20,9,0,0
교육기관,교육부,석전중학교,교육부 경상북도교육청 경상북도칠곡교육지원청 석전중학교,31,30,1,30,16,14,0,0
교육기관,교육부,순심여자중학교,교육부 경상북도교육청 경상북도칠곡교육지원청 순심여자중학교,10,10,0,10,5,5,0,0
교육기관,교육부,순심중학교,교육부 경상북도교육청 경상북도칠곡교육지원청 순심중학교,12,10,2,10,10,0,0,0
교육기관,교육부,숭산초등학교,교육부 경상북도교육청 경상북도칠곡교육지원청 숭산초등학교,22,22,0,22,17,5,0,0
교육기관,교육부,신동중학교,교육부 경상북도교육청 경상북도칠곡교육지원청 신동중학교,9,9,0,9,0,9,0,0
교육기관,교육부,신동초등학교,교육부 경상북도교육청 경상북도칠곡교육지원청 신동초등학교,14,14,0,14,0,14,0,0
교육기관,교육부,약동초등학교,교육부 경상북도교육청 경상북도칠곡교육지원청 약동초등학교,9,9,0,9,9,0,0,0
교육기관,교육부,약목중학교,교육부 경상북도교육청 경상북도칠곡교육지원청 약목중학교,35,35,0,35,16,19,0,0
교육기관,교육부,약목초등학교,교육부 경상북도교육청 경상북도칠곡교육지원청 약목초등학교,16,16,0,16,10,6,0,0
교육기관,교육부,왜관동부초등학교,교육부 경상북도교육청 경상북도칠곡교육지원청 왜관동부초등학교,17,17,0,17,12,5,0,0
교육기관,교육부,왜관중앙초등학교,교육부 경상북도교육청 경상북도칠곡교육지원청 왜관중앙초등학교,28,28,0,28,28,0,0,0
교육기관,교육부,왜관중학교,교육부 경상북도교육청 경상북도칠곡교육지원청 왜관중학교,15,15,0,15,9,6,0,0
교육기관,교육부,왜관초등학교,교육부 경상북도교육청 경상북도칠곡교육지원청 왜관초등학교,43,43,0,43,43,0,0,0
교육기관,교육부,인평중학교,교육부 경상북도교육청 경상북도칠곡교육지원청 인평중학교,29,28,1,28,27,1,0,0
교육기관,교육부,인평초등학교,교육부 경상북도교육청 경상북도칠곡교육지원청 인평초등학교,30,30,0,30,0,30,0,0
교육기관,교육부,장곡초등학교,교육부 경상북도교육청 경상북도칠곡교육지원청 장곡초등학교,12,12,0,12,12,0,0,0
교육기관,교육부,지천초등학교,교육부 경상북도교육청 경상북도칠곡교육지원청 지천초등학교,6,6,0,6,4,2,0,0
교육기관,교육부,경상북도포항교육지원청,교육부 경상북도교육청 경상북도포항교육지원청,30,30,0,30,0,30,0,0
교육기관,교육부,경상북도교육청영일도서관,교육부 경상북도교육청 경상북도포항교육지원청 경상북도교육청영일도서관,16,16,0,16,16,0,0,0
교육기관,교육부,경상북도교육청포항산누리오토캠핑장,교육부 경상북도교육청 경상북도포항교육지원청 경상북도교육청포항산누리오토캠핑장,10,10,0,10,0,10,0,0
교육기관,교육부,곡강초등학교,교육부 경상북도교육청 경상북도포항교육지원청 곡강초등학교,9,9,0,9,9,0,0,0
교육기관,교육부,구룡포중학교,교육부 경상북도교육청 경상북도포항교육지원청 구룡포중학교,0,0,0,0,0,0,0,0
교육기관,교육부,구룡포초등학교,교육부 경상북도교육청 경상북도포항교육지원청 구룡포초등학교,15,15,0,15,15,0,0,0
교육기관,교육부,구정초등학교,교육부 경상북도교육청 경상북도포항교육지원청 구정초등학교,22,22,0,22,22,0,0,0
교육기관,교육부,기계중학교,교육부 경상북도교육청 경상북도포항교육지원청 기계중학교,8,8,0,8,8,0,0,0
교육기관,교육부,기계중학교기북분교장,교육부 경상북도교육청 경상북도포항교육지원청 기계중학교기북분교장,6,6,0,6,6,0,0,0
교육기관,교육부,기계초등학교,교육부 경상북도교육청 경상북도포항교육지원청 기계초등학교,9,9,0,9,4,5,0,0
교육기관,교육부,기북초등학교,교육부 경상북도교육청 경상북도포항교육지원청 기북초등학교,9,9,0,9,7,2,0,0
교육기관,교육부,남성초등학교,교육부 경상북도교육청 경상북도포항교육지원청 남성초등학교,10,10,0,10,3,7,0,0
교육기관,교육부,달전초등학교,교육부 경상북도교육청 경상북도포항교육지원청 달전초등학교,8,8,0,8,4,4,0,0
교육기관,교육부,대도중학교,교육부 경상북도교육청 경상북도포항교육지원청 대도중학교,47,47,0,47,47,0,0,0
교육기관,교육부,대도초등학교,교육부 경상북도교육청 경상북도포항교육지원청 대도초등학교,38,38,0,38,38,0,0,0
교육기관,교육부,대동중학교,교육부 경상북도교육청 경상북도포항교육지원청 대동중학교,13,13,0,13,9,2,1,1
교육기관,교육부,대보중학교,교육부 경상북도교육청 경상북도포항교육지원청 대보중학교,6,6,0,6,6,0,0,0
교육기관,교육부,대송중학교,교육부 경상북도교육청 경상북도포항교육지원청 대송중학교,18,18,0,18,10,8,0,0
교육기관,교육부,대송초등학교,교육부 경상북도교육청 경상북도포항교육지원청 대송초등학교,11,11,0,11,11,0,0,0
교육기관,교육부,대이초등학교,교육부 경상북도교육청 경상북도포항교육지원청 대이초등학교,11,11,0,11,11,0,0,0
교육기관,교육부,대잠초등학교,교육부 경상북도교육청 경상북도포항교육지원청 대잠초등학교,15,15,0,15,15,0,0,0
교육기관,교육부,대해초등학교,교육부 경상북도교육청 경상북도포항교육지원청 대해초등학교,17,17,0,17,9,8,0,0
교육기관,교육부,대흥중학교,교육부 경상북도교육청 경상북도포항교육지원청 대흥중학교,35,35,0,35,22,13,0,0
교육기관,교육부,동지중학교,교육부 경상북도교육청 경상북도포항교육지원청 동지중학교,36,36,0,36,10,26,0,0
교육기관,교육부,두호남부초등학교,교육부 경상북도교육청 경상북도포항교육지원청 두호남부초등학교,24,24,0,24,24,0,0,0
교육기관,교육부,두호초등학교,교육부 경상북도교육청 경상북도포항교육지원청 두호초등학교,24,24,0,24,24,0,0,0
교육기관,교육부,문덕초등학교,교육부 경상북도교육청 경상북도포항교육지원청 문덕초등학교,19,19,0,19,19,0,0,0
교육기관,교육부,문충초등학교,교육부 경상북도교육청 경상북도포항교육지원청 문충초등학교,14,14,0,14,0,14,0,0
교육기관,교육부,상대초등학교,교육부 경상북도교육청 경상북도포항교육지원청 상대초등학교,10,10,0,10,0,10,0,0
교육기관,교육부,상도중학교,교육부 경상북도교육청 경상북도포항교육지원청 상도중학교,33,33,0,33,8,25,0,0
교육기관,교육부,송도중학교,교육부 경상북도교육청 경상북도포항교육지원청 송도중학교,34,34,0,34,34,0,0,0
교육기관,교육부,송라중학교,교육부 경상북도교육청 경상북도포항교육지원청 송라중학교,9,9,0,9,4,5,0,0
교육기관,교육부,송림초등학교,교육부 경상북도교육청 경상북도포항교육지원청 송림초등학교,32,32,0,32,32,0,0,0
교육기관,교육부,신광중학교,교육부 경상북도교육청 경상북도포항교육지원청 신광중학교,11,11,0,11,11,0,0,0
교육기관,교육부,신광초등학교,교육부 경상북도교육청 경상북도포항교육지원청 신광초등학교,6,6,0,6,6,0,0,0
교육기관,교육부,신흥중학교,교육부 경상북도교육청 경상북도포항교육지원청 신흥중학교,28,28,0,28,5,23,0,0
교육기관,교육부,신흥초등학교,교육부 경상북도교육청 경상북도포항교육지원청 신흥초등학교,20,20,0,20,16,4,0,0
교육기관,교육부,양덕중학교,교육부 경상북도교육청 경상북도포항교육지원청 양덕중학교,34,34,0,34,12,22,0,0
교육기관,교육부,양서초등학교,교육부 경상북도교육청 경상북도포항교육지원청 양서초등학교,15,14,1,14,4,7,1,2
교육기관,교육부,양포초등학교,교육부 경상북도교육청 경상북도포항교육지원청 양포초등학교,8,8,0,8,4,4,0,0
교육기관,교육부,양학중학교,교육부 경상북도교육청 경상북도포항교육지원청 양학중학교,28,28,0,28,21,7,0,0
교육기관,교육부,양학초등학교,교육부 경상북도교육청 경상북도포항교육지원청 양학초등학교,27,25,2,25,16,9,0,0
교육기관,교육부,연일초등학교,교육부 경상북도교육청 경상북도포항교육지원청 연일초등학교,14,8,6,8,2,2,2,2
교육기관,교육부,오천중학교,교육부 경상북도교육청 경상북도포항교육지원청 오천중학교,23,23,0,23,0,23,0,0
교육기관,교육부,오천초등학교,교육부 경상북도교육청 경상북도포항교육지원청 오천초등학교,16,16,0,16,16,0,0,0
교육기관,교육부,용흥초등학교,교육부 경상북도교육청 경상북도포항교육지원청 용흥초등학교,10,10,0,10,5,5,0,0
교육기관,교육부,월포초등학교,교육부 경상북도교육청 경상북도포항교육지원청 월포초등학교,7,7,0,7,4,1,1,1
교육기관,교육부,유강유치원,교육부 경상북도교육청 경상북도포항교육지원청 유강유치원,16,16,0,16,9,7,0,0
교육기관,교육부,유강중학교,교육부 경상북도교육청 경상북도포항교육지원청 유강중학교,20,20,0,20,3,17,0,0
교육기관,교육부,이동중학교,교육부 경상북도교육청 경상북도포항교육지원청 이동중학교,43,43,0,43,43,0,0,0
교육기관,교육부,이동초등학교,교육부 경상북도교육청 경상북도포항교육지원청 이동초등학교,19,19,0,19,19,0,0,0
교육기관,교육부,장기중학교,교육부 경상북도교육청 경상북도포항교육지원청 장기중학교,32,32,0,32,0,32,0,0
교육기관,교육부,장기초등학교,교육부 경상북도교육청 경상북도포항교육지원청 장기초등학교,6,6,0,6,6,0,0,0
교육기관,교육부,장량초등학교,교육부 경상북도교육청 경상북도포항교육지원청 장량초등학교,21,21,0,21,0,21,0,0
교육기관,교육부,장성초등학교,교육부 경상북도교육청 경상북도포항교육지원청 장성초등학교,15,15,0,15,6,9,0,0
교육기관,교육부,죽도초등학교,교육부 경상북도교육청 경상북도포항교육지원청 죽도초등학교,9,9,0,9,9,0,0,0
교육기관,교육부,죽장초등학교,교육부 경상북도교육청 경상북도포항교육지원청 죽장초등학교,10,10,0,10,10,0,0,0
교육기관,교육부,죽천초등학교,교육부 경상북도교육청 경상북도포항교육지원청 죽천초등학교,7,7,0,7,7,0,0,0
교육기관,교육부,창포초등학교,교육부 경상북도교육청 경상북도포항교육지원청 창포초등학교,30,30,0,30,12,18,0,0
교육기관,교육부,청림초등학교,교육부 경상북도교육청 경상북도포항교육지원청 청림초등학교,12,12,0,12,0,12,0,0
교육기관,교육부,청하중학교,교육부 경상북도교육청 경상북도포항교육지원청 청하중학교,21,21,0,21,21,0,0,0
교육기관,교육부,청하초등학교,교육부 경상북도교육청 경상북도포항교육지원청 청하초등학교,11,11,0,11,11,0,0,0
교육기관,교육부,초곡초등학교,교육부 경상북도교육청 경상북도포항교육지원청 초곡초등학교,32,31,1,31,31,0,0,0
교육기관,교육부,포항남부초등학교,교육부 경상북도교육청 경상북도포항교육지원청 포항남부초등학교,15,13,2,13,7,6,0,0
교육기관,교육부,포항대흥초등학교,교육부 경상북도교육청 경상북도포항교육지원청 포항대흥초등학교,30,30,0,30,22,8,0,0
교육기관,교육부,포항동부초등학교,교육부 경상북도교육청 경상북도포항교육지원청 포항동부초등학교,16,16,0,16,16,0,0,0
교육기관,교육부,포항동해중학교,교육부 경상북도교육청 경상북도포항교육지원청 포항동해중학교,30,30,0,30,30,0,0,0
교육기관,교육부,포항송곡초등학교,교육부 경상북도교육청 경상북도포항교육지원청 포항송곡초등학교,32,32,0,32,18,14,0,0
교육기관,교육부,포항송도초등학교,교육부 경상북도교육청 경상북도포항교육지원청 포항송도초등학교,5,5,0,5,3,2,0,0
교육기관,교육부,포항양덕초등학교,교육부 경상북도교육청 경상북도포항교육지원청 포항양덕초등학교,19,19,0,19,10,9,0,0
교육기관,교육부,포항여자중학교,교육부 경상북도교육청 경상북도포항교육지원청 포항여자중학교,29,29,0,29,20,9,0,0
교육기관,교육부,포항영신중학교,교육부 경상북도교육청 경상북도포항교육지원청 포항영신중학교,50,50,0,50,0,50,0,0
교육기관,교육부,포항영흥초등학교,교육부 경상북도교육청 경상북도포항교육지원청 포항영흥초등학교,21,21,0,21,12,9,0,0
교육기관,교육부,포항원동초등학교,교육부 경상북도교육청 경상북도포항교육지원청 포항원동초등학교,24,24,0,24,10,14,0,0
교육기관,교육부,포항유치원,교육부 경상북도교육청 경상북도포항교육지원청 포항유치원,16,16,0,16,0,16,0,0
교육기관,교육부,포항장량유치원,교육부 경상북도교육청 경상북도포항교육지원청 포항장량유치원,41,10,31,10,5,5,0,0
교육기관,교육부,포항장원초등학교,교육부 경상북도교육청 경상북도포항교육지원청 포항장원초등학교,18,18,0,18,18,0,0,0
교육기관,교육부,포항장흥초등학교,교육부 경상북도교육청 경상북도포항교육지원청 포항장흥초등학교,14,14,0,14,0,14,0,0
교육기관,교육부,포항제철중학교,교육부 경상북도교육청 경상북도포항교육지원청 포항제철중학교,40,40,0,40,0,40,0,0
교육기관,교육부,포항제철지곡초등학교,교육부 경상북도교육청 경상북도포항교육지원청 포항제철지곡초등학교,28,28,0,28,0,28,0,0
교육기관,교육부,포항제철초등학교,교육부 경상북도교육청 경상북도포항교육지원청 포항제철초등학교,54,54,0,54,34,18,1,1
교육기관,교육부,포항중앙초등학교,교육부 경상북도교육청 경상북도포항교육지원청 포항중앙초등학교,27,27,0,27,13,14,0,0
교육기관,교육부,포항중학교,교육부 경상북도교육청 경상북도포항교육지원청 포항중학교,41,41,0,41,0,41,0,0
교육기관,교육부,포항초등학교,교육부 경상북도교육청 경상북도포항교육지원청 포항초등학교,19,19,0,19,17,2,0,0
교육기관,교육부,포항포은중학교,교육부 경상북도교육청 경상북도포항교육지원청 포항포은중학교,34,34,0,34,17,17,0,0
교육기관,교육부,포항항도중학교,교육부 경상북도교육청 경상북도포항교육지원청 포항항도중학교,22,22,0,22,22,0,0,0
교육기관,교육부,포항해맞이초등학교,교육부 경상북도교육청 경상북도포항교육지원청 포항해맞이초등학교,17,17,0,17,15,1,1,0
교육기관,교육부,학천초등학교,교육부 경상북도교육청 경상북도포항교육지원청 학천초등학교,18,18,0,18,18,0,0,0
교육기관,교육부,항구초등학교,교육부 경상북도교육청 경상북도포항교육지원청 항구초등학교,22,22,0,22,12,10,0,0
교육기관,교육부,환호여자중학교,교육부 경상북도교육청 경상북도포항교육지원청 환호여자중학교,21,21,0,21,17,4,0,0
교육기관,교육부,효자초등학교,교육부 경상북도교육청 경상북도포항교육지원청 효자초등학교,15,15,0,15,15,0,0,0
교육기관,교육부,흥해남산초등학교,교육부 경상북도교육청 경상북도포항교육지원청 흥해남산초등학교,13,13,0,13,13,0,0,0
교육기관,교육부,흥해서부초등학교,교육부 경상북도교육청 경상북도포항교육지원청 흥해서부초등학교,12,12,0,12,12,0,0,0
교육기관,교육부,흥해중학교,교육부 경상북도교육청 경상북도포항교육지원청 흥해중학교,30,28,2,28,20,8,0,0
교육기관,교육부,흥해초등학교,교육부 경상북도교육청 경상북도포항교육지원청 흥해초등학교,32,24,8,24,12,12,0,0
교육기관,교육부,경상북도학생해양수련원,교육부 경상북도교육청 경상북도학생해양수련원,83,83,0,83,0,83,0,0
교육기관,교육부,경안고등학교,교육부 경상북도교육청 경안고등학교,22,22,0,22,22,0,0,0
교육기관,교육부,경안여자고등학교,교육부 경상북도교육청 경안여자고등학교,18,18,0,18,18,0,0,0
교육기관,교육부,경일고등학교,교육부 경상북도교육청 경일고등학교,80,80,0,80,80,0,0,0
교육기관,교육부,경주고등학교,교육부 경상북도교육청 경주고등학교,56,56,0,56,2,50,2,2
교육기관,교육부,경주공업고등학교,교육부 경상북도교육청 경주공업고등학교,96,96,0,96,40,56,0,0
교육기관,교육부,경주디자인고등학교,교육부 경상북도교육청 경주디자인고등학교,40,40,0,40,15,25,0,0
교육기관,교육부,경주여자고등학교,교육부 경상북도교육청 경주여자고등학교,15,14,1,14,8,6,0,0
교육기관,교육부,경주예일고등학교,교육부 경상북도교육청 경주예일고등학교,26,13,13,13,10,3,0,0
교육기관,교육부,경주정보고등학교,교육부 경상북도교육청 경주정보고등학교,50,50,0,50,48,2,0,0
교육기관,교육부,경희학교,교육부 경상북도교육청 경희학교,28,28,0,28,10,18,0,0
교육기관,교육부,계림고등학교,교육부 경상북도교육청 계림고등학교,22,22,0,22,0,22,0,0
교육기관,교육부,고령고등학교,교육부 경상북도교육청 고령고등학교,39,39,0,39,30,7,1,1
교육기관,교육부,구미고등학교,교육부 경상북도교육청 구미고등학교,51,50,1,50,25,25,0,0
교육기관,교육부,구미산동고등학교,교육부 경상북도교육청 구미산동고등학교,44,44,0,44,0,44,0,0
교육기관,교육부,구미여자상업고등학교,교육부 경상북도교육청 구미여자상업고등학교,15,15,0,15,0,15,0,0
교육기관,교육부,군위고등학교,교육부 경상북도교육청 군위고등학교,83,83,0,83,51,32,0,0
교육기관,교육부,근화여자고등학교,교육부 경상북도교육청 근화여자고등학교,63,63,0,63,50,13,0,0
교육기관,교육부,글로벌선진학교문경캠퍼스,교육부 경상북도교육청 글로벌선진학교문경캠퍼스,212,212,0,212,20,192,0,0
교육기관,교육부,금성고등학교,교육부 경상북도교육청 금성고등학교,10,10,0,10,7,3,0,0
교육기관,교육부,금오고등학교,교육부 경상북도교육청 금오고등학교,52,52,0,52,35,17,0,0
교육기관,교육부,금오공업고등학교,교육부 경상북도교육청 금오공업고등학교,127,127,0,127,111,16,0,0
교육기관,교육부,금오여자고등학교,교육부 경상북도교육청 금오여자고등학교,64,64,0,64,26,38,0,0
교육기관,교육부,금천고등학교,교육부 경상북도교육청 금천고등학교,29,29,0,29,3,26,0,0
교육기관,교육부,김천고등학교,교육부 경상북도교육청 김천고등학교,115,115,0,115,0,115,0,0
교육기관,교육부,김천생명과학고등학교,교육부 경상북도교육청 김천생명과학고등학교,24,24,0,24,13,11,0,0
교육기관,교육부,김천예술고등학교,교육부 경상북도교육청 김천예술고등학교,76,76,0,76,0,76,0,0
교육기관,교육부,김천중앙고등학교,교육부 경상북도교육청 김천중앙고등학교,59,11,48,11,11,0,0,0
교육기관,교육부,대경문화예술고등학교,교육부 경상북도교육청 대경문화예술고등학교,12,12,0,12,0,12,0,0
교육기관,교육부,대구가톨릭대학교사범대학부속무학고등학교,교육부 경상북도교육청 대구가톨릭대학교사범대학부속무학고등학교,98,98,0,98,0,98,0,0
교육기관,교육부,대동고등학교,교육부 경상북도교육청 대동고등학교,35,35,0,35,35,0,0,0
교육기관,교육부,대영고등학교,교육부 경상북도교육청 대영고등학교,34,34,0,34,12,22,0,0
교육기관,교육부,대창고등학교,교육부 경상북도교육청 대창고등학교,39,39,0,39,39,0,0,0
교육기관,교육부,도개고등학교,교육부 경상북도교육청 도개고등학교,61,61,0,61,61,0,0,0
교육기관,교육부,동명고등학교,교육부 경상북도교육청 동명고등학교,36,36,0,36,20,16,0,0
교육기관,교육부,동지고등학교,교육부 경상북도교육청 동지고등학교,28,28,0,28,0,28,0,0
교육기관,교육부,동지여자고등학교,교육부 경상북도교육청 동지여자고등학교,44,44,0,44,44,0,0,0
교육기관,교육부,두호고등학교,교육부 경상북도교육청 두호고등학교,43,41,2,41,15,21,0,5
교육기관,교육부,링컨중고등학교,교육부 경상북도교육청 링컨중고등학교,53,7,46,7,7,0,0,0
교육기관,교육부,무산고등학교,교육부 경상북도교육청 무산고등학교,23,23,0,23,15,8,0,0
교육기관,교육부,문경공업고등학교,교육부 경상북도교육청 문경공업고등학교,44,44,0,44,44,0,0,0
교육기관,교육부,문경여자고등학교,교육부 경상북도교육청 문경여자고등학교,43,41,2,41,41,0,0,0
교육기관,교육부,문명고등학교,교육부 경상북도교육청 문명고등학교,64,64,0,64,26,38,0,0
교육기관,교육부,문창고등학교,교육부 경상북도교육청 문창고등학교,68,68,0,68,0,68,0,0
교육기관,교육부,문화고등학교,교육부 경상북도교육청 문화고등학교,78,78,0,78,78,0,0,0
교육기관,교육부,봉화고등학교,교육부 경상북도교육청 봉화고등학교,69,69,0,69,0,69,0,0
교육기관,교육부,북삼고등학교,교육부 경상북도교육청 북삼고등학교,65,64,1,64,4,52,1,7
교육기관,교육부,사동고등학교,교육부 경상북도교육청 사동고등학교,44,42,2,42,21,21,0,0
교육기관,교육부,상모고등학교,교육부 경상북도교육청 상모고등학교,73,73,0,73,73,0,0,0
교육기관,교육부,상산전자고등학교,교육부 경상북도교육청 상산전자고등학교,25,25,0,25,25,0,0,0
교육기관,교육부,상주공업고등학교,교육부 경상북도교육청 상주공업고등학교,57,56,1,56,56,0,0,0
교육기관,교육부,상주여자고등학교,교육부 경상북도교육청 상주여자고등학교,37,23,14,23,23,0,0,0
교육기관,교육부,상지여자상업고등학교,교육부 경상북도교육청 상지여자상업고등학교,34,34,0,34,34,0,0,0
교육기관,교육부,상희학교,교육부 경상북도교육청 상희학교,26,22,4,22,6,16,0,0
교육기관,교육부,선산고등학교,교육부 경상북도교육청 선산고등학교,77,77,0,77,42,35,0,0
교육기관,교육부,선주고등학교,교육부 경상북도교육청 선주고등학교,32,32,0,32,32,0,0,0
교육기관,교육부,선화여자고등학교,교육부 경상북도교육청 선화여자고등학교,45,45,0,45,45,0,0,0
교육기관,교육부,성의고등학교,교육부 경상북도교육청 성의고등학교,70,70,0,70,8,62,0,0
교육기관,교육부,성의여자고등학교,교육부 경상북도교육청 성의여자고등학교,65,64,1,64,64,0,0,0
교육기관,교육부,성주고등학교,교육부 경상북도교육청 성주고등학교,71,71,0,71,51,20,0,0
교육기관,교육부,성주여자고등학교,교육부 경상북도교육청 성주여자고등학교,58,58,0,58,58,0,0,0
교육기관,교육부,성희여자고등학교,교육부 경상북도교육청 성희여자고등학교,53,53,0,53,0,53,0,0
교육기관,교육부,세명고등학교,교육부 경상북도교육청 세명고등학교,64,64,0,64,31,33,0,0
교육기관,교육부,세화고등학교,교육부 경상북도교육청 세화고등학교,48,48,0,48,48,0,0,0
교육기관,교육부,수비고등학교,교육부 경상북도교육청 수비고등학교,5,5,0,5,3,2,0,0
교육기관,교육부,순심고등학교,교육부 경상북도교육청 순심고등학교,61,35,26,35,16,19,0,0
교육기관,교육부,순심여자고등학교,교육부 경상북도교육청 순심여자고등학교,16,5,11,5,2,3,0,0
교육기관,교육부,신라공업고등학교,교육부 경상북도교육청 신라공업고등학교,58,58,0,58,20,38,0,0
교육기관,교육부,안강전자고등학교,교육부 경상북도교육청 안강전자고등학교,22,22,0,22,11,11,0,0
교육기관,교육부,안계고등학교,교육부 경상북도교육청 안계고등학교,35,33,2,33,23,8,1,1
교육기관,교육부,안동고등학교,교육부 경상북도교육청 안동고등학교,55,55,0,55,41,14,0,0
교육기관,교육부,안동여자고등학교,교육부 경상북도교육청 안동여자고등학교,31,31,0,31,31,0,0,0
교육기관,교육부,안동영명학교,교육부 경상북도교육청 안동영명학교,78,78,0,78,78,0,0,0
교육기관,교육부,안동중앙고등학교,교육부 경상북도교육청 안동중앙고등학교,21,19,2,19,0,19,0,0
교육기관,교육부,안동진명학교,교육부 경상북도교육청 안동진명학교,39,39,0,39,6,33,0,0
교육기관,교육부,약목고등학교,교육부 경상북도교육청 약목고등학교,52,52,0,52,52,0,0,0
교육기관,교육부,영광고등학교,교육부 경상북도교육청 영광고등학교,43,43,0,43,0,43,0,0
교육기관,교육부,영광여자고등학교,교육부 경상북도교육청 영광여자고등학교,31,29,2,29,14,15,0,0
교육기관,교육부,영남삼육고등학교,교육부 경상북도교육청 영남삼육고등학교,104,104,0,104,104,0,0,0
교육기관,교육부,영덕고등학교,교육부 경상북도교육청 영덕고등학교,39,39,0,39,0,39,0,0
교육기관,교육부,영덕여자고등학교,교육부 경상북도교육청 영덕여자고등학교,15,15,0,15,15,0,0,0
교육기관,교육부,영동고등학교,교육부 경상북도교육청 영동고등학교,22,22,0,22,16,6,0,0
교육기관,교육부,영양고등학교,교육부 경상북도교육청 영양고등학교,28,28,0,28,28,0,0,0
교육기관,교육부,영양여자고등학교,교육부 경상북도교육청 영양여자고등학교,10,10,0,10,0,10,0,0
교육기관,교육부,영일고등학교,교육부 경상북도교육청 영일고등학교,42,42,0,42,42,0,0,0
교육기관,교육부,영주동산고등학교,교육부 경상북도교육청 영주동산고등학교,39,39,0,39,24,15,0,0
교육기관,교육부,영주여자고등학교,교육부 경상북도교육청 영주여자고등학교,35,35,0,35,31,4,0,0
교육기관,교육부,영천고등학교,교육부 경상북도교육청 영천고등학교,60,60,0,60,0,60,0,0
교육기관,교육부,영천성남여자고등학교,교육부 경상북도교육청 영천성남여자고등학교,26,26,0,26,6,20,0,0
교육기관,교육부,영천여자고등학교,교육부 경상북도교육청 영천여자고등학교,33,31,2,31,0,31,0,0
교육기관,교육부,영해고등학교,교육부 경상북도교육청 영해고등학교,61,61,0,61,16,45,0,0
교육기관,교육부,예천여자고등학교,교육부 경상북도교육청 예천여자고등학교,25,25,0,25,25,0,0,0
교육기관,교육부,오상고등학교,교육부 경상북도교육청 오상고등학교,54,54,0,54,0,54,0,0
교육기관,교육부,오천고등학교,교육부 경상북도교육청 오천고등학교,56,56,0,56,0,56,0,0
교육기관,교육부,울릉고등학교,교육부 경상북도교육청 울릉고등학교,36,36,0,36,35,1,0,0
교육기관,교육부,울진고등학교,교육부 경상북도교육청 울진고등학교,44,44,0,44,0,44,0,0
교육기관,교육부,유성여자고등학교,교육부 경상북도교육청 유성여자고등학교,52,51,1,51,17,34,0,0
교육기관,교육부,율곡고등학교,교육부 경상북도교육청 율곡고등학교,24,24,0,24,16,8,0,0
교육기관,교육부,의성고등학교,교육부 경상북도교육청 의성고등학교,42,42,0,42,30,12,0,0
교육기관,교육부,의성여자고등학교,교육부 경상북도교육청 의성여자고등학교,26,19,7,19,14,5,0,0
교육기관,교육부,의성유니텍고등학교,교육부 경상북도교육청 의성유니텍고등학교,47,47,0,47,47,0,0,0
교육기관,교육부,이서고등학교,교육부 경상북도교육청 이서고등학교,76,76,0,76,0,76,0,0
교육기관,교육부,인동고등학교,교육부 경상북도교육청 인동고등학교,52,52,0,52,51,0,1,0
교육기관,교육부,점촌고등학교,교육부 경상북도교육청 점촌고등학교,47,47,0,47,47,0,0,0
교육기관,교육부,죽변고등학교,교육부 경상북도교육청 죽변고등학교,33,33,0,33,31,2,0,0
교육기관,교육부,진량고등학교,교육부 경상북도교육청 진량고등학교,58,58,0,58,30,28,0,0
교육기관,교육부,진보고등학교,교육부 경상북도교육청 진보고등학교,20,20,0,20,12,8,0,0
교육기관,교육부,청송여자고등학교,교육부 경상북도교육청 청송여자고등학교,18,18,0,18,18,0,0,0
교육기관,교육부,청송자동차고등학교,교육부 경상북도교육청 청송자동차고등학교,19,19,0,19,19,0,0,0
교육기관,교육부,평해정보고등학교,교육부 경상북도교육청 평해정보고등학교,30,30,0,30,0,30,0,0
교육기관,교육부,포은고등학교,교육부 경상북도교육청 포은고등학교,29,29,0,29,17,12,0,0
교육기관,교육부,포항고등학교,교육부 경상북도교육청 포항고등학교,50,1,49,1,1,0,0,0
교육기관,교육부,포항과학기술고등학교,교육부 경상북도교육청 포항과학기술고등학교,74,74,0,74,74,0,0,0
교육기관,교육부,포항동성고등학교,교육부 경상북도교육청 포항동성고등학교,108,108,0,108,108,0,0,0
교육기관,교육부,포항명도학교,교육부 경상북도교육청 포항명도학교,22,22,0,22,6,8,4,4
교육기관,교육부,포항여자고등학교,교육부 경상북도교육청 포항여자고등학교,39,39,0,39,39,0,0,0
교육기관,교육부,포항여자전자고등학교,교육부 경상북도교육청 포항여자전자고등학교,53,53,0,53,44,9,0,0
교육기관,교육부,포항영신고등학교,교육부 경상북도교육청 포항영신고등학교,95,95,0,95,0,95,0,0
교육기관,교육부,포항예술고등학교,교육부 경상북도교육청 포항예술고등학교,33,33,0,33,10,21,1,1
교육기관,교육부,포항이동고등학교,교육부 경상북도교육청 포항이동고등학교,19,19,0,19,15,4,0,0
교육기관,교육부,포항제철고등학교,교육부 경상북도교육청 포항제철고등학교,56,54,2,54,11,43,0,0
교육기관,교육부,포항제철공업고등학교,교육부 경상북도교육청 포항제철공업고등학교,55,55,0,55,28,27,0,0
교육기관,교육부,포항중앙고등학교,교육부 경상북도교육청 포항중앙고등학교,66,66,0,66,66,0,0,0
교육기관,교육부,포항흥해공업고등학교,교육부 경상북도교육청 포항흥해공업고등학교,33,33,0,33,33,0,0,0
교육기관,교육부,풍산고등학교,교육부 경상북도교육청 풍산고등학교,53,53,0,53,19,32,0,2
교육기관,교육부,하양여자고등학교,교육부 경상북도교육청 하양여자고등학교,47,36,11,36,18,18,0,0
교육기관,교육부,한국국제조리고등학교,교육부 경상북도교육청 한국국제조리고등학교,38,38,0,38,27,11,0,0
교육기관,교육부,한국국제통상마이스터고등학교,교육부 경상북도교육청 한국국제통상마이스터고등학교,64,64,0,64,32,32,0,0
교육기관,교육부,한국미래농업고등학교,교육부 경상북도교육청 한국미래농업고등학교,44,44,0,44,44,0,0,0
교육기관,교육부,한국산림과학고등학교,교육부 경상북도교육청 한국산림과학고등학교,47,47,0,47,0,47,0,0
교육기관,교육부,한국생명과학고등학교,교육부 경상북도교육청 한국생명과학고등학교,85,85,0,85,20,65,0,0
교육기관,교육부,한국원자력마이스터고등학교,교육부 경상북도교육청 한국원자력마이스터고등학교,75,75,0,75,75,0,0,0
교육기관,교육부,한국펫고등학교,교육부 경상북도교육청 한국펫고등학교,36,36,0,36,36,0,0,0
교육기관,교육부,한국해양마이스터고등학교,교육부 경상북도교육청 한국해양마이스터고등학교,57,57,0,57,32,25,0,0
교육기관,교육부,한일여자고등학교,교육부 경상북도교육청 한일여자고등학교,63,63,0,63,20,43,0,0
교육기관,교육부,함창고등학교,교육부 경상북도교육청 함창고등학교,52,52,0,52,26,26,0,0
교육기관,교육부,현서고등학교,교육부 경상북도교육청 현서고등학교,20,20,0,20,10,10,0,0
교육기관,교육부,현일고등학교,교육부 경상북도교육청 현일고등학교,31,29,2,29,29,0,0,0
교육기관,교육부,형곡고등학교,교육부 경상북도교육청 형곡고등학교,34,34,0,34,0,34,0,0
교육기관,교육부,화랑교육원,교육부 경상북도교육청 화랑교육원,31,31,0,31,0,31,0,0
교육기관,교육부,효청보건고등학교,교육부 경상북도교육청 효청보건고등학교,68,68,0,68,68,0,0,0
교육기관,교육부,후포고등학교,교육부 경상북도교육청 후포고등학교,25,23,2,23,9,14,0,0
교육기관,교육부,경상남도교육청,교육부 경상남도교육청,67,67,0,67,0,67,0,0
교육기관,교육부,간디고등학교,교육부 경상남도교육청 간디고등학교,16,16,0,16,14,2,0,0
교육기관,교육부,거제고등학교,교육부 경상남도교육청 거제고등학교,41,40,1,40,40,0,0,0
교육기관,교육부,거제공업고등학교,교육부 경상남도교육청 거제공업고등학교,71,71,0,71,56,15,0,0
교육기관,교육부,거제상문고등학교,교육부 경상남도교육청 거제상문고등학교,48,48,0,48,5,43,0,0
교육기관,교육부,거제애광학교,교육부 경상남도교육청 거제애광학교,11,11,0,11,0,11,0,0
교육기관,교육부,거제여자상업고등학교,교육부 경상남도교육청 거제여자상업고등학교,44,35,9,35,31,4,0,0
교육기관,교육부,거제옥포고등학교,교육부 경상남도교육청 거제옥포고등학교,36,36,0,36,36,0,0,0
교육기관,교육부,거제제일고등학교,교육부 경상남도교육청 거제제일고등학교,62,62,0,62,44,18,0,0
교육기관,교육부,거제중앙고등학교,교육부 경상남도교육청 거제중앙고등학교,43,43,0,43,33,9,1,0
교육기관,교육부,거창고등학교,교육부 경상남도교육청 거창고등학교,26,26,0,26,0,26,0,0
교육기관,교육부,거창나래학교,교육부 경상남도교육청 거창나래학교,44,44,0,44,44,0,0,0
교육기관,교육부,거창대성고등학교,교육부 경상남도교육청 거창대성고등학교,42,42,0,42,42,0,0,0
교육기관,교육부,거창승강기고등학교,교육부 경상남도교육청 거창승강기고등학교,36,36,0,36,16,20,0,0
교육기관,교육부,거창연극고등학교,교육부 경상남도교육청 거창연극고등학교,52,52,0,52,52,0,0,0
교육기관,교육부,거창중앙고등학교,교육부 경상남도교육청 거창중앙고등학교,51,51,0,51,44,7,0,0
교육기관,교육부,경남고성음악고등학교,교육부 경상남도교육청 경남고성음악고등학교,51,50,1,50,35,15,0,0
교육기관,교육부,경남과학고등학교,교육부 경상남도교육청 경남과학고등학교,88,88,0,88,0,88,0,0
교육기관,교육부,경남관광고등학교,교육부 경상남도교육청 경남관광고등학교,50,50,0,50,0,50,0,0
교육기관,교육부,경남꿈키움중학교,교육부 경상남도교육청 경남꿈키움중학교,33,11,22,11,4,2,3,2
교육기관,교육부,경남로봇고등학교,교육부 경상남도교육청 경남로봇고등학교,39,39,0,39,39,0,0,0
교육기관,교육부,경남산업고등학교,교육부 경상남도교육청 경남산업고등학교,38,38,0,38,38,0,0,0
교육기관,교육부,경남예술고등학교,교육부 경상남도교육청 경남예술고등학교,59,59,0,59,30,29,0,0
교육기관,교육부,경남외국어고등학교,교육부 경상남도교육청 경남외국어고등학교,88,13,75,13,4,9,0,0
교육기관,교육부,경남자동차고등학교,교육부 경상남도교육청 경남자동차고등학교,31,31,0,31,31,0,0,0
교육기관,교육부,경남전자고등학교,교육부 경상남도교육청 경남전자고등학교,26,26,0,26,0,26,0,0
교육기관,교육부,경남정보고등학교,교육부 경상남도교육청 경남정보고등학교,39,39,0,39,39,0,0,0
교육기관,교육부,경남항공고등학교,교육부 경상남도교육청 경남항공고등학교,53,53,0,53,15,38,0,0
교육기관,교육부,경남해양과학고등학교,교육부 경상남도교육청 경남해양과학고등학교,28,24,4,24,5,18,0,1
교육기관,교육부,경남혜림학교,교육부 경상남도교육청 경남혜림학교,33,33,0,33,0,33,0,0
교육기관,교육부,경상고등학교,교육부 경상남도교육청 경상고등학교,46,46,0,46,20,24,2,0
교육기관,교육부,경상남도거제교육지원청,교육부 경상남도교육청 경상남도거제교육지원청,17,17,0,17,4,13,0,0
교육기관,교육부,거제고현중학교,교육부 경상남도교육청 경상남도거제교육지원청 거제고현중학교,37,37,0,37,37,0,0,0
교육기관,교육부,거제고현초등학교,교육부 경상남도교육청 경상남도거제교육지원청 거제고현초등학교,22,22,0,22,22,0,0,0
교육기관,교육부,거제상동초등학교,교육부 경상남도교육청 경상남도거제교육지원청 거제상동초등학교,47,47,0,47,47,0,0,0
교육기관,교육부,거제양정초등학교,교육부 경상남도교육청 경상남도거제교육지원청 거제양정초등학교,31,31,0,31,4,27,0,0
교육기관,교육부,거제용소초등학교,교육부 경상남도교육청 경상남도거제교육지원청 거제용소초등학교,53,4,49,4,4,0,0,0
교육기관,교육부,거제유치원,교육부 경상남도교육청 경상남도거제교육지원청 거제유치원,34,34,0,34,0,34,0,0
교육기관,교육부,거제장평중학교,교육부 경상남도교육청 경상남도거제교육지원청 거제장평중학교,45,44,1,44,44,0,0,0
교육기관,교육부,거제제일중학교,교육부 경상남도교육청 경상남도거제교육지원청 거제제일중학교,29,29,0,29,15,14,0,0
교육기관,교육부,거제중앙중학교,교육부 경상남도교육청 경상남도거제교육지원청 거제중앙중학교,21,21,0,21,21,0,0,0
교육기관,교육부,거제중앙초등학교,교육부 경상남도교육청 경상남도거제교육지원청 거제중앙초등학교,37,37,0,37,0,37,0,0
교육기관,교육부,거제중학교,교육부 경상남도교육청 경상남도거제교육지원청 거제중학교,58,58,0,58,42,16,0,0
교육기관,교육부,거제초등학교,교육부 경상남도교육청 경상남도거제교육지원청 거제초등학교,17,17,0,17,14,3,0,0
교육기관,교육부,경상남도교육청거제도서관,교육부 경상남도교육청 경상남도거제교육지원청 경상남도교육청거제도서관,14,14,0,14,13,1,0,0
교육기관,교육부,계룡중학교,교육부 경상남도교육청 경상남도거제교육지원청 계룡중학교,52,52,0,52,52,0,0,0
교육기관,교육부,계룡초등학교,교육부 경상남도교육청 경상남도거제교육지원청 계룡초등학교,22,22,0,22,22,0,0,0
교육기관,교육부,국산초등학교,교육부 경상남도교육청 경상남도거제교육지원청 국산초등학교,24,24,0,24,18,4,2,0
교육기관,교육부,기성초등학교,교육부 경상남도교육청 경상남도거제교육지원청 기성초등학교,30,30,0,30,27,3,0,0
교육기관,교육부,내곡초등학교,교육부 경상남도교육청 경상남도거제교육지원청 내곡초등학교,44,44,0,44,44,0,0,0
교육기관,교육부,능포초등학교,교육부 경상남도교육청 경상남도거제교육지원청 능포초등학교,16,16,0,16,16,0,0,0
교육기관,교육부,대우초등학교,교육부 경상남도교육청 경상남도거제교육지원청 대우초등학교,35,35,0,35,33,2,0,0
교육기관,교육부,동부초등학교,교육부 경상남도교육청 경상남도거제교육지원청 동부초등학교,10,10,0,10,10,0,0,0
교육기관,교육부,둔덕중학교,교육부 경상남도교육청 경상남도거제교육지원청 둔덕중학교,19,18,1,18,16,2,0,0
교육기관,교육부,마전초등학교,교육부 경상남도교육청 경상남도거제교육지원청 마전초등학교,17,17,0,17,4,11,1,1
교육기관,교육부,사등유치원,교육부 경상남도교육청 경상남도거제교육지원청 사등유치원,16,10,6,10,3,7,0,0
교육기관,교육부,사등초등학교,교육부 경상남도교육청 경상남도거제교육지원청 사등초등학교,21,21,0,21,0,21,0,0
교육기관,교육부,삼룡초등학교,교육부 경상남도교육청 경상남도거제교육지원청 삼룡초등학교,37,37,0,37,37,0,0,0
교육기관,교육부,성포중학교,교육부 경상남도교육청 경상남도거제교육지원청 성포중학교,13,13,0,13,13,0,0,0
교육기관,교육부,송정초등학교,교육부 경상남도교육청 경상남도거제교육지원청 송정초등학교,15,15,0,15,15,0,0,0
교육기관,교육부,수월중학교,교육부 경상남도교육청 경상남도거제교육지원청 수월중학교,33,33,0,33,12,21,0,0
교육기관,교육부,수월초등학교,교육부 경상남도교육청 경상남도거제교육지원청 수월초등학교,21,21,0,21,21,0,0,0
교육기관,교육부,숭덕초등학교,교육부 경상남도교육청 경상남도거제교육지원청 숭덕초등학교,26,13,13,13,13,0,0,0
교육기관,교육부,신현중학교,교육부 경상남도교육청 경상남도거제교육지원청 신현중학교,32,32,0,32,31,1,0,0
교육기관,교육부,신현초등학교,교육부 경상남도교육청 경상남도거제교육지원청 신현초등학교,22,22,0,22,22,0,0,0
교육기관,교육부,아주초등학교,교육부 경상남도교육청 경상남도거제교육지원청 아주초등학교,24,24,0,24,0,24,0,0
교육기관,교육부,양지초등학교,교육부 경상남도교육청 경상남도거제교육지원청 양지초등학교,17,17,0,17,9,8,0,0
교육기관,교육부,연초중학교,교육부 경상남도교육청 경상남도거제교육지원청 연초중학교,12,12,0,12,3,7,1,1
교육기관,교육부,오량초등학교,교육부 경상남도교육청 경상남도거제교육지원청 오량초등학교,16,16,0,16,16,0,0,0
교육기관,교육부,오비초등학교,교육부 경상남도교육청 경상남도거제교육지원청 오비초등학교,8,8,0,8,7,1,0,0
교육기관,교육부,옥포성지중학교,교육부 경상남도교육청 경상남도거제교육지원청 옥포성지중학교,25,25,0,25,22,2,1,0
교육기관,교육부,옥포중학교,교육부 경상남도교육청 경상남도거제교육지원청 옥포중학교,65,65,0,65,65,0,0,0
교육기관,교육부,옥포초등학교,교육부 경상남도교육청 경상남도거제교육지원청 옥포초등학교,24,24,0,24,14,10,0,0
교육기관,교육부,외간초등학교,교육부 경상남도교육청 경상남도거제교육지원청 외간초등학교,16,16,0,16,16,0,0,0
교육기관,교육부,외포중학교,교육부 경상남도교육청 경상남도거제교육지원청 외포중학교,6,6,0,6,1,5,0,0
교육기관,교육부,외포초등학교,교육부 경상남도교육청 경상남도거제교육지원청 외포초등학교,12,12,0,12,12,0,0,0
교육기관,교육부,일운초등학교,교육부 경상남도교육청 경상남도거제교육지원청 일운초등학교,23,23,0,23,23,0,0,0
교육기관,교육부,장목중학교,교육부 경상남도교육청 경상남도거제교육지원청 장목중학교,16,2,14,2,0,2,0,0
교육기관,교육부,장목초등학교,교육부 경상남도교육청 경상남도거제교육지원청 장목초등학교,12,12,0,12,8,2,1,1
교육기관,교육부,장승포초등학교,교육부 경상남도교육청 경상남도거제교육지원청 장승포초등학교,29,29,0,29,2,25,1,1
교육기관,교육부,장평초등학교,교육부 경상남도교육청 경상남도거제교육지원청 장평초등학교,6,6,0,6,6,0,0,0
교육기관,교육부,제산초등학교,교육부 경상남도교육청 경상남도거제교육지원청 제산초등학교,28,28,0,28,28,0,0,0
교육기관,교육부,중곡초등학교,교육부 경상남도교육청 경상남도거제교육지원청 중곡초등학교,22,22,0,22,18,4,0,0
교육기관,교육부,지세포중학교,교육부 경상남도교육청 경상남도거제교육지원청 지세포중학교,17,17,0,17,12,5,0,0
교육기관,교육부,진목초등학교,교육부 경상남도교육청 경상남도거제교육지원청 진목초등학교,20,20,0,20,20,0,0,0
교육기관,교육부,창호초등학교,교육부 경상남도교육청 경상남도거제교육지원청 창호초등학교,19,19,0,19,19,0,0,0
교육기관,교육부,칠천초등학교,교육부 경상남도교육청 경상남도거제교육지원청 칠천초등학교,13,13,0,13,7,6,0,0
교육기관,교육부,하청중학교,교육부 경상남도교육청 경상남도거제교육지원청 하청중학교,19,19,0,19,19,0,0,0
교육기관,교육부,하청초등학교,교육부 경상남도교육청 경상남도거제교육지원청 하청초등학교,21,21,0,21,18,3,0,0
교육기관,교육부,한아름유치원,교육부 경상남도교육청 경상남도거제교육지원청 한아름유치원,10,10,0,10,2,8,0,0
교육기관,교육부,해성중학교,교육부 경상남도교육청 경상남도거제교육지원청 해성중학교,47,46,1,46,0,46,0,0
교육기관,교육부,경상남도거창교육지원청,교육부 경상남도교육청 경상남도거창교육지원청,0,0,0,0,0,0,0,0
교육기관,교육부,가북초등학교,교육부 경상남도교육청 경상남도거창교육지원청 가북초등학교,4,4,0,4,4,0,0,0
교육기관,교육부,가조중학교,교육부 경상남도교육청 경상남도거창교육지원청 가조중학교,15,15,0,15,10,5,0,0
교육기관,교육부,가조초등학교,교육부 경상남도교육청 경상남도거창교육지원청 가조초등학교,10,10,0,10,10,0,0,0
교육기관,교육부,거창대성중학교,교육부 경상남도교육청 경상남도거창교육지원청 거창대성중학교,57,57,0,57,57,0,0,0
교육기관,교육부,거창덕유중학교,교육부 경상남도교육청 경상남도거창교육지원청 거창덕유중학교,45,45,0,45,32,13,0,0
교육기관,교육부,거창여자중학교,교육부 경상남도교육청 경상남도거창교육지원청 거창여자중학교,22,22,0,22,16,6,0,0
교육기관,교육부,거창유치원,교육부 경상남도교육청 경상남도거창교육지원청 거창유치원,9,9,0,9,5,4,0,0
교육기관,교육부,거창중학교,교육부 경상남도교육청 경상남도거창교육지원청 거창중학교,27,26,1,26,9,16,0,1
교육기관,교육부,거창중학교고제분교장,교육부 경상남도교육청 경상남도거창교육지원청 거창중학교고제분교장,6,6,0,6,6,0,0,0
교육기관,교육부,거창초등학교,교육부 경상남도교육청 경상남도거창교육지원청 거창초등학교,25,25,0,25,25,0,0,0
교육기관,교육부,경상남도교육청거창도서관,교육부 경상남도교육청 경상남도거창교육지원청 경상남도교육청거창도서관,4,4,0,4,4,0,0,0
교육기관,교육부,고제초등학교,교육부 경상남도교육청 경상남도거창교육지원청 고제초등학교,6,6,0,6,6,0,0,0
교육기관,교육부,남상초등학교,교육부 경상남도교육청 경상남도거창교육지원청 남상초등학교,13,13,0,13,13,0,0,0
교육기관,교육부,남하초등학교,교육부 경상남도교육청 경상남도거창교육지원청 남하초등학교,9,9,0,9,7,2,0,0
교육기관,교육부,마리초등학교,교육부 경상남도교육청 경상남도거창교육지원청 마리초등학교,10,10,0,10,2,6,1,1
교육기관,교육부,북상초등학교,교육부 경상남도교육청 경상남도거창교육지원청 북상초등학교,8,8,0,8,4,4,0,0
교육기관,교육부,샛별중학교,교육부 경상남도교육청 경상남도거창교육지원청 샛별중학교,12,12,0,12,11,1,0,0
교육기관,교육부,샛별초등학교,교육부 경상남도교육청 경상남도거창교육지원청 샛별초등학교,19,19,0,19,15,4,0,0
교육기관,교육부,신원초등학교,교육부 경상남도교육청 경상남도거창교육지원청 신원초등학교,5,5,0,5,5,0,0,0
교육기관,교육부,아림초등학교,교육부 경상남도교육청 경상남도거창교육지원청 아림초등학교,25,25,0,25,25,0,0,0
교육기관,교육부,웅양중학교,교육부 경상남도교육청 경상남도거창교육지원청 웅양중학교,7,6,1,6,3,3,0,0
교육기관,교육부,웅양초등학교,교육부 경상남도교육청 경상남도거창교육지원청 웅양초등학교,8,8,0,8,8,0,0,0
교육기관,교육부,월천초등학교,교육부 경상남도교육청 경상남도거창교육지원청 월천초등학교,8,8,0,8,8,0,0,0
교육기관,교육부,위천초등학교,교육부 경상남도교육청 경상남도거창교육지원청 위천초등학교,14,14,0,14,14,0,0,0
교육기관,교육부,주상초등학교,교육부 경상남도교육청 경상남도거창교육지원청 주상초등학교,6,6,0,6,3,1,1,1
교육기관,교육부,창남초등학교,교육부 경상남도교육청 경상남도거창교육지원청 창남초등학교,32,32,0,32,32,0,0,0
교육기관,교육부,창동초등학교,교육부 경상남도교육청 경상남도거창교육지원청 창동초등학교,26,26,0,26,15,11,0,0
교육기관,교육부,혜성여자중학교,교육부 경상남도교육청 경상남도거창교육지원청 혜성여자중학교,12,12,0,12,12,0,0,0
교육기관,교육부,경상남도고성교육지원청,교육부 경상남도교육청 경상남도고성교육지원청,24,24,0,24,4,20,0,0
교육기관,교육부,개천초등학교,교육부 경상남도교육청 경상남도고성교육지원청 개천초등학교,4,4,0,4,4,0,0,0
교육기관,교육부,거류초등학교,교육부 경상남도교육청 경상남도고성교육지원청 거류초등학교,14,14,0,14,14,0,0,0
교육기관,교육부,경상남도교육청고성도서관,교육부 경상남도교육청 경상남도고성교육지원청 경상남도교육청고성도서관,12,12,0,12,0,12,0,0
교육기관,교육부,고성동중학교,교육부 경상남도교육청 경상남도고성교육지원청 고성동중학교,11,10,1,10,10,0,0,0
교육기관,교육부,고성여자중학교,교육부 경상남도교육청 경상남도고성교육지원청 고성여자중학교,19,19,0,19,19,0,0,0
교육기관,교육부,고성유치원,교육부 경상남도교육청 경상남도고성교육지원청 고성유치원,13,13,0,13,13,0,0,0
교육기관,교육부,고성중학교,교육부 경상남도교육청 경상남도고성교육지원청 고성중학교,12,12,0,12,12,0,0,0
교육기관,교육부,고성초등학교,교육부 경상남도교육청 경상남도고성교육지원청 고성초등학교,27,27,0,27,27,0,0,0
교육기관,교육부,구만초등학교,교육부 경상남도교육청 경상남도고성교육지원청 구만초등학교,7,7,0,7,7,0,0,0
교육기관,교육부,대성초등학교,교육부 경상남도교육청 경상남도고성교육지원청 대성초등학교,15,15,0,15,8,3,4,0
교육기관,교육부,대흥초등학교,교육부 경상남도교육청 경상남도고성교육지원청 대흥초등학교,11,11,0,11,5,5,1,0
교육기관,교육부,동광초등학교,교육부 경상남도교육청 경상남도고성교육지원청 동광초등학교,7,7,0,7,5,2,0,0
교육기관,교육부,동해중학교,교육부 경상남도교육청 경상남도고성교육지원청 동해중학교,11,11,0,11,2,9,0,0
교육기관,교육부,동해초등학교,교육부 경상남도교육청 경상남도고성교육지원청 동해초등학교,13,13,0,13,10,3,0,0
교육기관,교육부,마암초등학교,교육부 경상남도교육청 경상남도고성교육지원청 마암초등학교,8,8,0,8,2,6,0,0
교육기관,교육부,방산초등학교,교육부 경상남도교육청 경상남도고성교육지원청 방산초등학교,11,11,0,11,9,2,0,0
교육기관,교육부,삼산초등학교,교육부 경상남도교육청 경상남도고성교육지원청 삼산초등학교,12,12,0,12,6,6,0,0
교육기관,교육부,상리초등학교,교육부 경상남도교육청 경상남도고성교육지원청 상리초등학교,9,9,0,9,9,0,0,0
교육기관,교육부,소가야중학교,교육부 경상남도교육청 경상남도고성교육지원청 소가야중학교,44,44,0,44,20,24,0,0
교육기관,교육부,영오초등학교,교육부 경상남도교육청 경상남도고성교육지원청 영오초등학교,13,13,0,13,4,9,0,0
교육기관,교육부,영오초등학교영현분교장,교육부 경상남도교육청 경상남도고성교육지원청 영오초등학교영현분교장,7,7,0,7,7,0,0,0
교육기관,교육부,영천중학교,교육부 경상남도교육청 경상남도고성교육지원청 영천중학교,17,17,0,17,17,0,0,0
교육기관,교육부,율천초등학교,교육부 경상남도교육청 경상남도고성교육지원청 율천초등학교,15,15,0,15,15,0,0,0
교육기관,교육부,철성중학교,교육부 경상남도교육청 경상남도고성교육지원청 철성중학교,15,15,0,15,15,0,0,0
교육기관,교육부,철성초등학교,교육부 경상남도교육청 경상남도고성교육지원청 철성초등학교,9,9,0,9,8,1,0,0
교육기관,교육부,하이초등학교,교육부 경상남도교육청 경상남도고성교육지원청 하이초등학교,8,8,0,8,5,1,1,1
교육기관,교육부,하일초등학교,교육부 경상남도교육청 경상남도고성교육지원청 하일초등학교,16,16,0,16,16,0,0,0
교육기관,교육부,회화중학교,교육부 경상남도교육청 경상남도고성교육지원청 회화중학교,17,16,1,16,10,6,0,0
교육기관,교육부,회화초등학교,교육부 경상남도교육청 경상남도고성교육지원청 회화초등학교,14,14,0,14,14,0,0,0
교육기관,교육부,경상남도교육청경남수학문화관,교육부 경상남도교육청 경상남도교육청경남수학문화관,19,19,0,19,0,19,0,0
교육기관,교육부,경상남도교육청과학교육원,교육부 경상남도교육청 경상남도교육청과학교육원,54,54,0,54,0,54,0,0
교육기관,교육부,경상남도교육청과학교육원우포생태교육원,교육부 경상남도교육청 경상남도교육청과학교육원 경상남도교육청과학교육원우포생태교육원,4,4,0,4,2,2,0,0
교육기관,교육부,경상남도교육청교육연구정보원,교육부 경상남도교육청 경상남도교육청교육연구정보원,52,16,36,16,0,16,0,0
교육기관,교육부,경상남도교육청교육연수원,교육부 경상남도교육청 경상남도교육청교육연수원,67,67,0,67,0,67,0,0
교육기관,교육부,경상남도교육청교육정보원,교육부 경상남도교육청 경상남도교육청교육정보원,52,16,36,16,0,16,0,0
교육기관,교육부,경상남도교육청김해도서관,교육부 경상남도교육청 경상남도교육청김해도서관,39,39,0,39,7,32,0,0
교육기관,교육부,경상남도교육청낙동강학생교육원,교육부 경상남도교육청 경상남도교육청낙동강학생교육원,51,51,0,51,0,51,0,0
교육기관,교육부,경상남도교육청낙동강학생교육원진산분원,교육부 경상남도교육청 경상남도교육청낙동강학생교육원 경상남도교육청낙동강학생교육원진산분원,13,2,11,2,0,2,0,0
교육기관,교육부,경상남도교육청낙동강학생교육원칠북분원,교육부 경상남도교육청 경상남도교육청낙동강학생교육원 경상남도교육청낙동강학생교육원칠북분원,28,28,0,28,26,2,0,0
교육기관,교육부,경상남도교육청덕유학생교육원,교육부 경상남도교육청 경상남도교육청덕유학생교육원,22,22,0,22,10,12,0,0
교육기관,교육부,경상남도교육청마산도서관,교육부 경상남도교육청 경상남도교육청마산도서관,41,41,0,41,5,36,0,0
교육기관,교육부,경상남도교육청산촌유학교육원,교육부 경상남도교육청 경상남도교육청산촌유학교육원,16,16,0,16,16,0,0,0
교육기관,교육부,경상남도교육청유아교육원,교육부 경상남도교육청 경상남도교육청유아교육원,7,7,0,7,0,7,0,0
교육기관,교육부,경상남도교육청유아교육원김해체험분원,교육부 경상남도교육청 경상남도교육청유아교육원 경상남도교육청유아교육원김해체험분원,20,20,0,20,9,11,0,0
교육기관,교육부,경상남도교육청유아교육원진주체험분원,교육부 경상남도교육청 경상남도교육청유아교육원 경상남도교육청유아교육원진주체험분원,22,22,0,22,16,6,0,0
교육기관,교육부,경상남도교육청종합복지관,교육부 경상남도교육청 경상남도교육청종합복지관,28,28,0,28,0,28,0,0
교육기관,교육부,경상남도교육청창원도서관,교육부 경상남도교육청 경상남도교육청창원도서관,50,50,0,50,0,50,0,0
교육기관,교육부,경상남도교육청특수교육원,교육부 경상남도교육청 경상남도교육청특수교육원,55,55,0,55,0,55,0,0
교육기관,교육부,경상남도교육청학생교육원,교육부 경상남도교육청 경상남도교육청학생교육원,43,43,0,43,43,0,0,0
교육기관,교육부,경상남도교육청학생교육원남해분원,교육부 경상남도교육청 경상남도교육청학생교육원 경상남도교육청학생교육원남해분원,13,13,0,13,9,4,0,0
교육기관,교육부,경상남도교육청학생안전체험교육원,교육부 경상남도교육청 경상남도교육청학생안전체험교육원,69,23,46,23,6,17,0,0
교육기관,교육부,경상남도김해교육지원청,교육부 경상남도교육청 경상남도김해교육지원청,3,1,2,1,1,0,0,0
교육기관,교육부,가야중학교,교육부 경상남도교육청 경상남도김해교육지원청 가야중학교,31,31,0,31,30,0,1,0
교육기관,교육부,경상남도교육청김해지혜의바다도서관,교육부 경상남도교육청 경상남도김해교육지원청 경상남도교육청김해지혜의바다도서관,29,29,0,29,0,29,0,0
교육기관,교육부,경상남도교육청진영도서관,교육부 경상남도교육청 경상남도김해교육지원청 경상남도교육청진영도서관,7,7,0,7,0,7,0,0
교육기관,교육부,경운중학교,교육부 경상남도교육청 경상남도김해교육지원청 경운중학교,31,31,0,31,17,14,0,0
교육기관,교육부,경운초등학교,교육부 경상남도교육청 경상남도김해교육지원청 경운초등학교,26,26,0,26,21,5,0,0
교육기관,교육부,계동초등학교,교육부 경상남도교육청 경상남도김해교육지원청 계동초등학교,30,30,0,30,30,0,0,0
교육기관,교육부,관동중학교,교육부 경상남도교육청 경상남도김해교육지원청 관동중학교,28,28,0,28,15,13,0,0
교육기관,교육부,관동초등학교,교육부 경상남도교육청 경상남도김해교육지원청 관동초등학교,33,33,0,33,33,0,0,0
교육기관,교육부,구봉초등학교,교육부 경상남도교육청 경상남도김해교육지원청 구봉초등학교,14,9,5,9,4,5,0,0
교육기관,교육부,구산중학교,교육부 경상남도교육청 경상남도김해교육지원청 구산중학교,13,12,1,12,11,0,1,0
교육기관,교육부,구산초등학교,교육부 경상남도교육청 경상남도김해교육지원청 구산초등학교,14,14,0,14,11,3,0,0
교육기관,교육부,금동초등학교,교육부 경상남도교육청 경상남도김해교육지원청 금동초등학교,30,30,0,30,30,0,0,0
교육기관,교육부,금산초등학교,교육부 경상남도교육청 경상남도김해교육지원청 금산초등학교,15,15,0,15,15,0,0,0
교육기관,교육부,김해가야초등학교,교육부 경상남도교육청 경상남도김해교육지원청 김해가야초등학교,25,25,0,25,18,7,0,0
교육기관,교육부,김해구지초등학교,교육부 경상남도교육청 경상남도김해교육지원청 김해구지초등학교,37,37,0,37,37,0,0,0
교육기관,교육부,김해내동초등학교,교육부 경상남도교육청 경상남도김해교육지원청 김해내동초등학교,18,18,0,18,0,18,0,0
교육기관,교육부,김해대곡초등학교,교육부 경상남도교육청 경상남도김해교육지원청 김해대곡초등학교,20,20,0,20,8,5,4,3
교육기관,교육부,김해대동중학교,교육부 경상남도교육청 경상남도김해교육지원청 김해대동중학교,17,17,0,17,7,10,0,0
교육기관,교육부,김해동광초등학교,교육부 경상남도교육청 경상남도김해교육지원청 김해동광초등학교,34,34,0,34,34,0,0,0
교육기관,교육부,김해모산중학교,교육부 경상남도교육청 경상남도김해교육지원청 김해모산중학교,55,55,0,55,0,55,0,0
교육기관,교육부,김해모산초등학교,교육부 경상남도교육청 경상남도김해교육지원청 김해모산초등학교,39,39,0,39,0,39,0,0
교육기관,교육부,김해봉황초등학교,교육부 경상남도교육청 경상남도김해교육지원청 김해봉황초등학교,21,21,0,21,21,0,0,0
교육기관,교육부,김해부곡초등학교,교육부 경상남도교육청 경상남도김해교육지원청 김해부곡초등학교,12,12,0,12,12,0,0,0
교육기관,교육부,김해삼계중학교,교육부 경상남도교육청 경상남도김해교육지원청 김해삼계중학교,36,35,1,35,18,17,0,0
교육기관,교육부,김해서중학교,교육부 경상남도교육청 경상남도김해교육지원청 김해서중학교,31,31,0,31,0,31,0,0
교육기관,교육부,김해신명초등학교,교육부 경상남도교육청 경상남도김해교육지원청 김해신명초등학교,37,37,0,37,37,0,0,0
교육기관,교육부,김해신안초등학교,교육부 경상남도교육청 경상남도김해교육지원청 김해신안초등학교,22,22,0,22,0,22,0,0
교육기관,교육부,김해여자중학교,교육부 경상남도교육청 경상남도김해교육지원청 김해여자중학교,28,28,0,28,28,0,0,0
교육기관,교육부,김해외동초등학교,교육부 경상남도교육청 경상남도김해교육지원청 김해외동초등학교,20,20,0,20,16,2,0,2
교육기관,교육부,김해유치원,교육부 경상남도교육청 경상남도김해교육지원청 김해유치원,16,16,0,16,16,0,0,0
교육기관,교육부,김해율산초등학교,교육부 경상남도교육청 경상남도김해교육지원청 김해율산초등학교,51,51,0,51,40,11,0,0
교육기관,교육부,김해율하유치원,교육부 경상남도교육청 경상남도김해교육지원청 김해율하유치원,20,20,0,20,6,14,0,0
교육기관,교육부,김해중앙여자중학교,교육부 경상남도교육청 경상남도김해교육지원청 김해중앙여자중학교,11,11,0,11,0,11,0,0
교육기관,교육부,김해중학교,교육부 경상남도교육청 경상남도김해교육지원청 김해중학교,17,17,0,17,17,0,0,0
교육기관,교육부,김해합성초등학교,교육부 경상남도교육청 경상남도김해교육지원청 김해합성초등학교,13,13,0,13,13,0,0,0
교육기관,교육부,김해활천초등학교,교육부 경상남도교육청 경상남도김해교육지원청 김해활천초등학교,25,25,0,25,9,15,1,0
교육기관,교육부,내덕중학교,교육부 경상남도교육청 경상남도김해교육지원청 내덕중학교,36,35,1,35,35,0,0,0
교육기관,교육부,내동중학교,교육부 경상남도교육청 경상남도김해교육지원청 내동중학교,22,22,0,22,19,3,0,0
교육기관,교육부,능동중학교,교육부 경상남도교육청 경상남도김해교육지원청 능동중학교,25,25,0,25,0,25,0,0
교육기관,교육부,능동초등학교,교육부 경상남도교육청 경상남도김해교육지원청 능동초등학교,29,29,0,29,29,0,0,0
교육기관,교육부,대감초등학교,교육부 경상남도교육청 경상남도김해교육지원청 대감초등학교,29,29,0,29,10,19,0,0
교육기관,교육부,대동초등학교,교육부 경상남도교육청 경상남도김해교육지원청 대동초등학교,16,16,0,16,16,0,0,0
교육기관,교육부,대중초등학교,교육부 경상남도교육청 경상남도김해교육지원청 대중초등학교,9,9,0,9,0,9,0,0
교육기관,교육부,대진초등학교,교육부 경상남도교육청 경상남도김해교육지원청 대진초등학교,12,12,0,12,10,2,0,0
교육기관,교육부,대청중학교,교육부 경상남도교육청 경상남도김해교육지원청 대청중학교,25,25,0,25,9,16,0,0
교육기관,교육부,덕정초등학교,교육부 경상남도교육청 경상남도김해교육지원청 덕정초등학교,14,14,0,14,14,0,0,0
교육기관,교육부,봉명중학교,교육부 경상남도교육청 경상남도김해교육지원청 봉명중학교,30,30,0,30,30,0,0,0
교육기관,교육부,봉명초등학교,교육부 경상남도교육청 경상남도김해교육지원청 봉명초등학교,21,21,0,21,21,0,0,0
교육기관,교육부,분성중학교,교육부 경상남도교육청 경상남도김해교육지원청 분성중학교,39,39,0,39,23,10,6,0
교육기관,교육부,분성초등학교,교육부 경상남도교육청 경상남도김해교육지원청 분성초등학교,19,19,0,19,19,0,0,0
교육기관,교육부,삼계초등학교,교육부 경상남도교육청 경상남도김해교육지원청 삼계초등학교,17,17,0,17,14,3,0,0
교육기관,교육부,삼문초등학교,교육부 경상남도교육청 경상남도김해교육지원청 삼문초등학교,22,22,0,22,4,18,0,0
교육기관,교육부,삼방초등학교,교육부 경상남도교육청 경상남도김해교육지원청 삼방초등학교,17,17,0,17,4,7,1,5
교육기관,교육부,삼정중학교,교육부 경상남도교육청 경상남도김해교육지원청 삼정중학교,39,27,12,27,19,5,2,1
교육기관,교육부,생림중학교,교육부 경상남도교육청 경상남도김해교육지원청 생림중학교,16,15,1,15,12,2,1,0
교육기관,교육부,생림초등학교,교육부 경상남도교육청 경상남도김해교육지원청 생림초등학교,17,17,0,17,17,0,0,0
교육기관,교육부,석봉초등학교,교육부 경상남도교육청 경상남도김해교육지원청 석봉초등학교,20,20,0,20,20,0,0,0
교육기관,교육부,수남중학교,교육부 경상남도교육청 경상남도김해교육지원청 수남중학교,34,33,1,33,33,0,0,0
교육기관,교육부,수남초등학교,교육부 경상남도교육청 경상남도김해교육지원청 수남초등학교,21,21,0,21,21,0,0,0
교육기관,교육부,신어중학교,교육부 경상남도교육청 경상남도김해교육지원청 신어중학교,25,25,0,25,15,10,0,0
교육기관,교육부,신어초등학교,교육부 경상남도교육청 경상남도김해교육지원청 신어초등학교,23,23,0,23,5,18,0,0
교육기관,교육부,어방초등학교,교육부 경상남도교육청 경상남도김해교육지원청 어방초등학교,21,21,0,21,4,17,0,0
교육기관,교육부,영운중학교,교육부 경상남도교육청 경상남도김해교육지원청 영운중학교,48,48,0,48,48,0,0,0
교육기관,교육부,영운초등학교,교육부 경상남도교육청 경상남도김해교육지원청 영운초등학교,23,23,0,23,23,0,0,0
교육기관,교육부,용산초등학교,교육부 경상남도교육청 경상남도김해교육지원청 용산초등학교,12,12,0,12,12,0,0,0
교육기관,교육부,우암초등학교,교육부 경상남도교육청 경상남도김해교육지원청 우암초등학교,20,20,0,20,20,0,0,0
교육기관,교육부,월산중학교,교육부 경상남도교육청 경상남도김해교육지원청 월산중학교,16,16,0,16,4,10,2,0
교육기관,교육부,월산초등학교,교육부 경상남도교육청 경상남도김해교육지원청 월산초등학교,17,17,0,17,17,0,0,0
교육기관,교육부,율하중학교,교육부 경상남도교육청 경상남도김해교육지원청 율하중학교,36,36,0,36,0,36,0,0
교육기관,교육부,율하초등학교,교육부 경상남도교육청 경상남도김해교육지원청 율하초등학교,16,16,0,16,16,0,0,0
교육기관,교육부,이북초등학교,교육부 경상남도교육청 경상남도김해교육지원청 이북초등학교,13,13,0,13,13,0,0,0
교육기관,교육부,이작초등학교,교육부 경상남도교육청 경상남도김해교육지원청 이작초등학교,6,6,0,6,0,6,0,0
교육기관,교육부,임호중학교,교육부 경상남도교육청 경상남도김해교육지원청 임호중학교,30,30,0,30,26,4,0,0
교육기관,교육부,임호초등학교,교육부 경상남도교육청 경상남도김해교육지원청 임호초등학교,20,20,0,20,20,0,0,0
교육기관,교육부,장유유치원,교육부 경상남도교육청 경상남도김해교육지원청 장유유치원,35,35,0,35,35,0,0,0
교육기관,교육부,장유중학교,교육부 경상남도교육청 경상남도김해교육지원청 장유중학교,29,29,0,29,29,0,0,0
교육기관,교육부,장유초등학교,교육부 경상남도교육청 경상남도김해교육지원청 장유초등학교,17,17,0,17,17,0,0,0
교육기관,교육부,주석초등학교,교육부 경상남도교육청 경상남도김해교육지원청 주석초등학교,15,15,0,15,15,0,0,0
교육기관,교육부,주촌초등학교,교육부 경상남도교육청 경상남도김해교육지원청 주촌초등학교,7,7,0,7,3,2,1,1
교육기관,교육부,진례중학교,교육부 경상남도교육청 경상남도김해교육지원청 진례중학교,22,22,0,22,18,4,0,0
교육기관,교육부,진례초등학교,교육부 경상남도교육청 경상남도김해교육지원청 진례초등학교,20,20,0,20,12,8,0,0
교육기관,교육부,진영대창초등학교,교육부 경상남도교육청 경상남도김해교육지원청 진영대창초등학교,13,13,0,13,7,6,0,0
교육기관,교육부,진영대흥초등학교,교육부 경상남도교육청 경상남도김해교육지원청 진영대흥초등학교,22,22,0,22,0,22,0,0
교육기관,교육부,진영유치원,교육부 경상남도교육청 경상남도김해교육지원청 진영유치원,16,16,0,16,16,0,0,0
교육기관,교육부,진영장등중학교,교육부 경상남도교육청 경상남도김해교육지원청 진영장등중학교,27,27,0,27,26,1,0,0
교육기관,교육부,진영장등초등학교,교육부 경상남도교육청 경상남도김해교육지원청 진영장등초등학교,24,24,0,24,0,24,0,0
교육기관,교육부,진영중앙초등학교,교육부 경상남도교육청 경상남도김해교육지원청 진영중앙초등학교,61,61,0,61,49,12,0,0
교육기관,교육부,진영중학교,교육부 경상남도교육청 경상남도김해교육지원청 진영중학교,63,63,0,63,19,44,0,0
교육기관,교육부,칠산초등학교,교육부 경상남도교육청 경상남도김해교육지원청 칠산초등학교,10,10,0,10,6,4,0,0
교육기관,교육부,한림초등학교,교육부 경상남도교육청 경상남도김해교육지원청 한림초등학교,9,9,0,9,9,0,0,0
교육기관,교육부,한얼중학교,교육부 경상남도교육청 경상남도김해교육지원청 한얼중학교,41,41,0,41,24,12,5,0
교육기관,교육부,화정초등학교,교육부 경상남도교육청 경상남도김해교육지원청 화정초등학교,22,22,0,22,16,6,0,0
교육기관,교육부,활천중학교,교육부 경상남도교육청 경상남도김해교육지원청 활천중학교,24,24,0,24,0,24,0,0
교육기관,교육부,경상남도남해교육지원청,교육부 경상남도교육청 경상남도남해교육지원청,0,0,0,0,0,0,0,0
교육기관,교육부,경상남도교육청남해도서관,교육부 경상남도교육청 경상남도남해교육지원청 경상남도교육청남해도서관,10,10,0,10,6,4,0,0
교육기관,교육부,꽃내중학교,교육부 경상남도교육청 경상남도남해교육지원청 꽃내중학교,37,37,0,37,37,0,0,0
교육기관,교육부,남명초등학교,교육부 경상남도교육청 경상남도남해교육지원청 남명초등학교,16,16,0,16,11,3,1,1
교육기관,교육부,남해여자중학교,교육부 경상남도교육청 경상남도남해교육지원청 남해여자중학교,15,15,0,15,8,7,0,0
교육기관,교육부,남해유치원,교육부 경상남도교육청 경상남도남해교육지원청 남해유치원,15,15,0,15,3,12,0,0
교육기관,교육부,남해초등학교,교육부 경상남도교육청 경상남도남해교육지원청 남해초등학교,16,16,0,16,16,0,0,0
교육기관,교육부,도마초등학교,교육부 경상남도교육청 경상남도남해교육지원청 도마초등학교,17,17,0,17,13,4,0,0
교육기관,교육부,미조중학교,교육부 경상남도교육청 경상남도남해교육지원청 미조중학교,8,8,0,8,8,0,0,0
교육기관,교육부,미조초등학교,교육부 경상남도교육청 경상남도남해교육지원청 미조초등학교,11,11,0,11,11,0,0,0
교육기관,교육부,삼동초등학교,교육부 경상남도교육청 경상남도남해교육지원청 삼동초등학교,11,11,0,11,0,11,0,0
교육기관,교육부,상주초등학교,교육부 경상남도교육청 경상남도남해교육지원청 상주초등학교,13,13,0,13,5,8,0,0
교육기관,교육부,설천중학교,교육부 경상남도교육청 경상남도남해교육지원청 설천중학교,11,10,1,10,5,5,0,0
교육기관,교육부,설천초등학교,교육부 경상남도교육청 경상남도남해교육지원청 설천초등학교,15,15,0,15,7,8,0,0
교육기관,교육부,성명초등학교,교육부 경상남도교육청 경상남도남해교육지원청 성명초등학교,9,9,0,9,9,0,0,0
교육기관,교육부,이동초등학교,교육부 경상남도교육청 경상남도남해교육지원청 이동초등학교,15,15,0,15,10,5,0,0
교육기관,교육부,지족초등학교,교육부 경상남도교육청 경상남도남해교육지원청 지족초등학교,17,17,0,17,6,11,0,0
교육기관,교육부,창선초등학교,교육부 경상남도교육청 경상남도남해교육지원청 창선초등학교,10,10,0,10,10,0,0,0
교육기관,교육부,해양초등학교,교육부 경상남도교육청 경상남도남해교육지원청 해양초등학교,16,16,0,16,12,4,0,0
교육기관,교육부,경상남도밀양교육지원청,교육부 경상남도교육청 경상남도밀양교육지원청,7,7,0,7,3,4,0,0
교육기관,교육부,경상남도교육청밀양도서관,교육부 경상남도교육청 경상남도밀양교육지원청 경상남도교육청밀양도서관,12,12,0,12,5,7,0,0
교육기관,교육부,경상남도교육청하남도서관,교육부 경상남도교육청 경상남도밀양교육지원청 경상남도교육청하남도서관,8,8,0,8,0,8,0,0
교육기관,교육부,동국대학교사범대학부속홍제중학교,교육부 경상남도교육청 경상남도밀양교육지원청 동국대학교사범대학부속홍제중학교,15,14,1,14,7,6,1,0
교육기관,교육부,동명중학교,교육부 경상남도교육청 경상남도밀양교육지원청 동명중학교,17,17,0,17,0,17,0,0
교육기관,교육부,무안중학교,교육부 경상남도교육청 경상남도밀양교육지원청 무안중학교,9,9,0,9,6,3,0,0
교육기관,교육부,무안초등학교,교육부 경상남도교육청 경상남도밀양교육지원청 무안초등학교,20,20,0,20,20,0,0,0
교육기관,교육부,미리벌중학교,교육부 경상남도교육청 경상남도밀양교육지원청 미리벌중학교,40,40,0,40,0,40,0,0
교육기관,교육부,미리벌초등학교,교육부 경상남도교육청 경상남도밀양교육지원청 미리벌초등학교,24,24,0,24,24,0,0,0
교육기관,교육부,밀성여자중학교,교육부 경상남도교육청 경상남도밀양교육지원청 밀성여자중학교,22,22,0,22,10,12,0,0
교육기관,교육부,밀성중학교,교육부 경상남도교육청 경상남도밀양교육지원청 밀성중학교,23,23,0,23,10,13,0,0
교육기관,교육부,밀성초등학교,교육부 경상남도교육청 경상남도밀양교육지원청 밀성초등학교,30,30,0,30,18,12,0,0
교육기관,교육부,밀양동강중학교,교육부 경상남도교육청 경상남도밀양교육지원청 밀양동강중학교,11,10,1,10,5,4,0,1
교육기관,교육부,밀양여자중학교,교육부 경상남도교육청 경상남도밀양교육지원청 밀양여자중학교,30,30,0,30,30,0,0,0
교육기관,교육부,밀양유치원,교육부 경상남도교육청 경상남도밀양교육지원청 밀양유치원,5,5,0,5,3,2,0,0
교육기관,교육부,밀양중학교,교육부 경상남도교육청 경상남도밀양교육지원청 밀양중학교,35,35,0,35,0,35,0,0
교육기관,교육부,밀양초등학교,교육부 경상남도교육청 경상남도밀양교육지원청 밀양초등학교,35,35,0,35,35,0,0,0
교육기관,교육부,밀주초등학교,교육부 경상남도교육청 경상남도밀양교육지원청 밀주초등학교,24,24,0,24,24,0,0,0
교육기관,교육부,부북초등학교,교육부 경상남도교육청 경상남도밀양교육지원청 부북초등학교,10,10,0,10,6,4,0,0
교육기관,교육부,사포초등학교,교육부 경상남도교육청 경상남도밀양교육지원청 사포초등학교,10,10,0,10,6,4,0,0
교육기관,교육부,산내남명초등학교,교육부 경상남도교육청 경상남도밀양교육지원청 산내남명초등학교,11,11,0,11,11,0,0,0
교육기관,교육부,산내초등학교,교육부 경상남도교육청 경상남도밀양교육지원청 산내초등학교,8,8,0,8,8,0,0,0
교육기관,교육부,산동초등학교,교육부 경상남도교육청 경상남도밀양교육지원청 산동초등학교,9,9,0,9,6,3,0,0
교육기관,교육부,산외초등학교,교육부 경상남도교육청 경상남도밀양교육지원청 산외초등학교,10,10,0,10,10,0,0,0
교육기관,교육부,삼랑진중학교,교육부 경상남도교육청 경상남도밀양교육지원청 삼랑진중학교,20,20,0,20,20,0,0,0
교육기관,교육부,삼랑진초등학교,교육부 경상남도교육청 경상남도밀양교육지원청 삼랑진초등학교,12,12,0,12,8,4,0,0
교육기관,교육부,상남초등학교,교육부 경상남도교육청 경상남도밀양교육지원청 상남초등학교,11,11,0,11,6,5,0,0
교육기관,교육부,상동초등학교,교육부 경상남도교육청 경상남도밀양교육지원청 상동초등학교,20,20,0,20,17,3,0,0
교육기관,교육부,세종중학교,교육부 경상남도교육청 경상남도밀양교육지원청 세종중학교,12,12,0,12,0,12,0,0
교육기관,교육부,송진초등학교,교육부 경상남도교육청 경상남도밀양교육지원청 송진초등학교,16,16,0,16,8,8,0,0
교육기관,교육부,수산초등학교,교육부 경상남도교육청 경상남도밀양교육지원청 수산초등학교,13,13,0,13,10,3,0,0
교육기관,교육부,숭진초등학교,교육부 경상남도교육청 경상남도밀양교육지원청 숭진초등학교,6,6,0,6,6,0,0,0
교육기관,교육부,예림초등학교,교육부 경상남도교육청 경상남도밀양교육지원청 예림초등학교,36,36,0,36,1,35,0,0
교육기관,교육부,청도초등학교,교육부 경상남도교육청 경상남도밀양교육지원청 청도초등학교,5,5,0,5,5,0,0,0
교육기관,교육부,초동초등학교,교육부 경상남도교육청 경상남도밀양교육지원청 초동초등학교,18,18,0,18,18,0,0,0
교육기관,교육부,태룡초등학교,교육부 경상남도교육청 경상남도밀양교육지원청 태룡초등학교,9,9,0,9,9,0,0,0
교육기관,교육부,경상남도교육청사천도서관,교육부 경상남도교육청 경상남도사천교육지원청 경상남도교육청사천도서관,16,16,0,16,8,8,0,0
교육기관,교육부,경상남도교육청삼천포도서관,교육부 경상남도교육청 경상남도사천교육지원청 경상남도교육청삼천포도서관,12,12,0,12,6,6,0,0
교육기관,교육부,경상남도교육청삼천포학생체육관,교육부 경상남도교육청 경상남도사천교육지원청 경상남도교육청삼천포학생체육관,4,4,0,4,2,2,0,0
교육기관,교육부,곤명중학교,교육부 경상남도교육청 경상남도사천교육지원청 곤명중학교,16,15,1,15,8,7,0,0
교육기관,교육부,곤명초등학교,교육부 경상남도교육청 경상남도사천교육지원청 곤명초등학교,13,13,0,13,3,5,3,2
교육기관,교육부,곤양중학교,교육부 경상남도교육청 경상남도사천교육지원청 곤양중학교,12,12,0,12,12,0,0,0
교육기관,교육부,곤양초등학교,교육부 경상남도교육청 경상남도사천교육지원청 곤양초등학교,13,13,0,13,13,0,0,0
교육기관,교육부,남양중학교,교육부 경상남도교육청 경상남도사천교육지원청 남양중학교,40,40,0,40,13,27,0,0
교육기관,교육부,남양초등학교,교육부 경상남도교육청 경상남도사천교육지원청 남양초등학교,11,11,0,11,8,3,0,0
교육기관,교육부,노산초등학교,교육부 경상남도교육청 경상남도사천교육지원청 노산초등학교,25,25,0,25,0,25,0,0
교육기관,교육부,대방초등학교,교육부 경상남도교육청 경상남도사천교육지원청 대방초등학교,16,16,0,16,16,0,0,0
교육기관,교육부,대성초등학교,교육부 경상남도교육청 경상남도사천교육지원청 대성초등학교,16,16,0,16,16,0,0,0
교육기관,교육부,동성초등학교,교육부 경상남도교육청 경상남도사천교육지원청 동성초등학교,24,24,0,24,24,0,0,0
교육기관,교육부,문선초등학교,교육부 경상남도교육청 경상남도사천교육지원청 문선초등학교,46,46,0,46,14,27,0,5
교육기관,교육부,사남초등학교,교육부 경상남도교육청 경상남도사천교육지원청 사남초등학교,18,18,0,18,18,0,0,0
교육기관,교육부,사천여자중학교,교육부 경상남도교육청 경상남도사천교육지원청 사천여자중학교,18,18,0,18,0,18,0,0
교육기관,교육부,사천유치원,교육부 경상남도교육청 경상남도사천교육지원청 사천유치원,33,33,0,33,33,0,0,0
교육기관,교육부,사천중학교,교육부 경상남도교육청 경상남도사천교육지원청 사천중학교,33,33,0,33,23,10,0,0
교육기관,교육부,사천초등학교,교육부 경상남도교육청 경상남도사천교육지원청 사천초등학교,20,20,0,20,15,5,0,0
교육기관,교육부,삼성초등학교,교육부 경상남도교육청 경상남도사천교육지원청 삼성초등학교,14,14,0,14,14,0,0,0
교육기관,교육부,삼천포여자중학교,교육부 경상남도교육청 경상남도사천교육지원청 삼천포여자중학교,28,26,2,26,23,2,1,0
교육기관,교육부,삼천포제일중학교,교육부 경상남도교육청 경상남도사천교육지원청 삼천포제일중학교,38,38,0,38,38,0,0,0
교육기관,교육부,삼천포중앙여자중학교,교육부 경상남도교육청 경상남도사천교육지원청 삼천포중앙여자중학교,15,15,0,15,15,0,0,0
교육기관,교육부,삼천포중학교,교육부 경상남도교육청 경상남도사천교육지원청 삼천포중학교,28,27,1,27,17,10,0,0
교육기관,교육부,삼천포초등학교,교육부 경상남도교육청 경상남도사천교육지원청 삼천포초등학교,14,14,0,14,14,0,0,0
교육기관,교육부,서포중학교,교육부 경상남도교육청 경상남도사천교육지원청 서포중학교,9,9,0,9,9,0,0,0
교육기관,교육부,서포초등학교,교육부 경상남도교육청 경상남도사천교육지원청 서포초등학교,9,9,0,9,9,0,0,0
교육기관,교육부,선진유치원,교육부 경상남도교육청 경상남도사천교육지원청 선진유치원,20,20,0,20,7,13,0,0
교육기관,교육부,수양초등학교,교육부 경상남도교육청 경상남도사천교육지원청 수양초등학교,15,15,0,15,15,0,0,0
교육기관,교육부,용남중학교,교육부 경상남도교육청 경상남도사천교육지원청 용남중학교,39,38,1,38,6,32,0,0
교육기관,교육부,용산초등학교,교육부 경상남도교육청 경상남도사천교육지원청 용산초등학교,18,18,0,18,17,1,0,0
교육기관,교육부,용현초등학교,교육부 경상남도교육청 경상남도사천교육지원청 용현초등학교,21,21,0,21,21,0,0,0
교육기관,교육부,정동초등학교,교육부 경상남도교육청 경상남도사천교육지원청 정동초등학교,7,7,0,7,6,0,0,1
교육기관,교육부,축동초등학교,교육부 경상남도교육청 경상남도사천교육지원청 축동초등학교,10,10,0,10,10,0,0,0
교육기관,교육부,경상남도산청교육지원청,교육부 경상남도교육청 경상남도산청교육지원청,0,0,0,0,0,0,0,0
교육기관,교육부,경상남도교육청산청도서관,교육부 경상남도교육청 경상남도산청교육지원청 경상남도교육청산청도서관,7,7,0,7,3,4,0,0
교육기관,교육부,경상남도교육청산청지리산도서관,교육부 경상남도교육청 경상남도산청교육지원청 경상남도교육청산청지리산도서관,16,16,0,16,0,16,0,0
교육기관,교육부,경상남도교육청산청학생야영수련원,교육부 경상남도교육청 경상남도산청교육지원청 경상남도교육청산청학생야영수련원,4,4,0,4,4,0,0,0
교육기관,교육부,금서초등학교,교육부 경상남도교육청 경상남도산청교육지원청 금서초등학교,11,11,0,11,6,5,0,0
교육기관,교육부,단계초등학교,교육부 경상남도교육청 경상남도산청교육지원청 단계초등학교,11,11,0,11,11,0,0,0
교육기관,교육부,단성중학교,교육부 경상남도교육청 경상남도산청교육지원청 단성중학교,14,14,0,14,14,0,0,0
교육기관,교육부,단성초등학교,교육부 경상남도교육청 경상남도산청교육지원청 단성초등학교,16,16,0,16,16,0,0,0
교육기관,교육부,덕산중학교,교육부 경상남도교육청 경상남도산청교육지원청 덕산중학교,12,12,0,12,12,0,0,0
교육기관,교육부,덕산초등학교,교육부 경상남도교육청 경상남도산청교육지원청 덕산초등학교,15,15,0,15,15,0,0,0
교육기관,교육부,도산초등학교,교육부 경상남도교육청 경상남도산청교육지원청 도산초등학교,10,10,0,10,10,0,0,0
교육기관,교육부,산청유치원,교육부 경상남도교육청 경상남도산청교육지원청 산청유치원,21,21,0,21,21,0,0,0
교육기관,교육부,산청중학교,교육부 경상남도교육청 경상남도산청교육지원청 산청중학교,46,46,0,46,23,21,1,1
교육기관,교육부,산청초등학교,교육부 경상남도교육청 경상남도산청교육지원청 산청초등학교,21,21,0,21,19,2,0,0
교육기관,교육부,삼장초등학교,교육부 경상남도교육청 경상남도산청교육지원청 삼장초등학교,10,8,2,8,3,3,1,1
교육기관,교육부,생비량초등학교,교육부 경상남도교육청 경상남도산청교육지원청 생비량초등학교,13,13,0,13,13,0,0,0
교육기관,교육부,생초초등학교,교육부 경상남도교육청 경상남도산청교육지원청 생초초등학교,16,16,0,16,0,16,0,0
교육기관,교육부,신등중학교,교육부 경상남도교육청 경상남도산청교육지원청 신등중학교,5,5,0,5,2,2,1,0
교육기관,교육부,신안초등학교,교육부 경상남도교육청 경상남도산청교육지원청 신안초등학교,17,17,0,17,12,2,2,1
교육기관,교육부,신천초등학교,교육부 경상남도교육청 경상남도산청교육지원청 신천초등학교,12,12,0,12,12,0,0,0
교육기관,교육부,오부초등학교,교육부 경상남도교육청 경상남도산청교육지원청 오부초등학교,18,18,0,18,14,2,2,0
교육기관,교육부,차황초등학교,교육부 경상남도교육청 경상남도산청교육지원청 차황초등학교,14,14,0,14,14,0,0,0
교육기관,교육부,경상남도양산교육지원청,교육부 경상남도교육청 경상남도양산교육지원청,16,16,0,16,4,12,0,0
교육기관,교육부,가남초등학교,교육부 경상남도교육청 경상남도양산교육지원청 가남초등학교,21,21,0,21,21,0,0,0
교육기관,교육부,가양초등학교,교육부 경상남도교육청 경상남도양산교육지원청 가양초등학교,28,28,0,28,26,2,0,0
교육기관,교육부,가촌초등학교,교육부 경상남도교육청 경상남도양산교육지원청 가촌초등학교,57,57,0,57,10,47,0,0
교육기관,교육부,개운중학교,교육부 경상남도교육청 경상남도양산교육지원청 개운중학교,74,74,0,74,0,74,0,0
교육기관,교육부,경상남도교육청양산도서관,교육부 경상남도교육청 경상남도양산교육지원청 경상남도교육청양산도서관,32,32,0,32,0,32,0,0
교육기관,교육부,금오중학교,교육부 경상남도교육청 경상남도양산교육지원청 금오중학교,68,67,1,67,67,0,0,0
교육기관,교육부,금오초등학교,교육부 경상남도교육청 경상남도양산교육지원청 금오초등학교,46,46,0,46,10,32,4,0
교육기관,교육부,대운초등학교,교육부 경상남도교육청 경상남도양산교육지원청 대운초등학교,32,32,0,32,16,16,0,0
교육기관,교육부,덕계초등학교,교육부 경상남도교육청 경상남도양산교육지원청 덕계초등학교,29,29,0,29,0,29,0,0
교육기관,교육부,동면유치원,교육부 경상남도교육청 경상남도양산교육지원청 동면유치원,32,32,0,32,10,22,0,0
교육기관,교육부,동면초등학교,교육부 경상남도교육청 경상남도양산교육지원청 동면초등학교,57,50,7,50,48,2,0,0
교육기관,교육부,동산초등학교,교육부 경상남도교육청 경상남도양산교육지원청 동산초등학교,21,21,0,21,5,16,0,0
교육기관,교육부,명동유치원,교육부 경상남도교육청 경상남도양산교육지원청 명동유치원,16,15,1,15,1,11,1,2
교육기관,교육부,물금유치원,교육부 경상남도교육청 경상남도양산교육지원청 물금유치원,23,0,23,0,0,0,0,0
교육기관,교육부,물금중학교,교육부 경상남도교육청 경상남도양산교육지원청 물금중학교,67,67,0,67,34,33,0,0
교육기관,교육부,물금초등학교,교육부 경상남도교육청 경상남도양산교육지원청 물금초등학교,33,33,0,33,33,0,0,0
교육기관,교육부,백동초등학교,교육부 경상남도교육청 경상남도양산교육지원청 백동초등학교,19,19,0,19,19,0,0,0
교육기관,교육부,범어중학교,교육부 경상남도교육청 경상남도양산교육지원청 범어중학교,40,40,0,40,12,28,0,0
교육기관,교육부,범어초등학교,교육부 경상남도교육청 경상남도양산교육지원청 범어초등학교,13,13,0,13,13,0,0,0
교육기관,교육부,보광중학교,교육부 경상남도교육청 경상남도양산교육지원청 보광중학교,21,21,0,21,7,14,0,0
교육기관,교육부,북정초등학교,교육부 경상남도교육청 경상남도양산교육지원청 북정초등학교,16,16,0,16,16,0,0,0
교육기관,교육부,삼성중학교,교육부 경상남도교육청 경상남도양산교육지원청 삼성중학교,25,25,0,25,19,6,0,0
교육기관,교육부,삼성초등학교,교육부 경상남도교육청 경상남도양산교육지원청 삼성초등학교,17,17,0,17,4,13,0,0
교육기관,교육부,상북초등학교,교육부 경상남도교육청 경상남도양산교육지원청 상북초등학교,18,16,2,16,16,0,0,0
교육기관,교육부,서남초등학교,교육부 경상남도교육청 경상남도양산교육지원청 서남초등학교,15,15,0,15,3,12,0,0
교육기관,교육부,서창중학교,교육부 경상남도교육청 경상남도양산교육지원청 서창중학교,48,48,0,48,48,0,0,0
교육기관,교육부,서창초등학교,교육부 경상남도교육청 경상남도양산교육지원청 서창초등학교,21,21,0,21,21,0,0,0
교육기관,교육부,석산초등학교,교육부 경상남도교육청 경상남도양산교육지원청 석산초등학교,26,26,0,26,11,15,0,0
교육기관,교육부,성산초등학교,교육부 경상남도교육청 경상남도양산교육지원청 성산초등학교,15,15,0,15,12,3,0,0
교육기관,교육부,소토초등학교,교육부 경상남도교육청 경상남도양산교육지원청 소토초등학교,26,26,0,26,13,13,0,0
교육기관,교육부,신기초등학교,교육부 경상남도교육청 경상남도양산교육지원청 신기초등학교,29,29,0,29,29,0,0,0
교육기관,교육부,신명초등학교,교육부 경상남도교육청 경상남도양산교육지원청 신명초등학교,32,32,0,32,11,16,2,3
교육기관,교육부,신양초등학교,교육부 경상남도교육청 경상남도양산교육지원청 신양초등학교,23,23,0,23,13,10,0,0
교육기관,교육부,신주중학교,교육부 경상남도교육청 경상남도양산교육지원청 신주중학교,32,32,0,32,11,21,0,0
교육기관,교육부,신주초등학교,교육부 경상남도교육청 경상남도양산교육지원청 신주초등학교,43,43,0,43,27,16,0,0
교육기관,교육부,양산여자중학교,교육부 경상남도교육청 경상남도양산교육지원청 양산여자중학교,30,30,0,30,30,0,0,0
교육기관,교육부,양산유치원,교육부 경상남도교육청 경상남도양산교육지원청 양산유치원,10,10,0,10,10,0,0,0
교육기관,교육부,양산중앙중학교,교육부 경상남도교육청 경상남도양산교육지원청 양산중앙중학교,29,28,1,28,28,0,0,0
교육기관,교육부,양산초등학교,교육부 경상남도교육청 경상남도양산교육지원청 양산초등학교,21,21,0,21,0,21,0,0
교육기관,교육부,양주초등학교,교육부 경상남도교육청 경상남도양산교육지원청 양주초등학교,16,16,0,16,8,8,0,0
교육기관,교육부,어곡초등학교,교육부 경상남도교육청 경상남도양산교육지원청 어곡초등학교,32,32,0,32,22,10,0,0
교육기관,교육부,영천초등학교,교육부 경상남도교육청 경상남도양산교육지원청 영천초등학교,12,12,0,12,12,0,0,0
교육기관,교육부,오봉유치원,교육부 경상남도교육청 경상남도양산교육지원청 오봉유치원,10,10,0,10,0,10,0,0
교육기관,교육부,오봉초등학교,교육부 경상남도교육청 경상남도양산교육지원청 오봉초등학교,31,31,0,31,31,0,0,0
교육기관,교육부,용연초등학교,교육부 경상남도교육청 경상남도양산교육지원청 용연초등학교,11,11,0,11,11,0,0,0
교육기관,교육부,웅상여자중학교,교육부 경상남도교육청 경상남도양산교육지원청 웅상여자중학교,35,7,28,7,2,2,3,0
교육기관,교육부,웅상중학교,교육부 경상남도교육청 경상남도양산교육지원청 웅상중학교,32,32,0,32,24,8,0,0
교육기관,교육부,웅상초등학교,교육부 경상남도교육청 경상남도양산교육지원청 웅상초등학교,43,43,0,43,5,30,4,4
교육기관,교육부,원동중학교,교육부 경상남도교육청 경상남도양산교육지원청 원동중학교,15,15,0,15,7,6,1,1
교육기관,교육부,원동초등학교이천분교장,교육부 경상남도교육청 경상남도양산교육지원청 원동초등학교이천분교장,5,5,0,5,0,5,0,0
교육기관,교육부,좌삼초등학교,교육부 경상남도교육청 경상남도양산교육지원청 좌삼초등학교,14,14,0,14,14,0,0,0
교육기관,교육부,중부초등학교,교육부 경상남도교육청 경상남도양산교육지원청 중부초등학교,28,28,0,28,28,0,0,0
교육기관,교육부,천성초등학교,교육부 경상남도교육청 경상남도양산교육지원청 천성초등학교,17,17,0,17,17,0,0,0
교육기관,교육부,평산초등학교,교육부 경상남도교육청 경상남도양산교육지원청 평산초등학교,19,19,0,19,10,9,0,0
교육기관,교육부,하북초등학교,교육부 경상남도교육청 경상남도양산교육지원청 하북초등학교,6,6,0,6,6,0,0,0
교육기관,교육부,화제초등학교,교육부 경상남도교육청 경상남도양산교육지원청 화제초등학교,10,10,0,10,8,2,0,0
교육기관,교육부,황산초등학교,교육부 경상남도교육청 경상남도양산교육지원청 황산초등학교,16,16,0,16,7,9,0,0
교육기관,교육부,회야초등학교,교육부 경상남도교육청 경상남도양산교육지원청 회야초등학교,46,44,2,44,16,28,0,0
교육기관,교육부,가례초등학교,교육부 경상남도교육청 경상남도의령교육지원청 가례초등학교,12,12,0,12,4,8,0,0
교육기관,교육부,경상남도교육청의령도서관,교육부 경상남도교육청 경상남도의령교육지원청 경상남도교육청의령도서관,16,16,0,16,8,8,0,0
교육기관,교육부,궁류초등학교,교육부 경상남도교육청 경상남도의령교육지원청 궁류초등학교,11,11,0,11,3,6,1,1
교육기관,교육부,낙서초등학교,교육부 경상남도교육청 경상남도의령교육지원청 낙서초등학교,9,9,0,9,9,0,0,0
교육기관,교육부,남산초등학교,교육부 경상남도교육청 경상남도의령교육지원청 남산초등학교,11,11,0,11,0,11,0,0
교육기관,교육부,대의초등학교,교육부 경상남도교육청 경상남도의령교육지원청 대의초등학교,8,8,0,8,0,8,0,0
교육기관,교육부,부림초등학교,교육부 경상남도교육청 경상남도의령교육지원청 부림초등학교,14,14,0,14,14,0,0,0
교육기관,교육부,신반중학교,교육부 경상남도교육청 경상남도의령교육지원청 신반중학교,17,17,0,17,0,17,0,0
교육기관,교육부,용덕초등학교,교육부 경상남도교육청 경상남도의령교육지원청 용덕초등학교,10,10,0,10,0,10,0,0
교육기관,교육부,유곡초등학교,교육부 경상남도교육청 경상남도의령교육지원청 유곡초등학교,13,13,0,13,0,13,0,0
교육기관,교육부,의령여자중학교,교육부 경상남도교육청 경상남도의령교육지원청 의령여자중학교,10,10,0,10,5,5,0,0
교육기관,교육부,의령유치원,교육부 경상남도교육청 경상남도의령교육지원청 의령유치원,16,16,0,16,7,9,0,0
교육기관,교육부,의령중학교,교육부 경상남도교육청 경상남도의령교육지원청 의령중학교,16,16,0,16,8,8,0,0
교육기관,교육부,의령초등학교,교육부 경상남도교육청 경상남도의령교육지원청 의령초등학교,17,17,0,17,0,17,0,0
교육기관,교육부,정곡중학교,교육부 경상남도교육청 경상남도의령교육지원청 정곡중학교,8,8,0,8,8,0,0,0
교육기관,교육부,정곡초등학교,교육부 경상남도교육청 경상남도의령교육지원청 정곡초등학교,13,13,0,13,13,0,0,0
교육기관,교육부,지정중학교,교육부 경상남도교육청 경상남도의령교육지원청 지정중학교,7,6,1,6,0,6,0,0
교육기관,교육부,지정초등학교,교육부 경상남도교육청 경상남도의령교육지원청 지정초등학교,15,15,0,15,11,4,0,0
교육기관,교육부,칠곡초등학교,교육부 경상남도교육청 경상남도의령교육지원청 칠곡초등학교,16,16,0,16,0,16,0,0
교육기관,교육부,화정초등학교,교육부 경상남도교육청 경상남도의령교육지원청 화정초등학교,8,8,0,8,3,3,1,1
교육기관,교육부,경상남도진주교육지원청,교육부 경상남도교육청 경상남도진주교육지원청,12,12,0,12,0,12,0,0
교육기관,교육부,가람초등학교,교육부 경상남도교육청 경상남도진주교육지원청 가람초등학교,22,22,0,22,22,0,0,0
교육기관,교육부,가좌초등학교,교육부 경상남도교육청 경상남도진주교육지원청 가좌초등학교,24,24,0,24,24,0,0,0
교육기관,교육부,갈전초등학교,교육부 경상남도교육청 경상남도진주교육지원청 갈전초등학교,31,31,0,31,0,31,0,0
교육기관,교육부,개양중학교,교육부 경상남도교육청 경상남도진주교육지원청 개양중학교,23,23,0,23,23,0,0,0
교육기관,교육부,경상남도교육청예술교육원해봄,교육부 경상남도교육청 경상남도진주교육지원청 경상남도교육청예술교육원해봄,44,17,27,17,12,5,0,0
교육기관,교육부,경상남도교육청진양도서관,교육부 경상남도교육청 경상남도진주교육지원청 경상남도교육청진양도서관,14,14,0,14,8,6,0,0
교육기관,교육부,경상남도교육청진주학생수영장,교육부 경상남도교육청 경상남도진주교육지원청 경상남도교육청진주학생수영장,4,4,0,4,0,4,0,0
교육기관,교육부,경상남도교육청진주학생체육관,교육부 경상남도교육청 경상남도진주교육지원청 경상남도교육청진주학생체육관,4,4,0,4,4,0,0,0
교육기관,교육부,경해여자중학교,교육부 경상남도교육청 경상남도진주교육지원청 경해여자중학교,23,23,0,23,4,19,0,0
교육기관,교육부,관봉초등학교,교육부 경상남도교육청 경상남도진주교육지원청 관봉초등학교,7,7,0,7,7,0,0,0
교육기관,교육부,금곡중학교,교육부 경상남도교육청 경상남도진주교육지원청 금곡중학교,10,10,0,10,0,10,0,0
교육기관,교육부,금곡초등학교,교육부 경상남도교육청 경상남도진주교육지원청 금곡초등학교,10,10,0,10,5,5,0,0
교육기관,교육부,금산초등학교,교육부 경상남도교육청 경상남도진주교육지원청 금산초등학교,22,22,0,22,22,0,0,0
교육기관,교육부,금성초등학교,교육부 경상남도교육청 경상남도진주교육지원청 금성초등학교,24,24,0,24,20,4,0,0
교육기관,교육부,금호초등학교,교육부 경상남도교육청 경상남도진주교육지원청 금호초등학교,20,20,0,20,0,20,0,0
교육기관,교육부,남강초등학교,교육부 경상남도교육청 경상남도진주교육지원청 남강초등학교,24,24,0,24,24,0,0,0
교육기관,교육부,내동초등학교,교육부 경상남도교육청 경상남도진주교육지원청 내동초등학교,13,13,0,13,6,7,0,0
교육기관,교육부,대곡중학교,교육부 경상남도교육청 경상남도진주교육지원청 대곡중학교,51,50,1,50,0,50,0,0
교육기관,교육부,대곡초등학교,교육부 경상남도교육청 경상남도진주교육지원청 대곡초등학교,8,8,0,8,0,8,0,0
교육기관,교육부,도동초등학교,교육부 경상남도교육청 경상남도진주교육지원청 도동초등학교,28,28,0,28,28,0,0,0
교육기관,교육부,동진초등학교,교육부 경상남도교육청 경상남도진주교육지원청 동진초등학교,28,28,0,28,20,8,0,0
교육기관,교육부,망경초등학교,교육부 경상남도교육청 경상남도진주교육지원청 망경초등학교,25,25,0,25,25,0,0,0
교육기관,교육부,명석중학교,교육부 경상남도교육청 경상남도진주교육지원청 명석중학교,16,15,1,15,12,3,0,0
교육기관,교육부,명석초등학교,교육부 경상남도교육청 경상남도진주교육지원청 명석초등학교,14,13,1,13,3,10,0,0
교육기관,교육부,무지개초등학교,교육부 경상남도교육청 경상남도진주교육지원청 무지개초등학교,21,21,0,21,21,0,0,0
교육기관,교육부,문산중학교,교육부 경상남도교육청 경상남도진주교육지원청 문산중학교,50,50,0,50,49,1,0,0
교육기관,교육부,문산초등학교,교육부 경상남도교육청 경상남도진주교육지원청 문산초등학교,22,22,0,22,22,0,0,0
교육기관,교육부,미천초등학교,교육부 경상남도교육청 경상남도진주교육지원청 미천초등학교,6,6,0,6,5,1,0,0
교육기관,교육부,반성중학교,교육부 경상남도교육청 경상남도진주교육지원청 반성중학교,13,13,0,13,0,13,0,0
교육기관,교육부,반성초등학교,교육부 경상남도교육청 경상남도진주교육지원청 반성초등학교,16,16,0,16,16,0,0,0
교육기관,교육부,배영초등학교,교육부 경상남도교육청 경상남도진주교육지원청 배영초등학교,21,21,0,21,2,19,0,0
교육기관,교육부,봉곡초등학교,교육부 경상남도교육청 경상남도진주교육지원청 봉곡초등학교,16,16,0,16,16,0,0,0
교육기관,교육부,봉래초등학교,교육부 경상남도교육청 경상남도진주교육지원청 봉래초등학교,17,17,0,17,17,0,0,0
교육기관,교육부,봉원초등학교,교육부 경상남도교육청 경상남도진주교육지원청 봉원초등학교,21,21,0,21,15,6,0,0
교육기관,교육부,사봉초등학교,교육부 경상남도교육청 경상남도진주교육지원청 사봉초등학교,17,17,0,17,17,0,0,0
교육기관,교육부,삼현여자중학교,교육부 경상남도교육청 경상남도진주교육지원청 삼현여자중학교,20,20,0,20,3,17,0,0
교육기관,교육부,서진초등학교,교육부 경상남도교육청 경상남도진주교육지원청 서진초등학교,29,29,0,29,29,0,0,0
교육기관,교육부,선인국제중학교,교육부 경상남도교육청 경상남도진주교육지원청 선인국제중학교,21,20,1,20,10,10,0,0
교육기관,교육부,선학초등학교,교육부 경상남도교육청 경상남도진주교육지원청 선학초등학교,13,13,0,13,13,0,0,0
교육기관,교육부,수곡초등학교,교육부 경상남도교육청 경상남도진주교육지원청 수곡초등학교,12,12,0,12,6,6,0,0
교육기관,교육부,수정초등학교,교육부 경상남도교육청 경상남도진주교육지원청 수정초등학교,32,32,0,32,16,16,0,0
교육기관,교육부,신안초등학교,교육부 경상남도교육청 경상남도진주교육지원청 신안초등학교,16,16,0,16,0,16,0,0
교육기관,교육부,신진초등학교,교육부 경상남도교육청 경상남도진주교육지원청 신진초등학교,25,25,0,25,0,25,0,0
교육기관,교육부,예하초등학교,교육부 경상남도교육청 경상남도진주교육지원청 예하초등학교,40,38,2,38,6,32,0,0
교육기관,교육부,은하수초등학교,교육부 경상남도교육청 경상남도진주교육지원청 은하수초등학교,47,13,34,13,7,6,0,0
교육기관,교육부,이반성초등학교,교육부 경상남도교육청 경상남도진주교육지원청 이반성초등학교,10,10,0,10,5,5,0,0
교육기관,교육부,장재초등학교,교육부 경상남도교육청 경상남도진주교육지원청 장재초등학교,44,44,0,44,44,0,0,0
교육기관,교육부,정촌초등학교,교육부 경상남도교육청 경상남도진주교육지원청 정촌초등학교,26,26,0,26,0,26,0,0
교육기관,교육부,주약초등학교,교육부 경상남도교육청 경상남도진주교육지원청 주약초등학교,20,20,0,20,20,0,0,0
교육기관,교육부,지수중학교,교육부 경상남도교육청 경상남도진주교육지원청 지수중학교,6,5,1,5,0,5,0,0
교육기관,교육부,지수초등학교,교육부 경상남도교육청 경상남도진주교육지원청 지수초등학교,9,9,0,9,0,9,0,0
교육기관,교육부,진명여자중학교,교육부 경상남도교육청 경상남도진주교육지원청 진명여자중학교,23,12,11,12,0,12,0,0
교육기관,교육부,진서중학교,교육부 경상남도교육청 경상남도진주교육지원청 진서중학교,10,10,0,10,10,0,0,0
교육기관,교육부,진성초등학교,교육부 경상남도교육청 경상남도진주교육지원청 진성초등학교,12,12,0,12,12,0,0,0
교육기관,교육부,진주남중학교,교육부 경상남도교육청 경상남도진주교육지원청 진주남중학교,35,34,1,34,25,9,0,0
교육기관,교육부,진주누리유치원,교육부 경상남도교육청 경상남도진주교육지원청 진주누리유치원,25,25,0,25,22,3,0,0
교육기관,교육부,진주동명중학교,교육부 경상남도교육청 경상남도진주교육지원청 진주동명중학교,51,51,0,51,0,51,0,0
교육기관,교육부,진주동중학교,교육부 경상남도교육청 경상남도진주교육지원청 진주동중학교,43,43,0,43,28,15,0,0
교육기관,교육부,진주봉원중학교,교육부 경상남도교육청 경상남도진주교육지원청 진주봉원중학교,29,29,0,29,13,14,1,1
교육기관,교육부,진주여자중학교,교육부 경상남도교육청 경상남도진주교육지원청 진주여자중학교,31,31,0,31,9,22,0,0
교육기관,교육부,진주유치원,교육부 경상남도교육청 경상남도진주교육지원청 진주유치원,8,8,0,8,0,6,2,0
교육기관,교육부,진주제일중학교,교육부 경상남도교육청 경상남도진주교육지원청 진주제일중학교,101,93,8,93,1,92,0,0
교육기관,교육부,진주중앙중학교,교육부 경상남도교육청 경상남도진주교육지원청 진주중앙중학교,54,54,0,54,12,38,2,2
교육기관,교육부,진주중학교,교육부 경상남도교육청 경상남도진주교육지원청 진주중학교,18,18,0,18,5,13,0,0
교육기관,교육부,진주초등학교,교육부 경상남도교육청 경상남도진주교육지원청 진주초등학교,28,28,0,28,28,0,0,0
교육기관,교육부,집현초등학교,교육부 경상남도교육청 경상남도진주교육지원청 집현초등학교,22,22,0,22,22,0,0,0
교육기관,교육부,천전초등학교,교육부 경상남도교육청 경상남도진주교육지원청 천전초등학교,13,13,0,13,11,2,0,0
교육기관,교육부,초전초등학교,교육부 경상남도교육청 경상남도진주교육지원청 초전초등학교,28,28,0,28,0,28,0,0
교육기관,교육부,촉석초등학교,교육부 경상남도교육청 경상남도진주교육지원청 촉석초등학교,22,22,0,22,18,4,0,0
교육기관,교육부,충무공초등학교,교육부 경상남도교육청 경상남도진주교육지원청 충무공초등학교,49,49,0,49,49,0,0,0
교육기관,교육부,평거초등학교,교육부 경상남도교육청 경상남도진주교육지원청 평거초등학교,23,23,0,23,19,4,0,0
교육기관,교육부,한울유치원,교육부 경상남도교육청 경상남도진주교육지원청 한울유치원,13,4,9,4,4,0,0,0
교육기관,교육부,경상남도창녕교육지원청,교육부 경상남도교육청 경상남도창녕교육지원청,10,10,0,10,8,2,0,0
교육기관,교육부,경상남도교육청남지도서관,교육부 경상남도교육청 경상남도창녕교육지원청 경상남도교육청남지도서관,8,8,0,8,3,5,0,0
교육기관,교육부,경상남도교육청창녕도서관,교육부 경상남도교육청 경상남도창녕교육지원청 경상남도교육청창녕도서관,17,13,4,13,5,3,1,4
교육기관,교육부,계창초등학교,교육부 경상남도교육청 경상남도창녕교육지원청 계창초등학교,12,12,0,12,12,0,0,0
교육기관,교육부,고암초등학교,교육부 경상남도교육청 경상남도창녕교육지원청 고암초등학교,14,14,0,14,7,7,0,0
교육기관,교육부,길곡초등학교,교육부 경상남도교육청 경상남도창녕교육지원청 길곡초등학교,8,8,0,8,8,0,0,0
교육기관,교육부,남지여자중학교,교육부 경상남도교육청 경상남도창녕교육지원청 남지여자중학교,16,16,0,16,6,10,0,0
교육기관,교육부,남지중학교,교육부 경상남도교육청 경상남도창녕교육지원청 남지중학교,10,10,0,10,10,0,0,0
교육기관,교육부,남지초등학교,교육부 경상남도교육청 경상남도창녕교육지원청 남지초등학교,19,19,0,19,19,0,0,0
교육기관,교육부,대지초등학교,교육부 경상남도교육청 경상남도창녕교육지원청 대지초등학교,5,5,0,5,0,5,0,0
교육기관,교육부,대합초등학교,교육부 경상남도교육청 경상남도창녕교육지원청 대합초등학교,10,8,2,8,8,0,0,0
교육기관,교육부,도천초등학교,교육부 경상남도교육청 경상남도창녕교육지원청 도천초등학교,7,7,0,7,7,0,0,0
교육기관,교육부,동포초등학교,교육부 경상남도교육청 경상남도창녕교육지원청 동포초등학교,15,15,0,15,0,15,0,0
교육기관,교육부,명덕초등학교,교육부 경상남도교육청 경상남도창녕교육지원청 명덕초등학교,27,27,0,27,27,0,0,0
교육기관,교육부,부곡중학교,교육부 경상남도교육청 경상남도창녕교육지원청 부곡중학교,21,20,1,20,20,0,0,0
교육기관,교육부,부곡초등학교,교육부 경상남도교육청 경상남도창녕교육지원청 부곡초등학교,14,14,0,14,0,14,0,0
교육기관,교육부,부곡초등학교학포분교장,교육부 경상남도교육청 경상남도창녕교육지원청 부곡초등학교학포분교장,5,5,0,5,0,5,0,0
교육기관,교육부,성산중학교,교육부 경상남도교육청 경상남도창녕교육지원청 성산중학교,15,15,0,15,11,4,0,0
교육기관,교육부,신창여자중학교,교육부 경상남도교육청 경상남도창녕교육지원청 신창여자중학교,19,19,0,19,0,19,0,0
교육기관,교육부,영산중학교,교육부 경상남도교육청 경상남도창녕교육지원청 영산중학교,12,12,0,12,10,2,0,0
교육기관,교육부,영산초등학교,교육부 경상남도교육청 경상남도창녕교육지원청 영산초등학교,11,11,0,11,9,2,0,0
교육기관,교육부,유어초등학교,교육부 경상남도교육청 경상남도창녕교육지원청 유어초등학교,9,9,0,9,0,9,0,0
교육기관,교육부,이방초등학교,교육부 경상남도교육청 경상남도창녕교육지원청 이방초등학교,7,7,0,7,7,0,0,0
교육기관,교육부,장마초등학교,교육부 경상남도교육청 경상남도창녕교육지원청 장마초등학교,8,8,0,8,0,8,0,0
교육기관,교육부,장천초등학교,교육부 경상남도교육청 경상남도창녕교육지원청 장천초등학교,7,7,0,7,2,5,0,0
교육기관,교육부,창녕성산초등학교,교육부 경상남도교육청 경상남도창녕교육지원청 창녕성산초등학교,7,7,0,7,3,4,0,0
교육기관,교육부,창녕여자중학교,교육부 경상남도교육청 경상남도창녕교육지원청 창녕여자중학교,18,18,0,18,18,0,0,0
교육기관,교육부,창녕옥야중학교,교육부 경상남도교육청 경상남도창녕교육지원청 창녕옥야중학교,7,7,0,7,0,7,0,0
교육기관,교육부,창녕유치원,교육부 경상남도교육청 경상남도창녕교육지원청 창녕유치원,16,16,0,16,7,7,2,0
교육기관,교육부,창녕중학교,교육부 경상남도교육청 경상남도창녕교육지원청 창녕중학교,23,23,0,23,23,0,0,0
교육기관,교육부,창녕초등학교,교육부 경상남도교육청 경상남도창녕교육지원청 창녕초등학교,16,16,0,16,16,0,0,0
교육기관,교육부,경상남도창원교육지원청,교육부 경상남도교육청 경상남도창원교육지원청,66,66,0,66,0,66,0,0
교육기관,교육부,가고파초등학교,교육부 경상남도교육청 경상남도창원교육지원청 가고파초등학교,44,22,22,22,16,6,0,0
교육기관,교육부,가포초등학교,교육부 경상남도교육청 경상남도창원교육지원청 가포초등학교,11,11,0,11,11,0,0,0
교육기관,교육부,감계중학교,교육부 경상남도교육청 경상남도창원교육지원청 감계중학교,31,31,0,31,0,31,0,0
교육기관,교육부,감계초등학교,교육부 경상남도교육청 경상남도창원교육지원청 감계초등학교,25,25,0,25,25,0,0,0
교육기관,교육부,감천초등학교,교육부 경상남도교육청 경상남도창원교육지원청 감천초등학교,22,22,0,22,22,0,0,0
교육기관,교육부,경상남도교육청마산지혜의바다도서관,교육부 경상남도교육청 경상남도창원교육지원청 경상남도교육청마산지혜의바다도서관,25,25,0,25,15,10,0,0
교육기관,교육부,경상남도교육청진동도서관,교육부 경상남도교육청 경상남도창원교육지원청 경상남도교육청진동도서관,6,6,0,6,3,3,0,0
교육기관,교육부,경원중학교,교육부 경상남도교육청 경상남도창원교육지원청 경원중학교,12,12,0,12,12,0,0,0
교육기관,교육부,경화초등학교,교육부 경상남도교육청 경상남도창원교육지원청 경화초등학교,23,23,0,23,23,0,0,0
교육기관,교육부,곰내유치원,교육부 경상남도교육청 경상남도창원교육지원청 곰내유치원,12,12,0,12,3,8,1,0
교육기관,교육부,광려중학교,교육부 경상남도교육청 경상남도창원교육지원청 광려중학교,19,19,0,19,17,2,0,0
교육기관,교육부,광려초등학교,교육부 경상남도교육청 경상남도창원교육지원청 광려초등학교,21,18,3,18,18,0,0,0
교육기관,교육부,교동초등학교,교육부 경상남도교육청 경상남도창원교육지원청 교동초등학교,11,11,0,11,8,3,0,0
교육기관,교육부,교방초등학교,교육부 경상남도교육청 경상남도창원교육지원청 교방초등학교,21,21,0,21,0,21,0,0
교육기관,교육부,구산중학교,교육부 경상남도교육청 경상남도창원교육지원청 구산중학교,29,28,1,28,28,0,0,0
교육기관,교육부,구산중학교구남분교장,교육부 경상남도교육청 경상남도창원교육지원청 구산중학교구남분교장,5,4,1,4,4,0,0,0
교육기관,교육부,구산초등학교,교육부 경상남도교육청 경상남도창원교육지원청 구산초등학교,8,8,0,8,8,0,0,0
교육기관,교육부,구산초등학교구서분교장,교육부 경상남도교육청 경상남도창원교육지원청 구산초등학교구서분교장,8,8,0,8,8,0,0,0
교육기관,교육부,구암중학교,교육부 경상남도교육청 경상남도창원교육지원청 구암중학교,25,25,0,25,15,10,0,0
교육기관,교육부,구암초등학교,교육부 경상남도교육청 경상남도창원교육지원청 구암초등학교,24,24,0,24,16,8,0,0
교육기관,교육부,남산중학교,교육부 경상남도교육청 경상남도창원교육지원청 남산중학교,23,23,0,23,8,15,0,0
교육기관,교육부,남양초등학교,교육부 경상남도교육청 경상남도창원교육지원청 남양초등학교,27,27,0,27,24,3,0,0
교육기관,교육부,남정초등학교,교육부 경상남도교육청 경상남도창원교육지원청 남정초등학교,25,24,1,24,24,0,0,0
교육기관,교육부,내동초등학교,교육부 경상남도교육청 경상남도창원교육지원청 내동초등학교,29,29,0,29,29,0,0,0
교육기관,교육부,내서중학교,교육부 경상남도교육청 경상남도창원교육지원청 내서중학교,18,17,1,17,9,4,4,0
교육기관,교육부,내서초등학교,교육부 경상남도교육청 경상남도창원교육지원청 내서초등학교,18,18,0,18,18,0,0,0
교육기관,교육부,대방중학교,교육부 경상남도교육청 경상남도창원교육지원청 대방중학교,17,16,1,16,10,6,0,0
교육기관,교육부,대방초등학교,교육부 경상남도교육청 경상남도창원교육지원청 대방초등학교,12,12,0,12,6,6,0,0
교육기관,교육부,대산초등학교,교육부 경상남도교육청 경상남도창원교육지원청 대산초등학교,15,15,0,15,15,0,0,0
교육기관,교육부,대암초등학교,교육부 경상남도교육청 경상남도창원교육지원청 대암초등학교,28,28,0,28,27,1,0,0
교육기관,교육부,대야초등학교,교육부 경상남도교육청 경상남도창원교육지원청 대야초등학교,15,15,0,15,15,0,0,0
교육기관,교육부,대원초등학교,교육부 경상남도교육청 경상남도창원교육지원청 대원초등학교,25,25,0,25,22,3,0,0
교육기관,교육부,덕산초등학교,교육부 경상남도교육청 경상남도창원교육지원청 덕산초등학교,28,28,0,28,16,12,0,0
교육기관,교육부,도계중학교,교육부 경상남도교육청 경상남도창원교육지원청 도계중학교,21,19,2,19,5,14,0,0
교육기관,교육부,도계초등학교,교육부 경상남도교육청 경상남도창원교육지원청 도계초등학교,42,42,0,42,3,39,0,0
교육기관,교육부,도천초등학교,교육부 경상남도교육청 경상남도창원교육지원청 도천초등학교,29,29,0,29,29,0,0,0
교육기관,교육부,동부초등학교,교육부 경상남도교육청 경상남도창원교육지원청 동부초등학교,38,38,0,38,31,7,0,0
교육기관,교육부,동산초등학교,교육부 경상남도교육청 경상남도창원교육지원청 동산초등학교,23,23,0,23,18,5,0,0
교육기관,교육부,동진여자중학교,교육부 경상남도교육청 경상남도창원교육지원청 동진여자중학교,21,20,1,20,15,5,0,0
교육기관,교육부,동진중학교,교육부 경상남도교육청 경상남도창원교육지원청 동진중학교,27,27,0,27,11,16,0,0
교육기관,교육부,마산고운초등학교,교육부 경상남도교육청 경상남도창원교육지원청 마산고운초등학교,67,64,3,64,30,30,2,2
교육기관,교육부,마산동중학교,교육부 경상남도교육청 경상남도창원교육지원청 마산동중학교,16,16,0,16,10,3,3,0
교육기관,교육부,마산무학여자중학교,교육부 경상남도교육청 경상남도창원교육지원청 마산무학여자중학교,30,30,0,30,30,0,0,0
교육기관,교육부,마산삼진중학교,교육부 경상남도교육청 경상남도창원교육지원청 마산삼진중학교,30,30,0,30,14,16,0,0
교육기관,교육부,마산서중학교,교육부 경상남도교육청 경상남도창원교육지원청 마산서중학교,20,19,1,19,15,4,0,0
교육기관,교육부,마산신월초등학교,교육부 경상남도교육청 경상남도창원교육지원청 마산신월초등학교,28,28,0,28,22,5,1,0
교육기관,교육부,마산여자중학교,교육부 경상남도교육청 경상남도창원교육지원청 마산여자중학교,14,14,0,14,14,0,0,0
교육기관,교육부,마산의신여자중학교,교육부 경상남도교육청 경상남도창원교육지원청 마산의신여자중학교,12,12,0,12,2,10,0,0
교육기관,교육부,마산제일여자중학교,교육부 경상남도교육청 경상남도창원교육지원청 마산제일여자중학교,42,42,0,42,0,42,0,0
교육기관,교육부,마산중앙중학교,교육부 경상남도교육청 경상남도창원교육지원청 마산중앙중학교,24,24,0,24,0,24,0,0
교육기관,교육부,마산중앙초등학교,교육부 경상남도교육청 경상남도창원교육지원청 마산중앙초등학교,21,21,0,21,21,0,0,0
교육기관,교육부,마산중학교,교육부 경상남도교육청 경상남도창원교육지원청 마산중학교,24,24,0,24,24,0,0,0
교육기관,교육부,명곡여자중학교,교육부 경상남도교육청 경상남도창원교육지원청 명곡여자중학교,17,16,1,16,0,16,0,0
교육기관,교육부,명곡초등학교,교육부 경상남도교육청 경상남도창원교육지원청 명곡초등학교,20,20,0,20,4,12,0,4
교육기관,교육부,명도초등학교,교육부 경상남도교육청 경상남도창원교육지원청 명도초등학교,18,18,0,18,18,0,0,0
교육기관,교육부,명서중학교,교육부 경상남도교육청 경상남도창원교육지원청 명서중학교,10,10,0,10,10,0,0,0
교육기관,교육부,명서초등학교,교육부 경상남도교육청 경상남도창원교육지원청 명서초등학교,21,21,0,21,0,21,0,0
교육기관,교육부,무동꿈유치원,교육부 경상남도교육청 경상남도창원교육지원청 무동꿈유치원,45,43,2,43,18,20,5,0
교육기관,교육부,무동초등학교,교육부 경상남도교육청 경상남도창원교육지원청 무동초등학교,47,47,0,47,18,29,0,0
교육기관,교육부,무학초등학교,교육부 경상남도교육청 경상남도창원교육지원청 무학초등학교,19,19,0,19,9,7,1,2
교육기관,교육부,반동초등학교,교육부 경상남도교육청 경상남도창원교육지원청 반동초등학교,13,13,0,13,12,1,0,0
교육기관,교육부,반림중학교,교육부 경상남도교육청 경상남도창원교육지원청 반림중학교,11,11,0,11,0,11,0,0
교육기관,교육부,반송여자중학교,교육부 경상남도교육청 경상남도창원교육지원청 반송여자중학교,32,32,0,32,32,0,0,0
교육기관,교육부,반송중학교,교육부 경상남도교육청 경상남도창원교육지원청 반송중학교,31,31,0,31,31,0,0,0
교육기관,교육부,반송초등학교,교육부 경상남도교육청 경상남도창원교육지원청 반송초등학교,32,32,0,32,32,0,0,0
교육기관,교육부,봉강초등학교,교육부 경상남도교육청 경상남도창원교육지원청 봉강초등학교,18,18,0,18,18,0,0,0
교육기관,교육부,봉곡중학교,교육부 경상남도교육청 경상남도창원교육지원청 봉곡중학교,17,17,0,17,17,0,0,0
교육기관,교육부,봉덕초등학교,교육부 경상남도교육청 경상남도창원교육지원청 봉덕초등학교,13,13,0,13,13,0,0,0
교육기관,교육부,봉림중학교,교육부 경상남도교육청 경상남도창원교육지원청 봉림중학교,14,14,0,14,4,10,0,0
교육기관,교육부,봉림초등학교,교육부 경상남도교육청 경상남도창원교육지원청 봉림초등학교,25,25,0,25,10,15,0,0
교육기관,교육부,북면초등학교,교육부 경상남도교육청 경상남도창원교육지원청 북면초등학교,37,37,0,37,21,16,0,0
교육기관,교육부,북면초등학교승산분교장,교육부 경상남도교육청 경상남도창원교육지원청 북면초등학교승산분교장,14,14,0,14,13,1,0,0
교육기관,교육부,북성초등학교,교육부 경상남도교육청 경상남도창원교육지원청 북성초등학교,21,21,0,21,17,4,0,0
교육기관,교육부,사파중학교,교육부 경상남도교육청 경상남도창원교육지원청 사파중학교,18,8,10,8,5,3,0,0
교육기관,교육부,사파초등학교,교육부 경상남도교육청 경상남도창원교육지원청 사파초등학교,21,21,0,21,21,0,0,0
교육기관,교육부,사화초등학교,교육부 경상남도교육청 경상남도창원교육지원청 사화초등학교,22,22,0,22,20,2,0,0
교육기관,교육부,산호초등학교,교육부 경상남도교육청 경상남도창원교육지원청 산호초등학교,20,20,0,20,11,9,0,0
교육기관,교육부,삼계중학교,교육부 경상남도교육청 경상남도창원교육지원청 삼계중학교,30,30,0,30,0,30,0,0
교육기관,교육부,삼계초등학교,교육부 경상남도교육청 경상남도창원교육지원청 삼계초등학교,19,19,0,19,14,3,2,0
교육기관,교육부,삼정자중학교,교육부 경상남도교육청 경상남도창원교육지원청 삼정자중학교,57,57,0,57,54,2,1,0
교육기관,교육부,삼정자초등학교,교육부 경상남도교육청 경상남도창원교육지원청 삼정자초등학교,24,24,0,24,24,0,0,0
교육기관,교육부,상남초등학교,교육부 경상남도교육청 경상남도창원교육지원청 상남초등학교,18,18,0,18,16,2,0,0
교육기관,교육부,상북초등학교,교육부 경상남도교육청 경상남도창원교육지원청 상북초등학교,21,21,0,21,15,4,2,0
교육기관,교육부,상일초등학교,교육부 경상남도교육청 경상남도창원교육지원청 상일초등학교,21,21,0,21,14,7,0,0
교육기관,교육부,석동중학교,교육부 경상남도교육청 경상남도창원교육지원청 석동중학교,37,37,0,37,0,37,0,0
교육기관,교육부,석동초등학교,교육부 경상남도교육청 경상남도창원교육지원청 석동초등학교,16,16,0,16,15,1,0,0
교육기관,교육부,석전초등학교,교육부 경상남도교육청 경상남도창원교육지원청 석전초등학교,24,24,0,24,24,0,0,0
교육기관,교육부,성주초등학교,교육부 경상남도교육청 경상남도창원교육지원청 성주초등학교,16,16,0,16,15,1,0,0
교육기관,교육부,성지여자중학교,교육부 경상남도교육청 경상남도창원교육지원청 성지여자중학교,17,17,0,17,17,0,0,0
교육기관,교육부,성호초등학교,교육부 경상남도교육청 경상남도창원교육지원청 성호초등학교,19,0,19,0,0,0,0,0
교육기관,교육부,소답초등학교,교육부 경상남도교육청 경상남도창원교육지원청 소답초등학교,22,22,0,22,0,22,0,0
교육기관,교육부,신등초등학교,교육부 경상남도교육청 경상남도창원교육지원청 신등초등학교,16,16,0,16,16,0,0,0
교육기관,교육부,신방초등학교,교육부 경상남도교육청 경상남도창원교육지원청 신방초등학교,18,18,0,18,18,0,0,0
교육기관,교육부,신월중학교,교육부 경상남도교육청 경상남도창원교육지원청 신월중학교,34,15,19,15,10,5,0,0
교육기관,교육부,안계초등학교,교육부 경상남도교육청 경상남도창원교육지원청 안계초등학교,16,16,0,16,16,0,0,0
교육기관,교육부,안골포중학교,교육부 경상남도교육청 경상남도창원교육지원청 안골포중학교,31,31,0,31,16,15,0,0
교육기관,교육부,안골포초등학교,교육부 경상남도교육청 경상남도창원교육지원청 안골포초등학교,23,23,0,23,23,0,0,0
교육기관,교육부,안남중학교,교육부 경상남도교육청 경상남도창원교육지원청 안남중학교,26,26,0,26,26,0,0,0
교육기관,교육부,안남초등학교,교육부 경상남도교육청 경상남도창원교육지원청 안남초등학교,23,23,0,23,10,13,0,0
교육기관,교육부,안민중학교,교육부 경상남도교육청 경상남도창원교육지원청 안민중학교,19,18,1,18,0,18,0,0
교육기관,교육부,안민초등학교,교육부 경상남도교육청 경상남도창원교육지원청 안민초등학교,20,20,0,20,20,0,0,0
교육기관,교육부,안청초등학교,교육부 경상남도교육청 경상남도창원교육지원청 안청초등학교,22,22,0,22,22,0,0,0
교육기관,교육부,양곡중학교,교육부 경상남도교육청 경상남도창원교육지원청 양곡중학교,19,19,0,19,0,19,0,0
교육기관,교육부,양곡초등학교,교육부 경상남도교육청 경상남도창원교육지원청 양곡초등학교,21,21,0,21,4,17,0,0
교육기관,교육부,양덕솔빛유치원,교육부 경상남도교육청 경상남도창원교육지원청 양덕솔빛유치원,15,15,0,15,10,5,0,0
교육기관,교육부,양덕여자중학교,교육부 경상남도교육청 경상남도창원교육지원청 양덕여자중학교,15,15,0,15,15,0,0,0
교육기관,교육부,양덕중학교,교육부 경상남도교육청 경상남도창원교육지원청 양덕중학교,28,27,1,27,27,0,0,0
교육기관,교육부,양덕초등학교,교육부 경상남도교육청 경상남도창원교육지원청 양덕초등학교,21,21,0,21,4,17,0,0
교육기관,교육부,온천초등학교,교육부 경상남도교육청 경상남도창원교육지원청 온천초등학교,18,18,0,18,18,0,0,0
교육기관,교육부,완월초등학교,교육부 경상남도교육청 경상남도창원교육지원청 완월초등학교,21,21,0,21,21,0,0,0
교육기관,교육부,외동초등학교,교육부 경상남도교육청 경상남도창원교육지원청 외동초등학교,16,16,0,16,16,0,0,0
교육기관,교육부,용남초등학교,교육부 경상남도교육청 경상남도창원교육지원청 용남초등학교,24,24,0,24,0,24,0,0
교육기관,교육부,용마초등학교,교육부 경상남도교육청 경상남도창원교육지원청 용마초등학교,30,30,0,30,26,4,0,0
교육기관,교육부,용원중학교,교육부 경상남도교육청 경상남도창원교육지원청 용원중학교,31,31,0,31,16,15,0,0
교육기관,교육부,용원초등학교,교육부 경상남도교육청 경상남도창원교육지원청 용원초등학교,20,20,0,20,0,20,0,0
교육기관,교육부,용지초등학교,교육부 경상남도교육청 경상남도창원교육지원청 용지초등학교,11,11,0,11,11,0,0,0
교육기관,교육부,용호유치원,교육부 경상남도교육청 경상남도창원교육지원청 용호유치원,12,12,0,12,6,6,0,0
교육기관,교육부,용호초등학교,교육부 경상남도교육청 경상남도창원교육지원청 용호초등학교,27,27,0,27,10,17,0,0
교육기관,교육부,우산초등학교,교육부 경상남도교육청 경상남도창원교육지원청 우산초등학교,15,15,0,15,11,4,0,0
교육기관,교육부,우암초등학교,교육부 경상남도교육청 경상남도창원교육지원청 우암초등학교,16,16,0,16,16,0,0,0
교육기관,교육부,웅남중학교,교육부 경상남도교육청 경상남도창원교육지원청 웅남중학교,21,21,0,21,1,20,0,0
교육기관,교육부,웅남초등학교,교육부 경상남도교육청 경상남도창원교육지원청 웅남초등학교,34,34,0,34,24,4,4,2
교육기관,교육부,웅동중학교,교육부 경상남도교육청 경상남도창원교육지원청 웅동중학교,10,8,2,8,5,3,0,0
교육기관,교육부,웅동초등학교,교육부 경상남도교육청 경상남도창원교육지원청 웅동초등학교,29,29,0,29,11,18,0,0
교육기관,교육부,웅천중학교,교육부 경상남도교육청 경상남도창원교육지원청 웅천중학교,57,57,0,57,1,56,0,0
교육기관,교육부,웅천초등학교,교육부 경상남도교육청 경상남도창원교육지원청 웅천초등학교,68,68,0,68,0,68,0,0
교육기관,교육부,월성초등학교,교육부 경상남도교육청 경상남도창원교육지원청 월성초등학교,20,20,0,20,20,0,0,0
교육기관,교육부,월영초등학교,교육부 경상남도교육청 경상남도창원교육지원청 월영초등학교,34,34,0,34,34,0,0,0
교육기관,교육부,월포초등학교,교육부 경상남도교육청 경상남도창원교육지원청 월포초등학교,26,26,0,26,15,11,0,0
교육기관,교육부,유목초등학교,교육부 경상남도교육청 경상남도창원교육지원청 유목초등학교,20,20,0,20,20,0,0,0
교육기관,교육부,의창초등학교,교육부 경상남도교육청 경상남도창원교육지원청 의창초등학교,61,61,0,61,57,4,0,0
교육기관,교육부,일동초등학교,교육부 경상남도교육청 경상남도창원교육지원청 일동초등학교,14,14,0,14,1,13,0,0
교육기관,교육부,자여초등학교,교육부 경상남도교육청 경상남도창원교육지원청 자여초등학교,16,16,0,16,8,8,0,0
교육기관,교육부,자은초등학교,교육부 경상남도교육청 경상남도창원교육지원청 자은초등학교,18,18,0,18,11,7,0,0
교육기관,교육부,장복초등학교,교육부 경상남도교육청 경상남도창원교육지원청 장복초등학교,21,21,0,21,16,5,0,0
교육기관,교육부,장천초등학교,교육부 경상남도교육청 경상남도창원교육지원청 장천초등학교,20,20,0,20,20,0,0,0
교육기관,교육부,전안초등학교,교육부 경상남도교육청 경상남도창원교육지원청 전안초등학교,26,26,0,26,15,11,0,0
교육기관,교육부,제황초등학교,교육부 경상남도교육청 경상남도창원교육지원청 제황초등학교,13,13,0,13,6,7,0,0
교육기관,교육부,중동초등학교,교육부 경상남도교육청 경상남도창원교육지원청 중동초등학교,11,11,0,11,11,0,0,0
교육기관,교육부,중리초등학교,교육부 경상남도교육청 경상남도창원교육지원청 중리초등학교,19,19,0,19,0,19,0,0
교육기관,교육부,진동초등학교,교육부 경상남도교육청 경상남도창원교육지원청 진동초등학교,20,20,0,20,20,0,0,0
교육기관,교육부,진전중학교,교육부 경상남도교육청 경상남도창원교육지원청 진전중학교,14,14,0,14,6,8,0,0
교육기관,교육부,진전초등학교,교육부 경상남도교육청 경상남도창원교육지원청 진전초등학교,9,9,0,9,8,1,0,0
교육기관,교육부,진해남산초등학교,교육부 경상남도교육청 경상남도창원교육지원청 진해남산초등학교,16,16,0,16,11,5,0,0
교육기관,교육부,진해남중학교,교육부 경상남도교육청 경상남도창원교육지원청 진해남중학교,37,7,30,7,4,3,0,0
교육기관,교육부,진해냉천중학교,교육부 경상남도교육청 경상남도창원교육지원청 진해냉천중학교,45,45,0,45,44,1,0,0
교육기관,교육부,진해냉천초등학교,교육부 경상남도교육청 경상남도창원교육지원청 진해냉천초등학교,39,39,0,39,12,27,0,0
교육기관,교육부,진해신항중학교,교육부 경상남도교육청 경상남도창원교육지원청 진해신항중학교,47,46,1,46,16,30,0,0
교육기관,교육부,진해신항초등학교,교육부 경상남도교육청 경상남도창원교육지원청 진해신항초등학교,28,28,0,28,28,0,0,0
교육기관,교육부,진해여자중학교,교육부 경상남도교육청 경상남도창원교육지원청 진해여자중학교,27,27,0,27,14,13,0,0
교육기관,교육부,진해유치원,교육부 경상남도교육청 경상남도창원교육지원청 진해유치원,22,22,0,22,5,17,0,0
교육기관,교육부,진해중앙초등학교,교육부 경상남도교육청 경상남도창원교육지원청 진해중앙초등학교,18,18,0,18,0,18,0,0
교육기관,교육부,창덕중학교,교육부 경상남도교육청 경상남도창원교육지원청 창덕중학교,20,20,0,20,13,7,0,0
교육기관,교육부,창북중학교,교육부 경상남도교육청 경상남도창원교육지원청 창북중학교,69,69,0,69,69,0,0,0
교육기관,교육부,창신중학교,교육부 경상남도교육청 경상남도창원교육지원청 창신중학교,29,29,0,29,16,13,0,0
교육기관,교육부,창원남산유치원,교육부 경상남도교육청 경상남도창원교육지원청 창원남산유치원,10,10,0,10,6,3,1,0
교육기관,교육부,창원남산초등학교,교육부 경상남도교육청 경상남도창원교육지원청 창원남산초등학교,17,17,0,17,0,17,0,0
교육기관,교육부,창원남중학교,교육부 경상남도교육청 경상남도창원교육지원청 창원남중학교,16,16,0,16,15,1,0,0
교육기관,교육부,창원대산중학교,교육부 경상남도교육청 경상남도창원교육지원청 창원대산중학교,16,15,1,15,9,6,0,0
교육기관,교육부,창원동중학교,교육부 경상남도교육청 경상남도창원교육지원청 창원동중학교,16,15,1,15,8,7,0,0
교육기관,교육부,창원상남중학교,교육부 경상남도교육청 경상남도창원교육지원청 창원상남중학교,27,27,0,27,27,0,0,0
교육기관,교육부,창원상남초등학교,교육부 경상남도교육청 경상남도창원교육지원청 창원상남초등학교,22,22,0,22,4,18,0,0
교육기관,교육부,창원숲유치원,교육부 경상남도교육청 경상남도창원교육지원청 창원숲유치원,28,28,0,28,0,28,0,0
교육기관,교육부,창원신월초등학교,교육부 경상남도교육청 경상남도창원교육지원청 창원신월초등학교,22,22,0,22,7,15,0,0
교육기관,교육부,창원여자중학교,교육부 경상남도교육청 경상남도창원교육지원청 창원여자중학교,32,31,1,31,31,0,0,0
교육기관,교육부,창원중앙중학교,교육부 경상남도교육청 경상남도창원교육지원청 창원중앙중학교,32,30,2,30,30,0,0,0
교육기관,교육부,창원중학교,교육부 경상남도교육청 경상남도창원교육지원청 창원중학교,14,12,2,12,12,0,0,0
교육기관,교육부,창원진달래유치원,교육부 경상남도교육청 경상남도창원교육지원청 창원진달래유치원,16,16,0,16,8,8,0,0
교육기관,교육부,창원초등학교,교육부 경상남도교육청 경상남도창원교육지원청 창원초등학교,26,26,0,26,7,19,0,0
교육기관,교육부,창원한들초등학교,교육부 경상남도교육청 경상남도창원교육지원청 창원한들초등학교,38,38,0,38,20,18,0,0
교육기관,교육부,창원한별유치원,교육부 경상남도교육청 경상남도창원교육지원청 창원한별유치원,13,13,0,13,11,2,0,0
교육기관,교육부,토월유치원,교육부 경상남도교육청 경상남도창원교육지원청 토월유치원,13,13,0,13,6,7,0,0
교육기관,교육부,토월중학교,교육부 경상남도교육청 경상남도창원교육지원청 토월중학교,28,27,1,27,14,13,0,0
교육기관,교육부,토월초등학교,교육부 경상남도교육청 경상남도창원교육지원청 토월초등학교,23,23,0,23,23,0,0,0
교육기관,교육부,팔룡중학교,교육부 경상남도교육청 경상남도창원교육지원청 팔룡중학교,35,35,0,35,0,35,0,0
교육기관,교육부,팔룡초등학교,교육부 경상남도교육청 경상남도창원교육지원청 팔룡초등학교,19,19,0,19,19,0,0,0
교육기관,교육부,평산초등학교,교육부 경상남도교육청 경상남도창원교육지원청 평산초등학교,28,28,0,28,25,3,0,0
교육기관,교육부,풍호초등학교,교육부 경상남도교육청 경상남도창원교육지원청 풍호초등학교,16,16,0,16,6,10,0,0
교육기관,교육부,하북초등학교,교육부 경상남도교육청 경상남도창원교육지원청 하북초등학교,6,6,0,6,6,0,0,0
교육기관,교육부,하천초등학교,교육부 경상남도교육청 경상남도창원교육지원청 하천초등학교,16,16,0,16,3,13,0,0
교육기관,교육부,한사랑유치원,교육부 경상남도교육청 경상남도창원교육지원청 한사랑유치원,8,8,0,8,0,8,0,0
교육기관,교육부,합성초등학교,교육부 경상남도교육청 경상남도창원교육지원청 합성초등학교,41,41,0,41,41,0,0,0
교육기관,교육부,합포여자중학교,교육부 경상남도교육청 경상남도창원교육지원청 합포여자중학교,11,11,0,11,6,3,1,1
교육기관,교육부,합포중학교,교육부 경상남도교육청 경상남도창원교육지원청 합포중학교,32,32,0,32,20,12,0,0
교육기관,교육부,합포초등학교,교육부 경상남도교육청 경상남도창원교육지원청 합포초등학교,23,23,0,23,16,7,0,0
교육기관,교육부,해운중학교,교육부 경상남도교육청 경상남도창원교육지원청 해운중학교,16,15,1,15,8,7,0,0
교육기관,교육부,해운초등학교,교육부 경상남도교육청 경상남도창원교육지원청 해운초등학교,16,16,0,16,16,0,0,0
교육기관,교육부,해원꽃숲유치원,교육부 경상남도교육청 경상남도창원교육지원청 해원꽃숲유치원,18,18,0,18,0,18,0,0
교육기관,교육부,현동숲유치원,교육부 경상남도교육청 경상남도창원교육지원청 현동숲유치원,33,21,12,21,0,21,0,0
교육기관,교육부,현동초등학교,교육부 경상남도교육청 경상남도창원교육지원청 현동초등학교,43,43,0,43,43,0,0,0
교육기관,교육부,호계중학교,교육부 경상남도교육청 경상남도창원교육지원청 호계중학교,28,28,0,28,27,1,0,0
교육기관,교육부,호계초등학교,교육부 경상남도교육청 경상남도창원교육지원청 호계초등학교,28,28,0,28,2,22,2,2
교육기관,교육부,화양초등학교,교육부 경상남도교육청 경상남도창원교육지원청 화양초등학교,16,16,0,16,16,0,0,0
교육기관,교육부,회원초등학교,교육부 경상남도교육청 경상남도창원교육지원청 회원초등학교,31,31,0,31,31,0,0,0
교육기관,교육부,경상남도통영교육지원청,교육부 경상남도교육청 경상남도통영교육지원청,16,16,0,16,7,9,0,0
교육기관,교육부,경상남도교육청통영도서관,교육부 경상남도교육청 경상남도통영교육지원청 경상남도교육청통영도서관,15,15,0,15,3,12,0,0
교육기관,교육부,광도초등학교,교육부 경상남도교육청 경상남도통영교육지원청 광도초등학교,12,12,0,12,12,0,0,0
교육기관,교육부,남포초등학교,교육부 경상남도교육청 경상남도통영교육지원청 남포초등학교,8,8,0,8,8,0,0,0
교육기관,교육부,도산중학교,교육부 경상남도교육청 경상남도통영교육지원청 도산중학교,11,11,0,11,9,2,0,0
교육기관,교육부,도산초등학교,교육부 경상남도교육청 경상남도통영교육지원청 도산초등학교,17,17,0,17,11,6,0,0
교육기관,교육부,동원중학교,교육부 경상남도교육청 경상남도통영교육지원청 동원중학교,57,56,1,56,48,8,0,0
교육기관,교육부,두룡초등학교,교육부 경상남도교육청 경상남도통영교육지원청 두룡초등학교,15,15,0,15,15,0,0,0
교육기관,교육부,벽방초등학교,교육부 경상남도교육청 경상남도통영교육지원청 벽방초등학교,21,21,0,21,10,11,0,0
교육기관,교육부,사량중학교,교육부 경상남도교육청 경상남도통영교육지원청 사량중학교,14,10,4,10,8,2,0,0
교육기관,교육부,사량초등학교,교육부 경상남도교육청 경상남도통영교육지원청 사량초등학교,8,8,0,8,8,0,0,0
교육기관,교육부,산양중학교,교육부 경상남도교육청 경상남도통영교육지원청 산양중학교,15,15,0,15,0,15,0,0
교육기관,교육부,산양초등학교,교육부 경상남도교육청 경상남도통영교육지원청 산양초등학교,13,13,0,13,10,3,0,0
교육기관,교육부,욕지중학교,교육부 경상남도교육청 경상남도통영교육지원청 욕지중학교,7,6,1,6,3,3,0,0
교육기관,교육부,용남초등학교,교육부 경상남도교육청 경상남도통영교육지원청 용남초등학교,14,14,0,14,14,0,0,0
교육기관,교육부,원량초등학교,교육부 경상남도교육청 경상남도통영교육지원청 원량초등학교,13,13,0,13,13,0,0,0
교육기관,교육부,원평초등학교,교육부 경상남도교육청 경상남도통영교육지원청 원평초등학교,16,16,0,16,12,4,0,0
교육기관,교육부,유영초등학교,교육부 경상남도교육청 경상남도통영교육지원청 유영초등학교,19,17,2,17,9,8,0,0
교육기관,교육부,인평초등학교,교육부 경상남도교육청 경상남도통영교육지원청 인평초등학교,10,10,0,10,2,8,0,0
교육기관,교육부,제석초등학교,교육부 경상남도교육청 경상남도통영교육지원청 제석초등학교,36,36,0,36,12,24,0,0
교육기관,교육부,죽림초등학교,교육부 경상남도교육청 경상남도통영교육지원청 죽림초등학교,21,21,0,21,21,0,0,0
교육기관,교육부,진남초등학교,교육부 경상남도교육청 경상남도통영교육지원청 진남초등학교,10,10,0,10,5,5,0,0
교육기관,교육부,충렬여자중학교,교육부 경상남도교육청 경상남도통영교육지원청 충렬여자중학교,12,12,0,12,12,0,0,0
교육기관,교육부,충렬초등학교,교육부 경상남도교육청 경상남도통영교육지원청 충렬초등학교,17,17,0,17,15,2,0,0
교육기관,교육부,충무여자중학교,교육부 경상남도교육청 경상남도통영교육지원청 충무여자중학교,26,26,0,26,0,26,0,0
교육기관,교육부,충무중학교,교육부 경상남도교육청 경상남도통영교육지원청 충무중학교,27,26,1,26,26,0,0,0
교육기관,교육부,충무초등학교,교육부 경상남도교육청 경상남도통영교육지원청 충무초등학교,20,20,0,20,20,0,0,0
교육기관,교육부,통영여자중학교,교육부 경상남도교육청 경상남도통영교육지원청 통영여자중학교,24,24,0,24,24,0,0,0
교육기관,교육부,통영유치원,교육부 경상남도교육청 경상남도통영교육지원청 통영유치원,13,13,0,13,6,7,0,0
교육기관,교육부,통영중앙중학교,교육부 경상남도교육청 경상남도통영교육지원청 통영중앙중학교,68,68,0,68,52,16,0,0
교육기관,교육부,통영중학교,교육부 경상남도교육청 경상남도통영교육지원청 통영중학교,30,30,0,30,30,0,0,0
교육기관,교육부,통영초등학교,교육부 경상남도교육청 경상남도통영교육지원청 통영초등학교,23,23,0,23,13,8,0,2
교육기관,교육부,한려초등학교,교육부 경상남도교육청 경상남도통영교육지원청 한려초등학교,20,20,0,20,19,1,0,0
교육기관,교육부,한산중학교,교육부 경상남도교육청 경상남도통영교육지원청 한산중학교,5,5,0,5,2,3,0,0
교육기관,교육부,한산초등학교,교육부 경상남도교육청 경상남도통영교육지원청 한산초등학교,16,7,9,7,3,2,1,1
교육기관,교육부,경상남도하동교육지원청,교육부 경상남도교육청 경상남도하동교육지원청,5,5,0,5,0,5,0,0
교육기관,교육부,갈육초등학교,교육부 경상남도교육청 경상남도하동교육지원청 갈육초등학교,8,8,0,8,8,0,0,0
교육기관,교육부,경상남도교육청하동도서관,교육부 경상남도교육청 경상남도하동교육지원청 경상남도교육청하동도서관,11,11,0,11,0,11,0,0
교육기관,교육부,고전초등학교,교육부 경상남도교육청 경상남도하동교육지원청 고전초등학교,6,6,0,6,4,2,0,0
교육기관,교육부,궁항초등학교,교육부 경상남도교육청 경상남도하동교육지원청 궁항초등학교,8,8,0,8,8,0,0,0
교육기관,교육부,금남중학교,교육부 경상남도교육청 경상남도하동교육지원청 금남중학교,15,15,0,15,11,2,1,1
교육기관,교육부,노량초등학교,교육부 경상남도교육청 경상남도하동교육지원청 노량초등학교,7,7,0,7,7,0,0,0
교육기관,교육부,묵계초등학교,교육부 경상남도교육청 경상남도하동교육지원청 묵계초등학교,16,16,0,16,13,3,0,0
교육기관,교육부,북천초등학교,교육부 경상남도교육청 경상남도하동교육지원청 북천초등학교,6,6,0,6,3,3,0,0
교육기관,교육부,악양초등학교,교육부 경상남도교육청 경상남도하동교육지원청 악양초등학교,14,14,0,14,14,0,0,0
교육기관,교육부,옥종중학교,교육부 경상남도교육청 경상남도하동교육지원청 옥종중학교,17,17,0,17,17,0,0,0
교육기관,교육부,옥종초등학교,교육부 경상남도교육청 경상남도하동교육지원청 옥종초등학교,9,9,0,9,0,9,0,0
교육기관,교육부,적량초등학교,교육부 경상남도교육청 경상남도하동교육지원청 적량초등학교,10,10,0,10,10,0,0,0
교육기관,교육부,진교중학교,교육부 경상남도교육청 경상남도하동교육지원청 진교중학교,21,19,2,19,0,0,19,0
교육기관,교육부,진교초등학교,교육부 경상남도교육청 경상남도하동교육지원청 진교초등학교,21,21,0,21,15,6,0,0
교육기관,교육부,진정초등학교,교육부 경상남도교육청 경상남도하동교육지원청 진정초등학교,14,14,0,14,14,0,0,0
교육기관,교육부,청암중학교,교육부 경상남도교육청 경상남도하동교육지원청 청암중학교,26,26,0,26,3,21,1,1
교육기관,교육부,하동유치원,교육부 경상남도교육청 경상남도하동교육지원청 하동유치원,6,6,0,6,5,1,0,0
교육기관,교육부,하동중앙중학교,교육부 경상남도교육청 경상남도하동교육지원청 하동중앙중학교,22,22,0,22,22,0,0,0
교육기관,교육부,하동중학교,교육부 경상남도교육청 경상남도하동교육지원청 하동중학교,12,12,0,12,6,6,0,0
교육기관,교육부,하동초등학교,교육부 경상남도교육청 경상남도하동교육지원청 하동초등학교,24,24,0,24,7,17,0,0
교육기관,교육부,한다사중학교,교육부 경상남도교육청 경상남도하동교육지원청 한다사중학교,44,44,0,44,12,32,0,0
교육기관,교육부,화개중학교,교육부 경상남도교육청 경상남도하동교육지원청 화개중학교,13,12,1,12,12,0,0,0
교육기관,교육부,화개초등학교,교육부 경상남도교육청 경상남도하동교육지원청 화개초등학교,7,7,0,7,1,6,0,0
교육기관,교육부,횡천초등학교,교육부 경상남도교육청 경상남도하동교육지원청 횡천초등학교,10,10,0,10,0,10,0,0
교육기관,교육부,경상남도함안교육지원청,교육부 경상남도교육청 경상남도함안교육지원청,0,0,0,0,0,0,0,0
교육기관,교육부,가야초등학교,교육부 경상남도교육청 경상남도함안교육지원청 가야초등학교,22,22,0,22,22,0,0,0
교육기관,교육부,경상남도교육청함안도서관,교육부 경상남도교육청 경상남도함안교육지원청 경상남도교육청함안도서관,16,16,0,16,0,16,0,0
교육기관,교육부,군북중학교,교육부 경상남도교육청 경상남도함안교육지원청 군북중학교,14,8,6,8,2,3,1,2
교육기관,교육부,군북초등학교,교육부 경상남도교육청 경상남도함안교육지원청 군북초등학교,11,11,0,11,11,0,0,0
교육기관,교육부,대산중학교,교육부 경상남도교육청 경상남도함안교육지원청 대산중학교,26,26,0,26,13,11,2,0
교육기관,교육부,대산초등학교,교육부 경상남도교육청 경상남도함안교육지원청 대산초등학교,10,10,0,10,8,2,0,0
교육기관,교육부,문암초등학교,교육부 경상남도교육청 경상남도함안교육지원청 문암초등학교,16,16,0,16,16,0,0,0
교육기관,교육부,법수초등학교,교육부 경상남도교육청 경상남도함안교육지원청 법수초등학교,11,11,0,11,6,5,0,0
교육기관,교육부,산인초등학교,교육부 경상남도교육청 경상남도함안교육지원청 산인초등학교,12,12,0,12,12,0,0,0
교육기관,교육부,아라초등학교,교육부 경상남도교육청 경상남도함안교육지원청 아라초등학교,10,10,0,10,3,7,0,0
교육기관,교육부,예곡초등학교,교육부 경상남도교육청 경상남도함안교육지원청 예곡초등학교,8,8,0,8,0,8,0,0
교육기관,교육부,외암초등학교,교육부 경상남도교육청 경상남도함안교육지원청 외암초등학교,10,10,0,10,10,0,0,0
교육기관,교육부,월촌초등학교,교육부 경상남도교육청 경상남도함안교육지원청 월촌초등학교,5,5,0,5,5,0,0,0
교육기관,교육부,유원초등학교,교육부 경상남도교육청 경상남도함안교육지원청 유원초등학교,12,12,0,12,12,0,0,0
교육기관,교육부,중앙초등학교,교육부 경상남도교육청 경상남도함안교육지원청 중앙초등학교,17,17,0,17,14,3,0,0
교육기관,교육부,칠서초등학교,교육부 경상남도교육청 경상남도함안교육지원청 칠서초등학교,11,11,0,11,11,0,0,0
교육기관,교육부,칠성중학교,교육부 경상남도교육청 경상남도함안교육지원청 칠성중학교,20,20,0,20,12,8,0,0
교육기관,교육부,칠원중학교,교육부 경상남도교육청 경상남도함안교육지원청 칠원중학교,18,16,2,16,12,2,1,1
교육기관,교육부,칠원초등학교,교육부 경상남도교육청 경상남도함안교육지원청 칠원초등학교,17,17,0,17,0,17,0,0
교육기관,교육부,함성중학교,교육부 경상남도교육청 경상남도함안교육지원청 함성중학교,11,11,0,11,6,2,3,0
교육기관,교육부,함안여자중학교,교육부 경상남도교육청 경상남도함안교육지원청 함안여자중학교,22,22,0,22,0,22,0,0
교육기관,교육부,함안유치원,교육부 경상남도교육청 경상남도함안교육지원청 함안유치원,8,8,0,8,8,0,0,0
교육기관,교육부,함안중학교,교육부 경상남도교육청 경상남도함안교육지원청 함안중학교,21,12,9,12,12,0,0,0
교육기관,교육부,함안초등학교,교육부 경상남도교육청 경상남도함안교육지원청 함안초등학교,8,8,0,8,8,0,0,0
교육기관,교육부,호암중학교,교육부 경상남도교육청 경상남도함안교육지원청 호암중학교,20,20,0,20,19,1,0,0
교육기관,교육부,호암초등학교,교육부 경상남도교육청 경상남도함안교육지원청 호암초등학교,21,21,0,21,8,13,0,0
교육기관,교육부,경상남도교육청함양도서관,교육부 경상남도교육청 경상남도함양교육지원청 경상남도교육청함양도서관,4,4,0,4,2,2,0,0
교육기관,교육부,금반초등학교,교육부 경상남도교육청 경상남도함양교육지원청 금반초등학교,15,15,0,15,15,0,0,0
교육기관,교육부,마천중학교,교육부 경상남도교육청 경상남도함양교육지원청 마천중학교,8,7,1,7,0,7,0,0
교육기관,교육부,마천초등학교,교육부 경상남도교육청 경상남도함양교육지원청 마천초등학교,13,13,0,13,13,0,0,0
교육기관,교육부,병곡초등학교,교육부 경상남도교육청 경상남도함양교육지원청 병곡초등학교,15,15,0,15,10,5,0,0
교육기관,교육부,서상중학교,교육부 경상남도교육청 경상남도함양교육지원청 서상중학교,8,8,0,8,0,8,0,0
교육기관,교육부,서상초등학교,교육부 경상남도교육청 경상남도함양교육지원청 서상초등학교,16,16,0,16,16,0,0,0
교육기관,교육부,서하초등학교,교육부 경상남도교육청 경상남도함양교육지원청 서하초등학교,9,9,0,9,0,9,0,0
교육기관,교육부,수동중학교,교육부 경상남도교육청 경상남도함양교육지원청 수동중학교,7,6,1,6,3,3,0,0
교육기관,교육부,수동초등학교,교육부 경상남도교육청 경상남도함양교육지원청 수동초등학교,15,15,0,15,2,13,0,0
교육기관,교육부,안의중학교,교육부 경상남도교육청 경상남도함양교육지원청 안의중학교,19,19,0,19,9,10,0,0
교육기관,교육부,안의초등학교,교육부 경상남도교육청 경상남도함양교육지원청 안의초등학교,14,14,0,14,14,0,0,0
교육기관,교육부,위림초등학교,교육부 경상남도교육청 경상남도함양교육지원청 위림초등학교,11,11,0,11,11,0,0,0
교육기관,교육부,위성초등학교,교육부 경상남도교육청 경상남도함양교육지원청 위성초등학교,24,12,12,12,0,12,0,0
교육기관,교육부,유림초등학교,교육부 경상남도교육청 경상남도함양교육지원청 유림초등학교,14,14,0,14,5,9,0,0
교육기관,교육부,지곡초등학교,교육부 경상남도교육청 경상남도함양교육지원청 지곡초등학교,16,16,0,16,6,10,0,0
교육기관,교육부,천령유치원,교육부 경상남도교육청 경상남도함양교육지원청 천령유치원,23,23,0,23,12,11,0,0
교육기관,교육부,함양여자중학교,교육부 경상남도교육청 경상남도함양교육지원청 함양여자중학교,21,21,0,21,18,3,0,0
교육기관,교육부,함양중학교,교육부 경상남도교육청 경상남도함양교육지원청 함양중학교,20,20,0,20,20,0,0,0
교육기관,교육부,함양초등학교,교육부 경상남도교육청 경상남도함양교육지원청 함양초등학교,27,27,0,27,19,8,0,0
교육기관,교육부,가회중학교,교육부 경상남도교육청 경상남도합천교육지원청 가회중학교,10,8,2,8,6,2,0,0
교육기관,교육부,가회초등학교,교육부 경상남도교육청 경상남도합천교육지원청 가회초등학교,8,8,0,8,5,3,0,0
교육기관,교육부,경상남도교육청가야산독서당정글북,교육부 경상남도교육청 경상남도합천교육지원청 경상남도교육청가야산독서당정글북,42,42,0,42,0,42,0,0
교육기관,교육부,경상남도교육청합천도서관,교육부 경상남도교육청 경상남도합천교육지원청 경상남도교육청합천도서관,6,6,0,6,4,2,0,0
교육기관,교육부,남정초등학교,교육부 경상남도교육청 경상남도합천교육지원청 남정초등학교,12,12,0,12,8,4,0,0
교육기관,교육부,대병중학교,교육부 경상남도교육청 경상남도합천교육지원청 대병중학교,29,29,0,29,29,0,0,0
교육기관,교육부,대병초등학교,교육부 경상남도교육청 경상남도합천교육지원청 대병초등학교,7,7,0,7,7,0,0,0
교육기관,교육부,대양초등학교,교육부 경상남도교육청 경상남도합천교육지원청 대양초등학교,8,8,0,8,8,0,0,0
교육기관,교육부,묘산중학교,교육부 경상남도교육청 경상남도합천교육지원청 묘산중학교,15,15,0,15,10,5,0,0
교육기관,교육부,묘산초등학교,교육부 경상남도교육청 경상남도합천교육지원청 묘산초등학교,8,8,0,8,8,0,0,0
교육기관,교육부,봉산초등학교,교육부 경상남도교육청 경상남도합천교육지원청 봉산초등학교,4,4,0,4,4,0,0,0
교육기관,교육부,삼가중학교,교육부 경상남도교육청 경상남도합천교육지원청 삼가중학교,11,11,0,11,5,6,0,0
교육기관,교육부,삼가초등학교,교육부 경상남도교육청 경상남도합천교육지원청 삼가초등학교,13,13,0,13,10,3,0,0
교육기관,교육부,쌍백초등학교,교육부 경상남도교육청 경상남도합천교육지원청 쌍백초등학교,6,6,0,6,6,0,0,0
교육기관,교육부,쌍책초등학교,교육부 경상남도교육청 경상남도합천교육지원청 쌍책초등학교,5,5,0,5,4,1,0,0
교육기관,교육부,야로중학교,교육부 경상남도교육청 경상남도합천교육지원청 야로중학교,6,5,1,5,5,0,0,0
교육기관,교육부,야로초등학교,교육부 경상남도교육청 경상남도합천교육지원청 야로초등학교,8,8,0,8,5,1,1,1
교육기관,교육부,영전초등학교,교육부 경상남도교육청 경상남도합천교육지원청 영전초등학교,9,9,0,9,7,2,0,0
교육기관,교육부,용주초등학교,교육부 경상남도교육청 경상남도합천교육지원청 용주초등학교,6,6,0,6,6,0,0,0
교육기관,교육부,적중초등학교,교육부 경상남도교육청 경상남도합천교육지원청 적중초등학교,10,6,4,6,5,0,1,0
교육기관,교육부,청덕초등학교,교육부 경상남도교육청 경상남도합천교육지원청 청덕초등학교,10,10,0,10,8,2,0,0
교육기관,교육부,초계중학교,교육부 경상남도교육청 경상남도합천교육지원청 초계중학교,10,9,1,9,2,5,1,1
교육기관,교육부,초계초등학교,교육부 경상남도교육청 경상남도합천교육지원청 초계초등학교,15,15,0,15,15,0,0,0
교육기관,교육부,초계초등학교덕곡분교장,교육부 경상남도교육청 경상남도합천교육지원청 초계초등학교덕곡분교장,4,4,0,4,4,0,0,0
교육기관,교육부,합천가야초등학교,교육부 경상남도교육청 경상남도합천교육지원청 합천가야초등학교,33,33,0,33,16,17,0,0
교육기관,교육부,합천여자중학교,교육부 경상남도교육청 경상남도합천교육지원청 합천여자중학교,9,9,0,9,5,4,0,0
교육기관,교육부,합천유치원,교육부 경상남도교육청 경상남도합천교육지원청 합천유치원,11,11,0,11,5,6,0,0
교육기관,교육부,합천중학교,교육부 경상남도교육청 경상남도합천교육지원청 합천중학교,13,13,0,13,6,7,0,0
교육기관,교육부,합천초등학교,교육부 경상남도교육청 경상남도합천교육지원청 합천초등학교,32,32,0,32,22,10,0,0
교육기관,교육부,해인중학교,교육부 경상남도교육청 경상남도합천교육지원청 해인중학교,18,15,3,15,10,3,1,1
교육기관,교육부,경진고등학교,교육부 경상남도교육청 경진고등학교,22,22,0,22,0,22,0,0
교육기관,교육부,경해여자고등학교,교육부 경상남도교육청 경해여자고등학교,23,23,0,23,23,0,0,0
교육기관,교육부,고성고등학교,교육부 경상남도교육청 고성고등학교,63,63,0,63,0,63,0,0
교육기관,교육부,고성중앙고등학교,교육부 경상남도교육청 고성중앙고등학교,42,42,0,42,16,26,0,0
교육기관,교육부,구산고등학교,교육부 경상남도교육청 구산고등학교,61,61,0,61,41,20,0,0
교육기관,교육부,군북고등학교,교육부 경상남도교육청 군북고등학교,16,14,2,14,7,7,0,0
교육기관,교육부,금곡무지개고등학교,교육부 경상남도교육청 금곡무지개고등학교,34,34,0,34,11,22,1,0
교육기관,교육부,김해경원고등학교,교육부 경상남도교육청 김해경원고등학교,35,35,0,35,35,0,0,0
교육기관,교육부,김해고등학교,교육부 경상남도교육청 김해고등학교,47,47,0,47,0,47,0,0
교육기관,교육부,김해대청고등학교,교육부 경상남도교육청 김해대청고등학교,58,58,0,58,58,0,0,0
교육기관,교육부,김해분성고등학교,교육부 경상남도교육청 김해분성고등학교,38,38,0,38,2,32,3,1
교육기관,교육부,김해분성여자고등학교,교육부 경상남도교육청 김해분성여자고등학교,42,41,1,41,15,26,0,0
교육기관,교육부,김해삼문고등학교,교육부 경상남도교육청 김해삼문고등학교,40,40,0,40,21,16,1,2
교육기관,교육부,김해삼방고등학교,교육부 경상남도교육청 김해삼방고등학교,44,44,0,44,44,0,0,0
교육기관,교육부,김해생명과학고등학교,교육부 경상남도교육청 김해생명과학고등학교,46,46,0,46,46,0,0,0
교육기관,교육부,김해수남고등학교,교육부 경상남도교육청 김해수남고등학교,64,62,2,62,10,37,10,5
교육기관,교육부,김해여자고등학교,교육부 경상남도교육청 김해여자고등학교,36,35,1,35,30,5,0,0
교육기관,교육부,김해영운고등학교,교육부 경상남도교육청 김해영운고등학교,26,26,0,26,13,13,0,0
교육기관,교육부,김해외국어고등학교,교육부 경상남도교육청 김해외국어고등학교,35,34,1,34,13,21,0,0
교육기관,교육부,김해율하고등학교,교육부 경상남도교육청 김해율하고등학교,20,20,0,20,6,14,0,0
교육기관,교육부,김해은혜학교,교육부 경상남도교육청 김해은혜학교,16,16,0,16,0,16,0,0
교육기관,교육부,김해임호고등학교,교육부 경상남도교육청 김해임호고등학교,44,44,0,44,0,44,0,0
교육기관,교육부,김해제일고등학교,교육부 경상남도교육청 김해제일고등학교,50,50,0,50,0,50,0,0
교육기관,교육부,김해중앙여자고등학교,교육부 경상남도교육청 김해중앙여자고등학교,12,12,0,12,6,6,0,0
교육기관,교육부,김해한일여자고등학교,교육부 경상남도교육청 김해한일여자고등학교,31,30,1,30,15,15,0,0
교육기관,교육부,남지고등학교,교육부 경상남도교육청 남지고등학교,26,26,0,26,26,0,0,0
교육기관,교육부,남해고등학교,교육부 경상남도교육청 남해고등학교,34,34,0,34,34,0,0,0
교육기관,교육부,남해제일고등학교,교육부 경상남도교육청 남해제일고등학교,54,54,0,54,20,34,0,0
교육기관,교육부,단성고등학교,교육부 경상남도교육청 단성고등학교,16,16,0,16,13,3,0,0
교육기관,교육부,대곡고등학교,교육부 경상남도교육청 대곡고등학교,17,16,1,16,10,5,1,0
교육기관,교육부,대아고등학교,교육부 경상남도교육청 대아고등학교,31,31,0,31,15,16,0,0
교육기관,교육부,덕산고등학교,교육부 경상남도교육청 덕산고등학교,6,5,1,5,2,2,1,0
교육기관,교육부,동원고등학교,교육부 경상남도교육청 동원고등학교,82,81,1,81,81,0,0,0
교육기관,교육부,마산가포고등학교,교육부 경상남도교육청 마산가포고등학교,43,43,0,43,33,10,0,0
교육기관,교육부,마산고등학교,교육부 경상남도교육청 마산고등학교,47,45,2,45,38,5,1,1
교육기관,교육부,마산공업고등학교,교육부 경상남도교육청 마산공업고등학교,20,20,0,20,20,0,0,0
교육기관,교육부,마산구암고등학교,교육부 경상남도교육청 마산구암고등학교,49,49,0,49,17,32,0,0
교육기관,교육부,마산내서여자고등학교,교육부 경상남도교육청 마산내서여자고등학교,21,21,0,21,17,4,0,0
교육기관,교육부,마산무학여자고등학교,교육부 경상남도교육청 마산무학여자고등학교,53,53,0,53,27,26,0,0
교육기관,교육부,마산삼진고등학교,교육부 경상남도교육청 마산삼진고등학교,40,40,0,40,26,14,0,0
교육기관,교육부,마산여자고등학교,교육부 경상남도교육청 마산여자고등학교,16,16,0,16,16,0,0,0
교육기관,교육부,마산용마고등학교,교육부 경상남도교육청 마산용마고등학교,32,32,0,32,4,25,2,1
교육기관,교육부,마산제일여자고등학교,교육부 경상남도교육청 마산제일여자고등학교,24,24,0,24,12,12,0,0
교육기관,교육부,마산중앙고등학교,교육부 경상남도교육청 마산중앙고등학교,29,29,0,29,0,29,0,0
교육기관,교육부,명덕고등학교,교육부 경상남도교육청 명덕고등학교,31,30,1,30,12,17,0,1
교육기관,교육부,명신고등학교,교육부 경상남도교육청 명신고등학교,22,20,2,20,7,13,0,0
교육기관,교육부,물금고등학교,교육부 경상남도교육청 물금고등학교,31,26,5,26,11,15,0,0
교육기관,교육부,밀양고등학교,교육부 경상남도교육청 밀양고등학교,59,59,0,59,15,44,0,0
교육기관,교육부,밀양동명고등학교,교육부 경상남도교육청 밀양동명고등학교,17,15,2,15,7,8,0,0
교육기관,교육부,밀양아리솔학교,교육부 경상남도교육청 밀양아리솔학교,46,46,0,46,30,16,0,0
교육기관,교육부,밀양영화고등학교,교육부 경상남도교육청 밀양영화고등학교,46,46,0,46,0,46,0,0
교육기관,교육부,범어고등학교,교육부 경상남도교육청 범어고등학교,62,62,0,62,57,5,0,0
교육기관,교육부,보광고등학교,교육부 경상남도교육청 보광고등학교,35,33,2,33,17,16,0,0
교육기관,교육부,사천고등학교,교육부 경상남도교육청 사천고등학교,29,29,0,29,12,15,2,0
교육기관,교육부,사천여자고등학교,교육부 경상남도교육청 사천여자고등학교,17,17,0,17,0,17,0,0
교육기관,교육부,산청고등학교,교육부 경상남도교육청 산청고등학교,56,56,0,56,0,56,0,0
교육기관,교육부,삼가고등학교,교육부 경상남도교육청 삼가고등학교,16,16,0,16,16,0,0,0
교육기관,교육부,삼랑진고등학교,교육부 경상남도교육청 삼랑진고등학교,54,52,2,52,44,8,0,0
교육기관,교육부,삼천포공업고등학교,교육부 경상남도교육청 삼천포공업고등학교,69,69,0,69,69,0,0,0
교육기관,교육부,삼천포중앙고등학교,교육부 경상남도교육청 삼천포중앙고등학교,20,20,0,20,20,0,0,0
교육기관,교육부,삼현여자고등학교,교육부 경상남도교육청 삼현여자고등학교,26,23,3,23,0,23,0,0
교육기관,교육부,서상고등학교,교육부 경상남도교육청 서상고등학교,6,6,0,6,0,6,0,0
교육기관,교육부,서창고등학교,교육부 경상남도교육청 서창고등학교,49,49,0,49,43,6,0,0
교육기관,교육부,선명여자고등학교,교육부 경상남도교육청 선명여자고등학교,22,22,0,22,19,1,1,1
교육기관,교육부,성지여자고등학교,교육부 경상남도교육청 성지여자고등학교,20,13,7,13,3,10,0,0
교육기관,교육부,신등고등학교,교육부 경상남도교육청 신등고등학교,6,6,0,6,6,0,0,0
교육기관,교육부,아림고등학교,교육부 경상남도교육청 아림고등학교,28,28,0,28,0,28,0,0
교육기관,교육부,안의고등학교,교육부 경상남도교육청 안의고등학교,22,20,2,20,20,0,0,0
교육기관,교육부,양산남부고등학교,교육부 경상남도교육청 양산남부고등학교,42,42,0,42,21,21,0,0
교육기관,교육부,양산여자고등학교,교육부 경상남도교육청 양산여자고등학교,19,17,2,17,0,17,0,0
교육기관,교육부,양산희망학교,교육부 경상남도교육청 양산희망학교,15,15,0,15,8,7,0,0
교육기관,교육부,영산고등학교,교육부 경상남도교육청 영산고등학교,36,36,0,36,0,36,0,0
교육기관,교육부,옥종고등학교,교육부 경상남도교육청 옥종고등학교,15,15,0,15,15,0,0,0
교육기관,교육부,용남고등학교,교육부 경상남도교육청 용남고등학교,34,34,0,34,6,28,0,0
교육기관,교육부,웅상고등학교,교육부 경상남도교육청 웅상고등학교,28,28,0,28,28,0,0,0
교육기관,교육부,웅천고등학교,교육부 경상남도교육청 웅천고등학교,32,32,0,32,32,0,0,0
교육기관,교육부,의령고등학교,교육부 경상남도교육청 의령고등학교,48,7,41,7,0,7,0,0
교육기관,교육부,의령여자고등학교,교육부 경상남도교육청 의령여자고등학교,53,52,1,52,0,52,0,0
교육기관,교육부,의령은광학교,교육부 경상남도교육청 의령은광학교,15,15,0,15,8,7,0,0
교육기관,교육부,장유고등학교,교육부 경상남도교육청 장유고등학교,30,29,1,29,29,0,0,0
교육기관,교육부,증산고등학교,교육부 경상남도교육청 증산고등학교,44,44,0,44,44,0,0,0
교육기관,교육부,진교고등학교,교육부 경상남도교육청 진교고등학교,17,16,1,16,16,0,0,0
교육기관,교육부,진서고등학교,교육부 경상남도교육청 진서고등학교,13,13,0,13,6,7,0,0
교육기관,교육부,진양고등학교,교육부 경상남도교육청 진양고등학교,32,31,1,31,28,1,1,1
교육기관,교육부,진영고등학교,교육부 경상남도교육청 진영고등학교,42,42,0,42,8,34,0,0
교육기관,교육부,진영제일고등학교,교육부 경상남도교육청 진영제일고등학교,40,40,0,40,37,3,0,0
교육기관,교육부,진주고등학교,교육부 경상남도교육청 진주고등학교,59,59,0,59,11,48,0,0
교육기관,교육부,진주기계공업고등학교,교육부 경상남도교육청 진주기계공업고등학교,83,30,53,30,0,30,0,0
교육기관,교육부,진주동명고등학교,교육부 경상남도교육청 진주동명고등학교,54,54,0,54,0,54,0,0
교육기관,교육부,진주여자고등학교,교육부 경상남도교육청 진주여자고등학교,42,40,2,40,5,35,0,0
교육기관,교육부,진주외국어고등학교,교육부 경상남도교육청 진주외국어고등학교,39,38,1,38,38,0,0,0
교육기관,교육부,진주제일여자고등학교,교육부 경상남도교육청 진주제일여자고등학교,21,19,2,19,0,19,0,0
교육기관,교육부,진주중앙고등학교,교육부 경상남도교육청 진주중앙고등학교,40,40,0,40,40,0,0,0
교육기관,교육부,진주혜광학교,교육부 경상남도교육청 진주혜광학교,38,0,38,0,0,0,0,0
교육기관,교육부,진해고등학교,교육부 경상남도교육청 진해고등학교,49,49,0,49,11,38,0,0
교육기관,교육부,진해세화여자고등학교,교육부 경상남도교육청 진해세화여자고등학교,16,16,0,16,0,16,0,0
교육기관,교육부,진해여자고등학교,교육부 경상남도교육청 진해여자고등학교,18,18,0,18,18,0,0,0
교육기관,교육부,진해용원고등학교,교육부 경상남도교육청 진해용원고등학교,38,38,0,38,36,2,0,0
교육기관,교육부,창녕공업고등학교,교육부 경상남도교육청 창녕공업고등학교,64,64,0,64,0,64,0,0
교육기관,교육부,창녕대성고등학교,교육부 경상남도교육청 창녕대성고등학교,29,29,0,29,29,0,0,0
교육기관,교육부,창녕옥야고등학교,교육부 경상남도교육청 창녕옥야고등학교,13,13,0,13,0,13,0,0
교육기관,교육부,창선고등학교,교육부 경상남도교육청 창선고등학교,46,46,0,46,0,46,0,0
교육기관,교육부,창신고등학교,교육부 경상남도교육청 창신고등학교,21,21,0,21,11,10,0,0
교육기관,교육부,창원경일고등학교,교육부 경상남도교육청 창원경일고등학교,34,34,0,34,10,23,1,0
교육기관,교육부,창원공업고등학교,교육부 경상남도교육청 창원공업고등학교,33,33,0,33,0,33,0,0
교육기관,교육부,창원과학고등학교,교육부 경상남도교육청 창원과학고등학교,79,79,0,79,63,16,0,0
교육기관,교육부,창원기계공업고등학교,교육부 경상남도교육청 창원기계공업고등학교,70,69,1,69,13,56,0,0
교육기관,교육부,창원남고등학교,교육부 경상남도교육청 창원남고등학교,27,27,0,27,0,27,0,0
교육기관,교육부,창원남산고등학교,교육부 경상남도교육청 창원남산고등학교,50,50,0,50,50,0,0,0
교육기관,교육부,창원대산고등학교,교육부 경상남도교육청 창원대산고등학교,18,17,1,17,17,0,0,0
교육기관,교육부,창원대암고등학교,교육부 경상남도교육청 창원대암고등학교,28,27,1,27,0,27,0,0
교육기관,교육부,창원동백학교,교육부 경상남도교육청 창원동백학교,4,4,0,4,4,0,0,0
교육기관,교육부,창원명곡고등학교,교육부 경상남도교육청 창원명곡고등학교,37,37,0,37,0,37,0,0
교육기관,교육부,창원명지여자고등학교,교육부 경상남도교육청 창원명지여자고등학교,29,29,0,29,18,11,0,0
교육기관,교육부,창원문성고등학교,교육부 경상남도교육청 창원문성고등학교,13,12,1,12,2,4,4,2
교육기관,교육부,창원봉림고등학교,교육부 경상남도교육청 창원봉림고등학교,13,13,0,13,13,0,0,0
교육기관,교육부,창원사파고등학교,교육부 경상남도교육청 창원사파고등학교,34,33,1,33,33,0,0,0
교육기관,교육부,창원성민여자고등학교,교육부 경상남도교육청 창원성민여자고등학교,30,20,10,20,19,1,0,0
교육기관,교육부,창원신월고등학교,교육부 경상남도교육청 창원신월고등학교,50,50,0,50,50,0,0,0
교육기관,교육부,창원여자고등학교,교육부 경상남도교육청 창원여자고등학교,32,31,1,31,31,0,0,0
교육기관,교육부,창원예술학교,교육부 경상남도교육청 창원예술학교,40,40,0,40,33,7,0,0
교육기관,교육부,창원용호고등학교,교육부 경상남도교육청 창원용호고등학교,17,17,0,17,17,0,0,0
교육기관,교육부,창원중앙고등학교,교육부 경상남도교육청 창원중앙고등학교,38,38,0,38,28,10,0,0
교육기관,교육부,창원중앙여자고등학교,교육부 경상남도교육청 창원중앙여자고등학교,23,23,0,23,23,0,0,0
교육기관,교육부,창원천광학교,교육부 경상남도교육청 창원천광학교,14,14,0,14,8,6,0,0
교육기관,교육부,창원토월고등학교,교육부 경상남도교육청 창원토월고등학교,34,34,0,34,33,1,0,0
교육기관,교육부,철성고등학교,교육부 경상남도교육청 철성고등학교,24,24,0,24,24,0,0,0
교육기관,교육부,초계고등학교,교육부 경상남도교육청 초계고등학교,18,18,0,18,0,18,0,0
교육기관,교육부,충렬여자고등학교,교육부 경상남도교육청 충렬여자고등학교,25,3,22,3,3,0,0,0
교육기관,교육부,충무고등학교,교육부 경상남도교육청 충무고등학교,43,39,4,39,33,4,1,1
교육기관,교육부,칠원고등학교,교육부 경상남도교육청 칠원고등학교,57,57,0,57,16,40,0,1
교육기관,교육부,통영잠포학교,교육부 경상남도교육청 통영잠포학교,12,12,0,12,0,12,0,0
교육기관,교육부,하동고등학교,교육부 경상남도교육청 하동고등학교,24,24,0,24,14,10,0,0
교육기관,교육부,하동여자고등학교,교육부 경상남도교육청 하동여자고등학교,23,23,0,23,5,18,0,0
교육기관,교육부,학력인정경남미용고등학교,교육부 경상남도교육청 학력인정경남미용고등학교,9,9,0,9,0,9,0,0
교육기관,교육부,한국나노마이스터고등학교,교육부 경상남도교육청 한국나노마이스터고등학교,98,98,0,98,45,53,0,0
교육기관,교육부,한일여자고등학교,교육부 경상남도교육청 한일여자고등학교,35,33,2,33,19,14,0,0
교육기관,교육부,함안고등학교,교육부 경상남도교육청 함안고등학교,35,35,0,35,35,0,0,0
교육기관,교육부,함양제일고등학교,교육부 경상남도교육청 함양제일고등학교,41,41,0,41,20,21,0,0
교육기관,교육부,합천고등학교,교육부 경상남도교육청 합천고등학교,37,35,2,35,0,35,0,0
교육기관,교육부,합천여자고등학교,교육부 경상남도교육청 합천여자고등학교,13,13,0,13,0,13,0,0
교육기관,교육부,합천평화고등학교,교육부 경상남도교육청 합천평화고등학교,24,8,16,8,4,4,0,0
교육기관,교육부,합포고등학교,교육부 경상남도교육청 합포고등학교,23,21,2,21,18,3,0,0
교육기관,교육부,해성고등학교,교육부 경상남도교육청 해성고등학교,65,63,2,63,0,63,0,0
교육기관,교육부,제주특별자치도교육청,교육부 제주특별자치도교육청,47,47,0,47,0,47,0,0
교육기관,교육부,남녕고등학교,교육부 제주특별자치도교육청 남녕고등학교,75,75,0,75,75,0,0,0
교육기관,교육부,남주고등학교,교육부 제주특별자치도교육청 남주고등학교,52,52,0,52,52,0,0,0
교육기관,교육부,대기고등학교,교육부 제주특별자치도교육청 대기고등학교,45,45,0,45,30,15,0,0
교육기관,교육부,대정고등학교,교육부 제주특별자치도교육청 대정고등학교,27,27,0,27,0,27,0,0
교육기관,교육부,대정여자고등학교,교육부 제주특별자치도교육청 대정여자고등학교,31,11,20,11,9,2,0,0
교육기관,교육부,삼성여자고등학교,교육부 제주특별자치도교육청 삼성여자고등학교,34,34,0,34,10,24,0,0
교육기관,교육부,서귀포고등학교,교육부 제주특별자치도교육청 서귀포고등학교,53,53,0,53,19,34,0,0
교육기관,교육부,서귀포산업과학고등학교,교육부 제주특별자치도교육청 서귀포산업과학고등학교,26,26,0,26,26,0,0,0
교육기관,교육부,서귀포시교육지원청,교육부 제주특별자치도교육청 서귀포시교육지원청,12,12,0,12,0,12,0,0
교육기관,교육부,가마초등학교,교육부 제주특별자치도교육청 서귀포시교육지원청 가마초등학교,9,9,0,9,9,0,0,0
교육기관,교육부,가파초등학교,교육부 제주특별자치도교육청 서귀포시교육지원청 가파초등학교,8,8,0,8,0,8,0,0
교육기관,교육부,강정초등학교,교육부 제주특별자치도교육청 서귀포시교육지원청 강정초등학교,26,26,0,26,0,26,0,0
교육기관,교육부,남원중학교,교육부 제주특별자치도교육청 서귀포시교육지원청 남원중학교,15,14,1,14,14,0,0,0
교육기관,교육부,남원초등학교,교육부 제주특별자치도교육청 서귀포시교육지원청 남원초등학교,14,14,0,14,0,14,0,0
교육기관,교육부,남주중학교,교육부 제주특별자치도교육청 서귀포시교육지원청 남주중학교,19,18,1,18,0,18,0,0
교육기관,교육부,대정서초등학교,교육부 제주특별자치도교육청 서귀포시교육지원청 대정서초등학교,13,13,0,13,0,13,0,0
교육기관,교육부,대정중학교,교육부 제주특별자치도교육청 서귀포시교육지원청 대정중학교,76,33,43,33,8,25,0,0
교육기관,교육부,대정초등학교,교육부 제주특별자치도교육청 서귀포시교육지원청 대정초등학교,35,35,0,35,0,35,0,0
교육기관,교육부,덕수초등학교,교육부 제주특별자치도교육청 서귀포시교육지원청 덕수초등학교,13,13,0,13,13,0,0,0
교육기관,교육부,도순초등학교,교육부 제주특별자치도교육청 서귀포시교육지원청 도순초등학교,20,20,0,20,20,0,0,0
교육기관,교육부,동남초등학교,교육부 제주특별자치도교육청 서귀포시교육지원청 동남초등학교,36,36,0,36,36,0,0,0
교육기관,교육부,동홍초등학교,교육부 제주특별자치도교육청 서귀포시교육지원청 동홍초등학교,27,27,0,27,0,27,0,0
교육기관,교육부,무릉중학교,교육부 제주특별자치도교육청 서귀포시교육지원청 무릉중학교,16,15,1,15,0,15,0,0
교육기관,교육부,무릉초등학교,교육부 제주특별자치도교육청 서귀포시교육지원청 무릉초등학교,16,15,1,15,0,15,0,0
교육기관,교육부,법환초등학교,교육부 제주특별자치도교육청 서귀포시교육지원청 법환초등학교,19,19,0,19,19,0,0,0
교육기관,교육부,보목초등학교,교육부 제주특별자치도교육청 서귀포시교육지원청 보목초등학교,23,23,0,23,19,4,0,0
교육기관,교육부,보성초등학교,교육부 제주특별자치도교육청 서귀포시교육지원청 보성초등학교,20,20,0,20,0,20,0,0
교육기관,교육부,사계초등학교,교육부 제주특별자치도교육청 서귀포시교육지원청 사계초등학교,12,12,0,12,12,0,0,0
교육기관,교육부,새서귀초등학교,교육부 제주특별자치도교육청 서귀포시교육지원청 새서귀초등학교,20,20,0,20,18,2,0,0
교육기관,교육부,서광초등학교,교육부 제주특별자치도교육청 서귀포시교육지원청 서광초등학교,18,18,0,18,0,18,0,0
교육기관,교육부,서귀북초등학교,교육부 제주특별자치도교육청 서귀포시교육지원청 서귀북초등학교,28,28,0,28,3,25,0,0
교육기관,교육부,서귀서초등학교,교육부 제주특별자치도교육청 서귀포시교육지원청 서귀서초등학교,28,28,0,28,28,0,0,0
교육기관,교육부,서귀중앙여자중학교,교육부 제주특별자치도교육청 서귀포시교육지원청 서귀중앙여자중학교,22,17,5,17,6,9,1,1
교육기관,교육부,서귀중앙초등학교,교육부 제주특별자치도교육청 서귀포시교육지원청 서귀중앙초등학교,30,30,0,30,0,30,0,0
교육기관,교육부,서귀포대신중학교,교육부 제주특별자치도교육청 서귀포시교육지원청 서귀포대신중학교,24,24,0,24,11,13,0,0
교육기관,교육부,서귀포여자중학교,교육부 제주특별자치도교육청 서귀포시교육지원청 서귀포여자중학교,14,14,0,14,0,14,0,0
교육기관,교육부,서귀포중학교,교육부 제주특별자치도교육청 서귀포시교육지원청 서귀포중학교,42,42,0,42,21,21,0,0
교육기관,교육부,서귀포초등학교,교육부 제주특별자치도교육청 서귀포시교육지원청 서귀포초등학교,19,19,0,19,0,19,0,0
교육기관,교육부,서호초등학교,교육부 제주특별자치도교육청 서귀포시교육지원청 서호초등학교,17,17,0,17,17,0,0,0
교육기관,교육부,성산중학교,교육부 제주특별자치도교육청 서귀포시교육지원청 성산중학교,30,30,0,30,30,0,0,0
교육기관,교육부,성산초등학교,교육부 제주특별자치도교육청 서귀포시교육지원청 성산초등학교,14,14,0,14,14,0,0,0
교육기관,교육부,성읍초등학교,교육부 제주특별자치도교육청 서귀포시교육지원청 성읍초등학교,19,19,0,19,19,0,0,0
교육기관,교육부,수산초등학교,교육부 제주특별자치도교육청 서귀포시교육지원청 수산초등학교,17,17,0,17,17,0,0,0
교육기관,교육부,시흥초등학교,교육부 제주특별자치도교육청 서귀포시교육지원청 시흥초등학교,10,10,0,10,5,5,0,0
교육기관,교육부,신례초등학교,교육부 제주특별자치도교육청 서귀포시교육지원청 신례초등학교,16,16,0,16,8,8,0,0
교육기관,교육부,신산중학교,교육부 제주특별자치도교육청 서귀포시교육지원청 신산중학교,13,13,0,13,13,0,0,0
교육기관,교육부,신산초등학교,교육부 제주특별자치도교육청 서귀포시교육지원청 신산초등학교,9,9,0,9,9,0,0,0
교육기관,교육부,안덕중학교,교육부 제주특별자치도교육청 서귀포시교육지원청 안덕중학교,17,17,0,17,0,17,0,0
교육기관,교육부,안덕초등학교,교육부 제주특별자치도교육청 서귀포시교육지원청 안덕초등학교,17,17,0,17,11,6,0,0
교육기관,교육부,예래초등학교,교육부 제주특별자치도교육청 서귀포시교육지원청 예래초등학교,16,16,0,16,16,0,0,0
교육기관,교육부,온평초등학교,교육부 제주특별자치도교육청 서귀포시교육지원청 온평초등학교,11,11,0,11,10,1,0,0
교육기관,교육부,위미중학교,교육부 제주특별자치도교육청 서귀포시교육지원청 위미중학교,35,35,0,35,30,5,0,0
교육기관,교육부,위미초등학교,교육부 제주특별자치도교육청 서귀포시교육지원청 위미초등학교,41,41,0,41,0,41,0,0
교육기관,교육부,의귀초등학교,교육부 제주특별자치도교육청 서귀포시교육지원청 의귀초등학교,12,12,0,12,6,6,0,0
교육기관,교육부,중문중학교,교육부 제주특별자치도교육청 서귀포시교육지원청 중문중학교,52,51,1,51,51,0,0,0
교육기관,교육부,중문초등학교,교육부 제주특별자치도교육청 서귀포시교육지원청 중문초등학교,26,26,0,26,26,0,0,0
교육기관,교육부,창천초등학교,교육부 제주특별자치도교육청 서귀포시교육지원청 창천초등학교,8,8,0,8,0,8,0,0
교육기관,교육부,태흥초등학교,교육부 제주특별자치도교육청 서귀포시교육지원청 태흥초등학교,16,16,0,16,16,0,0,0
교육기관,교육부,토산초등학교,교육부 제주특별자치도교육청 서귀포시교육지원청 토산초등학교,11,11,0,11,11,0,0,0
교육기관,교육부,토평초등학교,교육부 제주특별자치도교육청 서귀포시교육지원청 토평초등학교,22,22,0,22,22,0,0,0
교육기관,교육부,표선중학교,교육부 제주특별자치도교육청 서귀포시교육지원청 표선중학교,37,37,0,37,0,37,0,0
교육기관,교육부,표선초등학교,교육부 제주특별자치도교육청 서귀포시교육지원청 표선초등학교,24,24,0,24,24,0,0,0
교육기관,교육부,풍천초등학교,교육부 제주특별자치도교육청 서귀포시교육지원청 풍천초등학교,19,19,0,19,6,13,0,0
교육기관,교육부,하례초등학교,교육부 제주특별자치도교육청 서귀포시교육지원청 하례초등학교,13,13,0,13,10,3,0,0
교육기관,교육부,하원초등학교,교육부 제주특별자치도교육청 서귀포시교육지원청 하원초등학교,19,19,0,19,0,19,0,0
교육기관,교육부,한마음초등학교,교육부 제주특별자치도교육청 서귀포시교육지원청 한마음초등학교,13,13,0,13,13,0,0,0
교육기관,교육부,효돈중학교,교육부 제주특별자치도교육청 서귀포시교육지원청 효돈중학교,25,25,0,25,20,5,0,0
교육기관,교육부,효돈초등학교,교육부 제주특별자치도교육청 서귀포시교육지원청 효돈초등학교,20,20,0,20,15,5,0,0
교육기관,교육부,흥산초등학교,교육부 제주특별자치도교육청 서귀포시교육지원청 흥산초등학교,12,12,0,12,0,12,0,0
교육기관,교육부,서귀포여자고등학교,교육부 제주특별자치도교육청 서귀포여자고등학교,33,22,11,22,22,0,0,0
교육기관,교육부,서귀포온성학교,교육부 제주특별자치도교육청 서귀포온성학교,16,16,0,16,0,16,0,0
교육기관,교육부,서귀포학생문화원,교육부 제주특별자치도교육청 서귀포학생문화원,11,11,0,11,0,11,0,0
교육기관,교육부,성산고등학교,교육부 제주특별자치도교육청 성산고등학교,56,56,0,56,56,0,0,0
교육기관,교육부,세화고등학교,교육부 제주특별자치도교육청 세화고등학교,51,51,0,51,0,51,0,0
교육기관,교육부,신성여자고등학교,교육부 제주특별자치도교육청 신성여자고등학교,57,57,0,57,57,0,0,0
교육기관,교육부,애월고등학교,교육부 제주특별자치도교육청 애월고등학교,64,64,0,64,37,27,0,0
교육기관,교육부,영주고등학교,교육부 제주특별자치도교육청 영주고등학교,53,52,1,52,15,37,0,0
교육기관,교육부,제주고등학교,교육부 제주특별자치도교육청 제주고등학교,67,32,35,32,0,32,0,0
교육기관,교육부,제주과학고등학교,교육부 제주특별자치도교육청 제주과학고등학교,28,28,0,28,0,28,0,0
교육기관,교육부,제주교육박물관,교육부 제주특별자치도교육청 제주교육박물관,39,39,0,39,0,39,0,0
교육기관,교육부,제주국제교육원,교육부 제주특별자치도교육청 제주국제교육원,12,12,0,12,0,12,0,0
교육기관,교육부,다문화교육부,교육부 제주특별자치도교육청 제주국제교육원 다문화교육부,3,3,0,3,3,0,0,0
교육기관,교육부,동부외국문화학습관,교육부 제주특별자치도교육청 제주국제교육원 동부외국문화학습관,4,4,0,4,0,4,0,0
교육기관,교육부,서귀포외국문화학습관,교육부 제주특별자치도교육청 제주국제교육원 서귀포외국문화학습관,4,4,0,4,4,0,0,0
교육기관,교육부,서부외국문화학습관,교육부 제주특별자치도교육청 제주국제교육원 서부외국문화학습관,4,4,0,4,0,4,0,0
교육기관,교육부,신제주외국문화학습관,교육부 제주특별자치도교육청 제주국제교육원 신제주외국문화학습관,5,5,0,5,3,2,0,0
교육기관,교육부,제주도서관,교육부 제주특별자치도교육청 제주도서관,22,22,0,22,0,22,0,0
교육기관,교육부,동녘도서관,교육부 제주특별자치도교육청 제주도서관 동녘도서관,6,6,0,6,0,6,0,0
교육기관,교육부,서귀포도서관,교육부 제주특별자치도교육청 제주도서관 서귀포도서관,8,8,0,8,0,8,0,0
교육기관,교육부,송악도서관,교육부 제주특별자치도교육청 제주도서관 송악도서관,8,8,0,8,4,4,0,0
교육기관,교육부,제남도서관,교육부 제주특별자치도교육청 제주도서관 제남도서관,4,4,0,4,0,4,0,0
교육기관,교육부,한수풀도서관,교육부 제주특별자치도교육청 제주도서관 한수풀도서관,10,10,0,10,0,10,0,0
교육기관,교육부,제주미래교육연구원,교육부 제주특별자치도교육청 제주미래교육연구원,61,61,0,61,0,61,0,0
교육기관,교육부,제주시교육지원청,교육부 제주특별자치도교육청 제주시교육지원청,23,23,0,23,5,18,0,0
교육기관,교육부,고산중학교,교육부 제주특별자치도교육청 제주시교육지원청 고산중학교,28,28,0,28,28,0,0,0
교육기관,교육부,고산초등학교,교육부 제주특별자치도교육청 제주시교육지원청 고산초등학교,11,11,0,11,11,0,0,0
교육기관,교육부,곽금초등학교,교육부 제주특별자치도교육청 제주시교육지원청 곽금초등학교,9,9,0,9,9,0,0,0
교육기관,교육부,광령초등학교,교육부 제주특별자치도교육청 제주시교육지원청 광령초등학교,15,15,0,15,15,0,0,0
교육기관,교육부,광양초등학교,교육부 제주특별자치도교육청 제주시교육지원청 광양초등학교,18,18,0,18,18,0,0,0
교육기관,교육부,구엄초등학교,교육부 제주특별자치도교육청 제주시교육지원청 구엄초등학교,17,17,0,17,10,7,0,0
교육기관,교육부,구좌중앙초등학교,교육부 제주특별자치도교육청 제주시교육지원청 구좌중앙초등학교,23,23,0,23,23,0,0,0
교육기관,교육부,금악초등학교,교육부 제주특별자치도교육청 제주시교육지원청 금악초등학교,14,14,0,14,5,9,0,0
교육기관,교육부,김녕중학교,교육부 제주특별자치도교육청 제주시교육지원청 김녕중학교,21,21,0,21,21,0,0,0
교육기관,교육부,김녕초등학교,교육부 제주특별자치도교육청 제주시교육지원청 김녕초등학교,16,16,0,16,12,4,0,0
교육기관,교육부,김녕초등학교동복분교장,교육부 제주특별자치도교육청 제주시교육지원청 김녕초등학교동복분교장,12,12,0,12,6,6,0,0
교육기관,교육부,남광초등학교,교육부 제주특별자치도교육청 제주시교육지원청 남광초등학교,41,41,0,41,34,7,0,0
교육기관,교육부,납읍초등학교,교육부 제주특별자치도교육청 제주시교육지원청 납읍초등학교,16,16,0,16,16,0,0,0
교육기관,교육부,노형중학교,교육부 제주특별자치도교육청 제주시교육지원청 노형중학교,89,89,0,89,89,0,0,0
교육기관,교육부,대흘초등학교,교육부 제주특별자치도교육청 제주시교육지원청 대흘초등학교,16,16,0,16,14,2,0,0
교육기관,교육부,더럭초등학교,교육부 제주특별자치도교육청 제주시교육지원청 더럭초등학교,14,14,0,14,7,7,0,0
교육기관,교육부,도남초등학교,교육부 제주특별자치도교육청 제주시교육지원청 도남초등학교,23,23,0,23,23,0,0,0
교육기관,교육부,도련초등학교,교육부 제주특별자치도교육청 제주시교육지원청 도련초등학교,49,49,0,49,0,49,0,0
교육기관,교육부,도리초등학교,교육부 제주특별자치도교육청 제주시교육지원청 도리초등학교,24,24,0,24,23,1,0,0
교육기관,교육부,도평초등학교,교육부 제주특별자치도교육청 제주시교육지원청 도평초등학교,16,16,0,16,8,8,0,0
교육기관,교육부,동광초등학교,교육부 제주특별자치도교육청 제주시교육지원청 동광초등학교,22,22,0,22,22,0,0,0
교육기관,교육부,동화초등학교,교육부 제주특별자치도교육청 제주시교육지원청 동화초등학교,21,21,0,21,0,21,0,0
교육기관,교육부,물메초등학교,교육부 제주특별자치도교육청 제주시교육지원청 물메초등학교,26,26,0,26,19,7,0,0
교육기관,교육부,백록초등학교,교육부 제주특별자치도교육청 제주시교육지원청 백록초등학교,27,27,0,27,17,10,0,0
교육기관,교육부,봉개초등학교,교육부 제주특별자치도교육청 제주시교육지원청 봉개초등학교,20,20,0,20,10,10,0,0
교육기관,교육부,북촌초등학교,교육부 제주특별자치도교육청 제주시교육지원청 북촌초등학교,14,14,0,14,14,0,0,0
교육기관,교육부,삼성초등학교,교육부 제주특별자치도교육청 제주시교육지원청 삼성초등학교,28,28,0,28,28,0,0,0
교육기관,교육부,삼양초등학교,교육부 제주특별자치도교육청 제주시교육지원청 삼양초등학교,13,13,0,13,13,0,0,0
교육기관,교육부,삼화초등학교,교육부 제주특별자치도교육청 제주시교육지원청 삼화초등학교,61,61,0,61,0,61,0,0
교육기관,교육부,선흘초등학교,교육부 제주특별자치도교육청 제주시교육지원청 선흘초등학교,13,13,0,13,13,0,0,0
교육기관,교육부,세화중학교,교육부 제주특별자치도교육청 제주시교육지원청 세화중학교,24,24,0,24,11,13,0,0
교육기관,교육부,세화초등학교,교육부 제주특별자치도교육청 제주시교육지원청 세화초등학교,15,15,0,15,15,0,0,0
교육기관,교육부,송당초등학교,교육부 제주특별자치도교육청 제주시교육지원청 송당초등학교,18,18,0,18,0,18,0,0
교육기관,교육부,수원초등학교,교육부 제주특별자치도교육청 제주시교육지원청 수원초등학교,13,13,0,13,1,10,1,1
교육기관,교육부,신광초등학교,교육부 제주특별자치도교육청 제주시교육지원청 신광초등학교,25,25,0,25,10,15,0,0
교육기관,교육부,신성여자중학교,교육부 제주특별자치도교육청 제주시교육지원청 신성여자중학교,34,31,3,31,0,31,0,0
교육기관,교육부,신엄중학교,교육부 제주특별자치도교육청 제주시교육지원청 신엄중학교,20,20,0,20,20,0,0,0
교육기관,교육부,신제주초등학교,교육부 제주특별자치도교육청 제주시교육지원청 신제주초등학교,57,57,0,57,57,0,0,0
교육기관,교육부,신창중학교,교육부 제주특별자치도교육청 제주시교육지원청 신창중학교,28,28,0,28,0,28,0,0
교육기관,교육부,신창초등학교,교육부 제주특별자치도교육청 제주시교육지원청 신창초등학교,28,28,0,28,0,28,0,0
교육기관,교육부,아라중학교,교육부 제주특별자치도교육청 제주시교육지원청 아라중학교,75,75,0,75,75,0,0,0
교육기관,교육부,아라초등학교,교육부 제주특별자치도교육청 제주시교육지원청 아라초등학교,41,41,0,41,41,0,0,0
교육기관,교육부,애월중학교,교육부 제주특별자치도교육청 제주시교육지원청 애월중학교,53,52,1,52,52,0,0,0
교육기관,교육부,애월초등학교,교육부 제주특별자치도교육청 제주시교육지원청 애월초등학교,16,16,0,16,0,16,0,0
교육기관,교육부,어도초등학교,교육부 제주특별자치도교육청 제주시교육지원청 어도초등학교,17,17,0,17,15,2,0,0
교육기관,교육부,영평초등학교,교육부 제주특별자치도교육청 제주시교육지원청 영평초등학교,29,29,0,29,19,10,0,0
교육기관,교육부,오라초등학교,교육부 제주특별자치도교육청 제주시교육지원청 오라초등학교,26,24,2,24,24,0,0,0
교육기관,교육부,오름중학교,교육부 제주특별자치도교육청 제주시교육지원청 오름중학교,64,17,47,17,0,17,0,0
교육기관,교육부,오현중학교,교육부 제주특별자치도교육청 제주시교육지원청 오현중학교,77,77,0,77,47,30,0,0
교육기관,교육부,외도초등학교,교육부 제주특별자치도교육청 제주시교육지원청 외도초등학교,38,38,0,38,0,38,0,0
교육기관,교육부,우도중학교,교육부 제주특별자치도교육청 제주시교육지원청 우도중학교,5,5,0,5,0,5,0,0
교육기관,교육부,우도초등학교,교육부 제주특별자치도교육청 제주시교육지원청 우도초등학교,5,5,0,5,5,0,0,0
교육기관,교육부,월랑초등학교,교육부 제주특별자치도교육청 제주시교육지원청 월랑초등학교,39,39,0,39,0,39,0,0
교육기관,교육부,이도초등학교,교육부 제주특별자치도교육청 제주시교육지원청 이도초등학교,51,51,0,51,51,0,0,0
교육기관,교육부,인화초등학교,교육부 제주특별자치도교육청 제주시교육지원청 인화초등학교,41,41,0,41,0,41,0,0
교육기관,교육부,일도초등학교,교육부 제주특별자치도교육청 제주시교육지원청 일도초등학교,18,18,0,18,18,0,0,0
교육기관,교육부,장전초등학교,교육부 제주특별자치도교육청 제주시교육지원청 장전초등학교,31,31,0,31,31,0,0,0
교육기관,교육부,재릉초등학교,교육부 제주특별자치도교육청 제주시교육지원청 재릉초등학교,17,17,0,17,17,0,0,0
교육기관,교육부,저청중학교,교육부 제주특별자치도교육청 제주시교육지원청 저청중학교,14,14,0,14,14,0,0,0
교육기관,교육부,저청초등학교,교육부 제주특별자치도교육청 제주시교육지원청 저청초등학교,16,16,0,16,16,0,0,0
교육기관,교육부,제주남초등학교,교육부 제주특별자치도교육청 제주시교육지원청 제주남초등학교,33,33,0,33,33,0,0,0
교육기관,교육부,제주대학교사범대학부설중학교,교육부 제주특별자치도교육청 제주시교육지원청 제주대학교사범대학부설중학교,37,37,0,37,23,14,0,0
교육기관,교육부,제주동여자중학교,교육부 제주특별자치도교육청 제주시교육지원청 제주동여자중학교,43,43,0,43,3,40,0,0
교육기관,교육부,제주동중학교,교육부 제주특별자치도교육청 제주시교육지원청 제주동중학교,30,30,0,30,0,30,0,0
교육기관,교육부,제주동초등학교,교육부 제주특별자치도교육청 제주시교육지원청 제주동초등학교,27,27,0,27,0,27,0,0
교육기관,교육부,제주북초등학교,교육부 제주특별자치도교육청 제주시교육지원청 제주북초등학교,35,35,0,35,35,0,0,0
교육기관,교육부,제주서중학교,교육부 제주특별자치도교육청 제주시교육지원청 제주서중학교,34,33,1,33,17,15,1,0
교육기관,교육부,제주서초등학교,교육부 제주특별자치도교육청 제주시교육지원청 제주서초등학교,29,29,0,29,16,13,0,0
교육기관,교육부,제주여자중학교,교육부 제주특별자치도교육청 제주시교육지원청 제주여자중학교,17,17,0,17,6,11,0,0
교육기관,교육부,제주제일중학교,교육부 제주특별자치도교육청 제주시교육지원청 제주제일중학교,50,50,0,50,0,50,0,0
교육기관,교육부,제주중앙여자중학교,교육부 제주특별자치도교육청 제주시교육지원청 제주중앙여자중학교,29,28,1,28,26,2,0,0
교육기관,교육부,제주중앙중학교,교육부 제주특별자치도교육청 제주시교육지원청 제주중앙중학교,38,36,2,36,17,19,0,0
교육기관,교육부,제주중앙초등학교,교육부 제주특별자치도교육청 제주시교육지원청 제주중앙초등학교,16,16,0,16,0,16,0,0
교육기관,교육부,제주중학교,교육부 제주특별자치도교육청 제주시교육지원청 제주중학교,27,27,0,27,0,27,0,0
교육기관,교육부,조천초등학교,교육부 제주특별자치도교육청 제주시교육지원청 조천초등학교,19,19,0,19,18,1,0,0
교육기관,교육부,조천초등학교교래분교장,교육부 제주특별자치도교육청 제주시교육지원청 조천초등학교교래분교장,9,9,0,9,9,0,0,0
교육기관,교육부,종달초등학교,교육부 제주특별자치도교육청 제주시교육지원청 종달초등학교,10,10,0,10,3,7,0,0
교육기관,교육부,추자중학교,교육부 제주특별자치도교육청 제주시교육지원청 추자중학교,12,12,0,12,12,0,0,0
교육기관,교육부,추자초등학교,교육부 제주특별자치도교육청 제주시교육지원청 추자초등학교,11,11,0,11,11,0,0,0
교육기관,교육부,탐라중학교,교육부 제주특별자치도교육청 제주시교육지원청 탐라중학교,71,70,1,70,0,70,0,0
교육기관,교육부,평대초등학교,교육부 제주특별자치도교육청 제주시교육지원청 평대초등학교,16,16,0,16,0,16,0,0
교육기관,교육부,하귀일초등학교,교육부 제주특별자치도교육청 제주시교육지원청 하귀일초등학교,23,23,0,23,20,3,0,0
교육기관,교육부,하귀초등학교,교육부 제주특별자치도교육청 제주시교육지원청 하귀초등학교,21,21,0,21,8,13,0,0
교육기관,교육부,하도초등학교,교육부 제주특별자치도교육청 제주시교육지원청 하도초등학교,8,8,0,8,4,4,0,0
교육기관,교육부,한동초등학교,교육부 제주특별자치도교육청 제주시교육지원청 한동초등학교,11,11,0,11,11,0,0,0
교육기관,교육부,한라중학교,교육부 제주특별자치도교육청 제주시교육지원청 한라중학교,46,20,26,20,0,20,0,0
교육기관,교육부,한라초등학교,교육부 제주특별자치도교육청 제주시교육지원청 한라초등학교,37,37,0,37,37,0,0,0
교육기관,교육부,한림여자중학교,교육부 제주특별자치도교육청 제주시교육지원청 한림여자중학교,19,19,0,19,0,19,0,0
교육기관,교육부,한림초등학교,교육부 제주특별자치도교육청 제주시교육지원청 한림초등학교,32,32,0,32,0,32,0,0
교육기관,교육부,한천초등학교,교육부 제주특별자치도교육청 제주시교육지원청 한천초등학교,24,24,0,24,0,24,0,0
교육기관,교육부,함덕중학교,교육부 제주특별자치도교육청 제주시교육지원청 함덕중학교,21,21,0,21,10,11,0,0
교육기관,교육부,함덕초등학교,교육부 제주특별자치도교육청 제주시교육지원청 함덕초등학교,26,26,0,26,26,0,0,0
교육기관,교육부,함덕초등학교선인분교장,교육부 제주특별자치도교육청 제주시교육지원청 함덕초등학교선인분교장,10,10,0,10,10,0,0,0
교육기관,교육부,해안초등학교,교육부 제주특별자치도교육청 제주시교육지원청 해안초등학교,21,21,0,21,21,0,0,0
교육기관,교육부,화북초등학교,교육부 제주특별자치도교육청 제주시교육지원청 화북초등학교,21,21,0,21,16,5,0,0
교육기관,교육부,제주여자고등학교,교육부 제주특별자치도교육청 제주여자고등학교,12,12,0,12,12,0,0,0
교육기관,교육부,제주여자상업고등학교,교육부 제주특별자치도교육청 제주여자상업고등학교,56,54,2,54,29,25,0,0
교육기관,교육부,제주영송학교,교육부 제주특별자치도교육청 제주영송학교,42,42,0,42,16,26,0,0
교육기관,교육부,제주영지학교,교육부 제주특별자치도교육청 제주영지학교,27,27,0,27,27,0,0,0
교육기관,교육부,제주외국어고등학교,교육부 제주특별자치도교육청 제주외국어고등학교,57,57,0,57,0,57,0,0
교육기관,교육부,제주유아교육진흥원,교육부 제주특별자치도교육청 제주유아교육진흥원,16,16,0,16,8,8,0,0
교육기관,교육부,제주융합과학연구원,교육부 제주특별자치도교육청 제주융합과학연구원,68,57,11,57,0,57,0,0
교육기관,교육부,제주제일고등학교,교육부 제주특별자치도교육청 제주제일고등학교,66,66,0,66,0,66,0,0
교육기관,교육부,제주중앙고등학교,교육부 제주특별자치도교육청 제주중앙고등학교,54,54,0,54,26,23,1,4
교육기관,교육부,제주학생문화원,교육부 제주특별자치도교육청 제주학생문화원,22,22,0,22,6,16,0,0
교육기관,교육부,중문고등학교,교육부 제주특별자치도교육청 중문고등학교,22,9,13,9,7,2,0,0
교육기관,교육부,표선고등학교,교육부 제주특별자치도교육청 표선고등학교,69,69,0,69,0,69,0,0
교육기관,교육부,한국뷰티고등학교,교육부 제주특별자치도교육청 한국뷰티고등학교,23,23,0,23,23,0,0,0
교육기관,교육부,한림고등학교,교육부 제주특별자치도교육청 한림고등학교,41,17,24,17,12,5,0,0
교육기관,교육부,한림공업고등학교,교육부 제주특별자치도교육청 한림공업고등학교,60,60,0,60,45,15,0,0
교육기관,교육부,함덕고등학교,교육부 제주특별자치도교육청 함덕고등학교,106,100,6,100,25,75,0,0
